,fightId,fighterId,opponentId,date,KDO,SMA,SML,T,TDA,TDL,TSA,HL,SA,GA,GBA,GBL,GHA,GHL,SBA,SBL,SHA,SHL,GC,ST
0,d856812dc733690a,45f0cc9d18f35137,6bd02119599741a4,2023-04-15,0,0,0,900,0,0,133,30,131,2,0,0,2,1,64,47,67,29,4.0,732.4
1,d856812dc733690a,6bd02119599741a4,45f0cc9d18f35137,2023-04-15,1,0,0,900,1,0,174,20,161,13,0,0,13,7,70,40,91,13,161.6,722.0
2,cef255a992ba7af3,4148802ae4a50768,f9b200db02b488d9,2023-04-15,1,0,0,900,1,0,207,67,156,51,0,0,51,22,26,11,130,45,91.4,793.0
3,cef255a992ba7af3,f9b200db02b488d9,4148802ae4a50768,2023-04-15,0,0,0,900,3,0,91,20,89,2,0,0,2,0,50,31,39,20,3.0,802.6
4,bdbddbc00d07dc4b,c47df9303d318c67,e132d47bd9efbbe0,2023-04-15,0,0,0,900,3,0,252,49,252,0,0,0,0,0,25,14,227,49,0.0,900.0
5,bdbddbc00d07dc4b,e132d47bd9efbbe0,c47df9303d318c67,2023-04-15,0,0,0,900,1,0,287,130,287,0,0,0,0,0,18,11,269,130,0.0,880.0
6,bbde45b2c766bb67,1a31ef98efce7a79,6e15f63b6c2e2c15,2023-04-15,0,0,0,129,0,0,5,1,5,0,0,0,0,0,1,1,4,1,0.0,122.0
7,bbde45b2c766bb67,6e15f63b6c2e2c15,1a31ef98efce7a79,2023-04-15,1,0,0,129,0,0,22,13,9,13,0,0,13,10,2,0,7,3,7.0,122.0
8,b01e6e97d66681c5,9abc648e76c4493a,d31cbcdd7d69536d,2023-04-15,1,1,1,400,1,1,110,44,99,11,0,0,11,11,29,20,70,33,70.1,298.0
9,b01e6e97d66681c5,d31cbcdd7d69536d,9abc648e76c4493a,2023-04-15,0,0,0,400,2,1,91,34,91,0,0,0,0,0,13,12,78,34,0.0,290.9
10,995e79b951da945b,04c8b08b16a5b99e,cd13728ae1151f46,2023-04-15,0,0,0,125,0,0,16,5,16,0,0,0,0,0,1,0,15,5,0.0,108.0
11,995e79b951da945b,cd13728ae1151f46,04c8b08b16a5b99e,2023-04-15,1,0,0,125,1,1,40,27,24,16,0,0,16,16,4,3,20,11,17.0,108.0
12,8b2b2562884821a7,3cf66c62d9069f43,f9ab66e67240db7b,2023-04-15,0,0,0,900,7,2,98,27,77,21,1,1,20,10,15,11,62,17,304.2,438.3
13,8b2b2562884821a7,f9ab66e67240db7b,3cf66c62d9069f43,2023-04-15,0,0,0,900,1,0,114,19,107,7,0,0,7,5,49,37,58,14,12.7,566.8
14,83c81018bb3aeebf,64a50dad704d1d49,aa171d55d4b5208f,2023-04-15,1,0,0,157,0,0,33,13,32,1,0,0,1,1,8,8,24,12,1.0,155.0
15,83c81018bb3aeebf,aa171d55d4b5208f,64a50dad704d1d49,2023-04-15,0,0,0,157,2,0,42,16,42,0,0,0,0,0,4,3,38,16,0.0,117.0
16,792f139c2b9fd294,e4277e87a789d687,e90a2f22417af68e,2023-04-15,0,0,0,900,6,1,131,36,131,0,0,0,0,0,36,28,95,36,0.0,714.0
17,792f139c2b9fd294,e90a2f22417af68e,e4277e87a789d687,2023-04-15,1,0,0,900,5,1,127,51,127,0,0,0,0,0,17,16,110,51,0.0,884.0
18,68c1b833ed8849a3,38c7f72747f4f712,e375cb5caf4717b6,2023-04-15,0,1,1,561,3,2,39,20,23,16,0,0,16,14,10,6,13,6,383.0,178.0
19,68c1b833ed8849a3,e375cb5caf4717b6,38c7f72747f4f712,2023-04-15,0,0,0,561,1,1,33,10,33,0,0,0,0,0,2,2,31,10,0.0,124.0
20,6049301b4deea035,040a74bb0a465c54,150ff4cc642270b9,2023-04-15,0,0,0,1500,0,0,225,48,225,0,0,0,0,0,52,28,173,48,0.0,1458.0
21,6049301b4deea035,150ff4cc642270b9,040a74bb0a465c54,2023-04-15,0,0,0,1500,0,0,262,77,262,0,0,0,0,0,82,70,180,77,0.0,1497.0
22,5de3a1bbcf705b58,7138a15258dabf20,cffb87059e645bd1,2023-04-15,0,0,0,462,1,0,22,7,22,0,0,0,0,0,11,8,11,7,0.0,210.8
23,5de3a1bbcf705b58,cffb87059e645bd1,7138a15258dabf20,2023-04-15,1,0,0,462,3,3,93,28,59,34,15,13,19,10,20,13,39,18,172.2,229.0
24,50e675146cda6e7c,06f36cf4bd97ec77,4ba8d454f762005d,2023-04-15,0,0,0,853,1,0,117,34,113,4,1,1,3,3,24,19,89,31,0.0,702.1
25,50e675146cda6e7c,4ba8d454f762005d,06f36cf4bd97ec77,2023-04-15,3,0,0,853,0,0,175,69,159,16,3,3,13,11,33,28,126,58,150.9,655.0
26,119559fd8124fee3,34c2b3656f88f7ef,96924b0019b3aff1,2023-04-15,0,1,0,900,5,3,39,7,39,0,0,0,0,0,17,10,22,7,0.0,443.0
27,119559fd8124fee3,96924b0019b3aff1,34c2b3656f88f7ef,2023-04-15,0,0,0,900,0,0,127,32,93,34,13,11,21,9,32,20,61,23,96.0,804.0
28,fe143cb868adfded,1338e2c7480bdf9e,e5549c82bfb5582d,2023-04-08,1,0,0,561,0,0,96,18,95,1,0,0,1,1,35,23,60,17,1.0,558.0
29,fe143cb868adfded,e5549c82bfb5582d,1338e2c7480bdf9e,2023-04-08,0,0,0,561,0,0,85,8,85,0,0,0,0,0,57,41,28,8,0.0,560.0
30,bbc76ff9e1b1b142,5442f1bc4b47eaf3,8c0580d4fff106c1,2023-04-08,0,0,0,900,0,0,201,44,201,0,0,0,0,0,37,26,164,44,0.0,848.4
31,bbc76ff9e1b1b142,8c0580d4fff106c1,5442f1bc4b47eaf3,2023-04-08,0,0,0,900,3,0,188,63,178,10,0,0,10,4,27,20,151,59,50.6,819.0
32,95349402616097cd,a3a542074109b347,eb04b9d31e938edb,2023-04-08,0,0,0,900,5,0,122,16,122,0,0,0,0,0,43,28,79,16,0.0,815.0
33,95349402616097cd,eb04b9d31e938edb,a3a542074109b347,2023-04-08,0,0,0,900,2,1,188,18,188,0,0,0,0,0,74,43,114,18,0.0,839.0
34,780147f2ed2637d1,8e5d953bdb9ae5e7,98215d037be5bcb7,2023-04-08,0,0,0,900,2,0,180,65,180,0,0,0,0,0,34,22,146,65,0.0,899.0
35,780147f2ed2637d1,98215d037be5bcb7,8e5d953bdb9ae5e7,2023-04-08,0,0,0,900,2,1,333,58,333,0,0,0,0,0,84,46,249,58,0.0,825.0
36,71ea7d7985dad804,23024fdfc966410a,47b9e0e7703a4868,2023-04-08,0,0,0,900,6,4,99,34,90,9,0,0,9,5,15,8,75,29,341.0,559.0
37,71ea7d7985dad804,47b9e0e7703a4868,23024fdfc966410a,2023-04-08,0,0,0,900,0,0,91,14,91,0,0,0,0,0,30,25,61,14,0.0,554.0
38,678d27af287476f8,0232cabbc30a2372,05339613bf8e9808,2023-04-08,0,0,0,177,0,0,54,21,54,0,0,0,0,0,5,4,49,21,0.0,173.9
39,678d27af287476f8,05339613bf8e9808,0232cabbc30a2372,2023-04-08,1,0,0,177,1,0,75,30,68,7,0,0,7,5,6,3,62,25,3.1,173.0
40,355a2f4090c0ca31,bc7d1ad49fcb2d08,e94085e821bd81de,2023-04-08,0,3,0,900,10,2,52,12,49,3,0,0,3,1,10,0,39,11,222.0,326.3
41,355a2f4090c0ca31,e94085e821bd81de,bc7d1ad49fcb2d08,2023-04-08,0,0,0,900,1,1,104,45,69,35,0,0,35,21,3,1,66,24,351.7,256.0
42,3165b03ddc6d3b6e,3a46b268013afede,6d1bffff14897645,2023-04-08,1,0,0,796,0,0,197,24,193,4,0,0,4,2,59,42,134,22,1.2,793.0
43,3165b03ddc6d3b6e,6d1bffff14897645,3a46b268013afede,2023-04-08,0,0,0,796,0,0,104,12,104,0,0,0,0,0,46,32,58,12,0.0,787.8
44,2cb34fc074f7a9ae,5ec591b78349ba7e,fe2babf95de24fb1,2023-04-08,0,0,0,900,1,1,52,26,25,27,0,0,27,21,5,3,20,5,357.4,450.0
45,2cb34fc074f7a9ae,fe2babf95de24fb1,5ec591b78349ba7e,2023-04-08,0,1,0,900,16,3,19,2,19,0,0,0,0,0,4,0,15,2,0.0,252.60000000000002
46,28e3d939eb043664,6ac9bc2953c47345,c1085e1701b13eca,2023-04-08,0,0,0,195,0,0,21,1,21,0,0,0,0,0,9,9,12,1,0.0,179.0
47,28e3d939eb043664,c1085e1701b13eca,6ac9bc2953c47345,2023-04-08,1,0,0,195,0,0,24,6,11,13,5,5,8,3,3,3,8,3,16.0,179.0
48,0810cdbeb9dd4d02,0a73acff6325c1e2,97cf1a2c7c5e7889,2023-04-08,1,0,0,336,2,1,35,15,16,19,2,2,17,8,2,1,14,7,214.0,110.0
49,0810cdbeb9dd4d02,97cf1a2c7c5e7889,0a73acff6325c1e2,2023-04-08,1,0,0,336,0,0,40,14,36,4,0,0,4,4,3,3,33,10,12.0,107.0
50,c6cc6ae23cbf8a27,361d49960a196976,7832f2f62f04178f,2023-03-25,1,2,1,470,2,1,45,10,45,0,0,0,0,0,21,14,24,10,0.0,330.0
51,c6cc6ae23cbf8a27,7832f2f62f04178f,361d49960a196976,2023-03-25,0,0,0,470,4,0,78,17,78,0,0,0,0,0,17,11,61,17,0.0,383.0
52,bce8ece2ff26b4d4,305d73ede05e31ad,583ee11abddfc581,2023-03-25,0,0,0,551,0,0,146,28,146,0,0,0,0,0,30,20,116,28,0.0,531.8
53,bce8ece2ff26b4d4,583ee11abddfc581,305d73ede05e31ad,2023-03-25,0,1,1,551,2,1,153,36,149,4,0,0,4,3,49,28,100,33,19.2,527.0
54,b9e037a45f8850fb,11583163f45c7b31,b93c06d09d1c4ac0,2023-03-25,1,0,0,900,0,0,158,43,143,15,2,1,13,5,48,41,95,38,51.6,845.0
55,b9e037a45f8850fb,b93c06d09d1c4ac0,11583163f45c7b31,2023-03-25,0,0,0,900,4,0,101,8,101,0,0,0,0,0,34,18,67,8,0.0,817.4
56,9433730f95d52fc8,05fa626cb33d15b8,6a740daf1b279661,2023-03-25,0,0,0,900,5,5,103,10,102,1,1,1,0,0,45,28,57,10,53.3,557.5
57,9433730f95d52fc8,6a740daf1b279661,05fa626cb33d15b8,2023-03-25,0,0,0,900,2,2,127,31,120,7,0,0,7,7,30,17,90,24,22.5,801.7
58,6f6fec9c78244174,65cdf4ec31143d86,dc7927cd622676a7,2023-03-25,0,0,0,900,6,1,130,26,126,4,1,1,3,3,27,20,99,23,7.6,727.0
59,6f6fec9c78244174,dc7927cd622676a7,65cdf4ec31143d86,2023-03-25,0,0,0,900,22,3,118,28,112,6,1,1,5,3,48,33,64,25,152.0,588.4
60,33fa6793a7f984ac,65f09bacd3957381,7c7332319c14094c,2023-03-25,0,0,0,1500,12,3,280,84,244,36,0,0,36,19,54,44,190,65,395.1,1070.5
61,33fa6793a7f984ac,7c7332319c14094c,65f09bacd3957381,2023-03-25,0,1,0,1500,1,0,158,28,157,1,0,0,1,0,53,30,104,28,1.5,1095.9
62,2f382615155e32b9,6b7c7460855dbbb9,c68c68efaa5ca6ef,2023-03-25,0,0,0,900,3,2,123,21,101,22,0,0,22,11,33,24,68,10,242.0,658.0
63,2f382615155e32b9,c68c68efaa5ca6ef,6b7c7460855dbbb9,2023-03-25,0,0,0,900,0,0,99,18,99,0,0,0,0,0,31,22,68,18,0.0,658.0
64,1c2d0db1c9eed052,3143bf892608139a,634e2fb70bde3fd5,2023-03-25,0,0,0,900,0,0,46,3,46,0,0,0,0,0,24,18,22,3,0.0,330.2
65,1c2d0db1c9eed052,634e2fb70bde3fd5,3143bf892608139a,2023-03-25,0,0,0,900,6,4,63,23,38,25,3,3,22,11,11,6,27,12,490.8,311.0
66,16bd47ba50891833,077e3ace32b72be9,31bb0772f21cabd8,2023-03-25,1,1,0,544,0,0,144,57,67,77,10,7,67,42,31,19,36,15,169.6,355.5
67,16bd47ba50891833,31bb0772f21cabd8,077e3ace32b72be9,2023-03-25,2,2,0,544,2,1,117,32,113,4,0,0,4,2,23,16,90,30,14.5,334.4
68,07e39fd5f4f23270,9fe7af8b3fbe00a0,b27a1fcb56a3035a,2023-03-25,0,3,0,900,11,3,95,24,94,1,1,1,0,0,17,17,77,24,28.7,421.4
69,07e39fd5f4f23270,b27a1fcb56a3035a,9fe7af8b3fbe00a0,2023-03-25,0,0,0,900,1,0,108,51,92,16,3,2,13,12,3,2,89,39,162.6,617.3
70,f40ac11da3bd7f8e,65adf3856c4d9256,75353550928a7921,2023-03-18,0,2,0,872,0,0,37,1,36,1,0,0,1,0,14,8,22,1,50.0,327.0
71,f40ac11da3bd7f8e,75353550928a7921,65adf3856c4d9256,2023-03-18,0,2,1,872,8,4,30,4,25,5,1,1,4,3,14,11,11,1,495.0,327.0
72,dd9cbf6d6284de26,04835018f90b118c,8e1f36476ef02a6a,2023-03-18,0,0,0,900,1,0,264,108,264,0,0,0,0,0,38,29,226,108,0.0,900.0
73,dd9cbf6d6284de26,8e1f36476ef02a6a,04835018f90b118c,2023-03-18,0,0,0,900,4,0,349,123,349,0,0,0,0,0,28,22,321,123,0.0,817.0
74,cdaf65287d9a0ecb,a0e6753c42698f13,fd406a32a6fb3a29,2023-03-18,0,0,0,900,0,0,80,32,79,1,0,0,1,1,16,15,63,31,0.3,624.3
75,cdaf65287d9a0ecb,fd406a32a6fb3a29,a0e6753c42698f13,2023-03-18,0,0,0,900,14,5,83,12,76,7,7,7,0,0,51,34,25,12,273.7,508.7
76,c483ac06b1e33c3b,f1b2aa7853d1ed6e,f1fac969a1d70b08,2023-03-18,0,0,0,1500,15,4,205,57,204,1,0,0,1,1,42,30,162,56,10.8,1197.0
77,c483ac06b1e33c3b,f1fac969a1d70b08,f1b2aa7853d1ed6e,2023-03-18,0,0,0,1500,1,0,161,34,161,0,0,0,0,0,92,86,69,34,0.0,1489.2
78,9f8cf5ac0807d64e,8b6e5dc2ba1edbe7,c739c2995a275314,2023-03-18,0,0,0,75,0,0,7,1,7,0,0,0,0,0,3,1,4,1,0.0,68.0
79,9f8cf5ac0807d64e,c739c2995a275314,8b6e5dc2ba1edbe7,2023-03-18,1,0,0,75,1,1,20,14,4,16,0,0,16,13,2,1,2,1,7.0,68.0
80,938c2c71b84e56ff,4c88a1db5a46c6a4,5b86d491d63890c5,2023-03-18,0,0,0,900,3,1,90,15,81,9,0,0,9,7,31,28,50,8,71.2,707.5
81,938c2c71b84e56ff,5b86d491d63890c5,4c88a1db5a46c6a4,2023-03-18,0,0,0,900,3,2,97,30,95,2,0,0,2,2,22,17,73,28,18.5,634.8
82,90a83875e1d11238,9e8f6c728eb01124,c814b4c899793af6,2023-03-18,0,0,0,900,3,1,171,81,171,0,0,0,0,0,29,22,142,81,0.0,895.0
83,90a83875e1d11238,c814b4c899793af6,9e8f6c728eb01124,2023-03-18,0,0,0,900,0,0,169,38,169,0,0,0,0,0,69,59,100,38,0.0,900.0
84,8a3e7085e8e5a6e9,12f91bfa8f1f723b,528b071cf3da7c56,2023-03-18,0,0,0,900,4,2,228,61,227,1,1,1,0,0,85,69,142,61,2.2,790.0
85,8a3e7085e8e5a6e9,528b071cf3da7c56,12f91bfa8f1f723b,2023-03-18,0,0,0,900,0,0,199,55,199,0,0,0,0,0,55,45,144,55,0.0,855.8
86,6068385c48de6801,60a42bf82447c919,dee294e9717012c2,2023-03-18,1,0,0,61,0,0,21,7,15,6,0,0,6,5,3,3,12,2,4.0,57.0
87,6068385c48de6801,dee294e9717012c2,60a42bf82447c919,2023-03-18,0,0,0,61,0,0,15,1,15,0,0,0,0,0,2,2,13,1,0.0,57.0
88,5e9c027fb24efc2b,327d5f279895110d,7acbb0972e75281a,2023-03-18,0,0,0,900,1,0,192,52,192,0,0,0,0,0,23,19,169,52,0.0,886.0
89,5e9c027fb24efc2b,7acbb0972e75281a,327d5f279895110d,2023-03-18,0,0,0,900,0,0,218,60,218,0,0,0,0,0,53,46,165,60,0.0,900.0
90,53d6d5ad08ac0694,4798e823ada58fe9,aa0c573da7119292,2023-03-18,0,0,0,900,4,4,77,39,49,28,11,11,17,14,14,12,35,25,375.5,415.8
91,53d6d5ad08ac0694,aa0c573da7119292,4798e823ada58fe9,2023-03-18,0,3,0,900,3,0,79,20,74,5,1,0,4,1,15,10,59,19,28.2,445.5
92,533984c3ff4b4858,396fe87b84ac2e1c,f2f140ce7532e327,2023-03-18,0,0,0,900,2,1,161,59,156,5,3,3,2,1,41,31,115,58,40.6,733.8
93,533984c3ff4b4858,f2f140ce7532e327,396fe87b84ac2e1c,2023-03-18,0,0,0,900,11,5,122,32,120,2,0,0,2,0,49,37,71,32,28.2,619.4
94,38094db8e3539cba,866fd7b1a6c90e7f,a93f94c923c3a9cb,2023-03-18,0,0,0,112,0,0,6,0,6,0,0,0,0,0,6,4,0,0,0.0,112.0
95,38094db8e3539cba,a93f94c923c3a9cb,866fd7b1a6c90e7f,2023-03-18,1,0,0,112,0,0,14,3,14,0,0,0,0,0,6,6,8,3,0.0,74.0
96,13f5be7a2ea5577e,87a1dc546b1c5caf,b8a85389d115e35a,2023-03-18,0,0,0,567,3,1,24,6,24,0,0,0,0,0,5,4,19,6,0.0,259.6
97,13f5be7a2ea5577e,b8a85389d115e35a,87a1dc546b1c5caf,2023-03-18,0,1,1,567,1,1,46,23,41,5,0,0,5,4,6,5,35,19,96.4,432.0
98,019b4d006800504b,a331233f597090a5,fd55393021a8c255,2023-03-18,0,0,0,291,0,0,12,3,11,1,0,0,1,1,5,4,6,2,0.0,140.9
99,019b4d006800504b,fd55393021a8c255,a331233f597090a5,2023-03-18,0,1,1,291,2,1,11,8,4,7,0,0,7,7,2,2,2,1,150.1,98.0
100,e9c6bac0d1a5ec0f,0c25d0a5e8cdbf19,d35f734c56a89103,2023-03-11,0,0,0,900,1,0,46,19,45,1,0,0,1,0,7,7,38,19,4.8,385.7
101,e9c6bac0d1a5ec0f,d35f734c56a89103,0c25d0a5e8cdbf19,2023-03-11,1,0,0,900,13,8,58,31,39,19,1,1,18,13,7,6,32,18,485.3,282.2
102,ccb5e29cd0347110,a53d30163304aa6e,c730a0be691dc081,2023-03-11,0,0,0,900,12,5,110,52,89,21,1,1,20,16,10,10,79,36,337.2,322.0
103,ccb5e29cd0347110,c730a0be691dc081,a53d30163304aa6e,2023-03-11,0,0,0,900,0,0,84,22,84,0,0,0,0,0,35,29,49,22,0.0,560.8
104,c4e4954beb59eca6,601964f9654f911a,eb8d8c2a95cfccb8,2023-03-11,0,0,0,900,17,3,154,44,149,5,4,4,1,1,37,27,112,43,37.4,690.1
105,c4e4954beb59eca6,eb8d8c2a95cfccb8,601964f9654f911a,2023-03-11,0,2,0,900,0,0,244,92,238,6,0,0,6,6,68,62,170,86,7.9,782.6
106,c3af2b6ab1262fef,294aa73dbf37d281,6e00cfffd54653c4,2023-03-11,1,1,1,383,1,0,45,14,39,6,0,0,6,2,12,9,27,12,45.4,330.0
107,c3af2b6ab1262fef,6e00cfffd54653c4,294aa73dbf37d281,2023-03-11,0,0,0,383,0,0,38,6,38,0,0,0,0,0,7,6,31,6,0.0,337.6
108,b9539d5e379b3edc,0fd5f4b838e890cc,f2477cf43c4975cc,2023-03-11,0,2,0,900,9,3,78,25,71,7,0,0,7,4,28,22,43,21,87.0,577.5
109,b9539d5e379b3edc,f2477cf43c4975cc,0fd5f4b838e890cc,2023-03-11,0,1,0,900,1,0,55,13,52,3,0,0,3,3,30,25,22,10,61.5,444.0
110,8e5ce3308c0e2046,6551c64fbcd1a467,6fd953151d981979,2023-03-11,0,0,0,900,2,2,204,47,204,0,0,0,0,0,70,54,134,47,0.0,881.0
111,8e5ce3308c0e2046,6fd953151d981979,6551c64fbcd1a467,2023-03-11,0,0,0,900,12,0,99,42,99,0,0,0,0,0,7,7,92,42,0.0,824.0
112,8d5b88e0ff253617,71171fc96445bf65,82529ce93cd9a2cf,2023-03-11,0,1,0,900,9,7,82,27,71,11,6,6,5,3,10,6,61,24,241.4,374.3
113,8d5b88e0ff253617,82529ce93cd9a2cf,71171fc96445bf65,2023-03-11,0,0,0,900,15,5,56,19,50,6,0,0,6,6,20,14,30,13,152.7,378.6
114,804c350ce714770f,113df4fde64735c6,2f13e4020cea5b38,2023-03-11,1,1,1,883,0,0,138,28,136,2,0,0,2,2,47,37,89,26,17.3,779.6
115,804c350ce714770f,2f13e4020cea5b38,113df4fde64735c6,2023-03-11,0,0,0,883,12,5,58,16,57,1,0,0,1,1,29,26,28,15,51.4,608.7
116,3cf3771274a4f8b1,4e6738062d469256,ca43de99b07b6b40,2023-03-11,0,0,0,480,1,0,44,8,44,0,0,0,0,0,18,12,26,8,0.0,384.0
117,3cf3771274a4f8b1,ca43de99b07b6b40,4e6738062d469256,2023-03-11,0,2,1,480,2,2,61,21,59,2,0,0,2,2,13,12,46,19,89.0,213.0
118,3b561a154aa2bbb2,279566840aa55bf2,c0badf3243907e59,2023-03-11,1,0,0,136,0,0,15,8,10,5,0,0,5,5,4,4,6,3,39.4,73.0
119,3b561a154aa2bbb2,c0badf3243907e59,279566840aa55bf2,2023-03-11,0,0,0,136,5,0,1,0,1,0,0,0,0,0,0,0,1,0,0.0,58.6
120,2c58a97f2fe6c985,bc711b6dd95c1af6,d05412b513b19621,2023-03-11,0,1,1,198,4,3,4,2,2,2,0,0,2,2,1,1,1,0,104.0,42.0
121,2c58a97f2fe6c985,d05412b513b19621,bc711b6dd95c1af6,2023-03-11,0,0,0,198,1,1,5,0,5,0,0,0,0,0,4,2,1,0,0.0,78.0
122,0ccd2593c88209e4,c03520b5c88ed6b4,d661ce4da776fc20,2023-03-11,0,0,0,1500,49,11,338,91,338,0,0,0,0,0,78,56,260,91,0.0,1087.0
123,0ccd2593c88209e4,d661ce4da776fc20,c03520b5c88ed6b4,2023-03-11,0,0,0,1500,5,1,143,41,143,0,0,0,0,0,38,34,105,41,0.0,1390.0
124,ee2354d638c078fd,323d4ca260dfa0ba,8c169fbe1ac33637,2023-03-04,1,1,0,900,1,0,129,52,125,4,0,0,4,4,15,14,110,48,24.8,639.5
125,ee2354d638c078fd,8c169fbe1ac33637,323d4ca260dfa0ba,2023-03-04,0,0,0,900,21,11,85,33,83,2,2,2,0,0,5,5,78,33,229.5,416.2
126,ed9f8f702585ed44,32490e80ddab1e5a,442c9011034ae1fd,2023-03-04,1,0,0,862,3,2,110,18,102,8,0,0,8,3,41,37,61,15,22.0,813.5
127,ed9f8f702585ed44,442c9011034ae1fd,32490e80ddab1e5a,2023-03-04,1,0,0,862,0,0,231,58,221,10,1,1,9,6,81,68,140,52,4.5,835.0
128,ec490d4224d3bc78,d8c7c61b176e3994,ec23c1be628d8057,2023-03-04,0,0,0,900,3,2,33,8,30,3,0,0,3,3,19,18,11,5,91.2,668.8
129,ec490d4224d3bc78,ec23c1be628d8057,d8c7c61b176e3994,2023-03-04,0,1,0,900,2,1,69,9,65,4,0,0,4,4,19,11,46,5,79.2,709.8
130,d6d034e98ce85246,4d8fa64202cee4c1,72db2a14ffa73ece,2023-03-04,1,0,0,900,1,0,97,23,94,3,0,0,3,3,25,17,69,20,13.7,538.4
131,d6d034e98ce85246,72db2a14ffa73ece,4d8fa64202cee4c1,2023-03-04,0,0,0,900,12,4,42,18,34,8,0,0,8,6,12,11,22,12,329.6,474.3
132,cd20dac4daa4f93a,a09ed60aa67a3f67,da22387a0407a2dc,2023-03-04,0,0,0,900,6,3,96,36,84,12,2,2,10,10,24,20,60,26,231.5,528.9
133,cd20dac4daa4f93a,da22387a0407a2dc,a09ed60aa67a3f67,2023-03-04,0,1,0,900,6,1,117,23,114,3,0,0,3,3,38,23,76,20,43.1,510.5
134,c3b9b97467f828d1,c742287ed86a09bc,d25240135aee03e5,2023-03-04,0,0,0,434,1,0,25,4,24,1,1,1,0,0,4,1,20,4,0.0,148.5
135,c3b9b97467f828d1,d25240135aee03e5,c742287ed86a09bc,2023-03-04,0,1,1,434,5,4,54,19,34,20,11,10,9,9,8,7,26,10,285.5,120.0
136,c2fc4c1e0c769655,0d7b51c9d2649a6e,b1a3e0aca758b322,2023-03-04,1,1,0,599,2,1,115,55,98,17,1,1,16,14,17,15,81,41,72.2,439.0
137,c2fc4c1e0c769655,b1a3e0aca758b322,0d7b51c9d2649a6e,2023-03-04,0,1,0,599,2,1,84,27,79,5,0,0,5,4,13,10,66,23,75.0,376.8
138,c29e2c49e1e417c8,8e9eb3fc86db0f7d,d0e1b42d41dab603,2023-03-04,1,0,0,552,0,0,222,91,222,0,0,0,0,0,20,18,202,91,0.0,463.0
139,c29e2c49e1e417c8,d0e1b42d41dab603,8e9eb3fc86db0f7d,2023-03-04,0,0,0,552,1,0,171,63,171,0,0,0,0,0,29,19,142,63,0.0,552.0
140,a69afe4a88c0ca12,132deb59abae64b1,e8b731feff72294b,2023-03-04,0,0,0,1174,6,4,145,68,140,5,0,0,5,5,24,19,116,63,135.0,840.9
141,a69afe4a88c0ca12,e8b731feff72294b,132deb59abae64b1,2023-03-04,0,1,1,1174,2,0,181,31,180,1,0,0,1,1,44,28,136,30,9.1,957.0
142,636fd144716a3084,07f72a2a7591b409,787bb1f087ccff8a,2023-03-04,0,1,1,124,2,2,10,2,10,0,0,0,0,0,5,3,5,2,0.0,67.0
143,636fd144716a3084,787bb1f087ccff8a,07f72a2a7591b409,2023-03-04,0,0,0,124,0,0,8,1,8,0,0,0,0,0,5,5,3,1,0.0,124.0
144,2b9daf452ab40b9b,35673bf5204524ee,830f60497fab345a,2023-03-04,0,2,1,174,4,1,4,0,4,0,0,0,0,0,2,1,2,0,0.0,24.0
145,2b9daf452ab40b9b,830f60497fab345a,35673bf5204524ee,2023-03-04,0,0,0,174,0,0,2,0,2,0,0,0,0,0,1,1,1,0,0.0,174.0
146,22fc6b3f4e48cfa3,01afe0916a40c7c5,b997be68943010fc,2023-03-04,0,1,1,857,4,0,179,69,179,0,0,0,0,0,49,44,130,69,0.0,634.0
147,22fc6b3f4e48cfa3,b997be68943010fc,01afe0916a40c7c5,2023-03-04,0,0,0,857,0,0,145,63,145,0,0,0,0,0,9,6,136,63,0.0,785.0
148,0eb16f1307f66a11,3c8a5200436e19f3,c0386644627a7ee5,2023-03-04,1,0,0,900,1,1,240,66,194,46,2,1,44,30,63,50,131,36,231.9,653.0
149,0eb16f1307f66a11,c0386644627a7ee5,3c8a5200436e19f3,2023-03-04,0,0,0,900,0,0,148,40,148,0,0,0,0,0,23,20,125,40,0.0,668.1
150,009feda296ae589c,36541f1e6c5d4955,beecb672a279223e,2023-03-04,0,2,0,900,0,0,115,37,114,1,0,0,1,1,10,9,104,36,0.0,400.0
151,009feda296ae589c,beecb672a279223e,36541f1e6c5d4955,2023-03-04,0,0,0,900,2,2,183,71,176,7,1,1,6,4,33,26,143,67,500.0,400.0
152,faac24c1b3d6368a,a6eb54ae17a551be,a9e260472d321361,2023-02-25,0,0,0,900,1,0,56,10,56,0,0,0,0,0,19,16,37,10,0.0,254.39999999999998
153,faac24c1b3d6368a,a9e260472d321361,a6eb54ae17a551be,2023-02-25,0,0,0,900,8,4,54,17,41,13,0,0,13,7,8,7,33,10,641.6,209.0
154,d6357dab7ccdf2db,1a9480fc288e55d7,441eacbe20e0e80b,2023-02-25,0,0,0,900,1,0,62,15,62,0,0,0,0,0,16,14,46,15,0.0,687.8
155,d6357dab7ccdf2db,441eacbe20e0e80b,1a9480fc288e55d7,2023-02-25,0,0,0,900,2,1,95,27,91,4,0,0,4,2,30,26,61,25,46.2,369.0
156,a7f66f13f953352f,3e708ce33b6b18e6,ac026518a9b4dc0f,2023-02-25,0,0,0,147,0,0,28,4,28,0,0,0,0,0,8,3,20,4,0.0,125.8
157,a7f66f13f953352f,ac026518a9b4dc0f,3e708ce33b6b18e6,2023-02-25,1,0,0,147,2,0,35,8,29,6,0,0,6,4,14,9,15,4,21.2,101.0
158,83fa3a382acc7bdc,0bc697c5936a2d0a,a2ccf35a88346a91,2023-02-25,2,0,0,299,1,0,86,38,79,7,1,1,6,5,15,12,64,33,5.9,283.0
159,83fa3a382acc7bdc,a2ccf35a88346a91,0bc697c5936a2d0a,2023-02-25,0,0,0,299,6,4,29,5,29,0,0,0,0,0,2,2,27,5,0.0,158.1
160,5737084215c45792,80d8aed0ca9b00f3,b08012bbe542592a,2023-02-25,0,0,0,471,0,0,11,4,11,0,0,0,0,0,1,1,10,4,0.0,434.0
161,5737084215c45792,b08012bbe542592a,80d8aed0ca9b00f3,2023-02-25,0,1,1,471,6,2,13,0,13,0,0,0,0,0,12,10,1,0,0.0,126.0
162,2ba11e0bf32829d6,2f181c0467965b98,886264a0c9f4ea5e,2023-02-25,0,2,1,865,1,1,102,21,98,4,0,0,4,2,26,21,72,19,252.0,613.0
163,2ba11e0bf32829d6,886264a0c9f4ea5e,2f181c0467965b98,2023-02-25,0,0,0,865,3,0,112,25,112,0,0,0,0,0,24,18,88,25,0.0,598.0
164,12d9b4a3931be5ec,914a897455693650,af65aa688d13eedf,2023-02-25,0,0,0,595,0,0,12,1,12,0,0,0,0,0,2,0,10,1,0.0,595.0
165,12d9b4a3931be5ec,af65aa688d13eedf,914a897455693650,2023-02-25,0,3,1,595,3,2,8,1,8,0,0,0,0,0,2,1,6,1,0.0,64.0
166,02615499125b4b5d,029afd138865d20a,ca28cdf526d6b6e9,2023-02-25,0,2,0,900,0,0,17,2,17,0,0,0,0,0,6,4,11,2,0.0,171.0
167,02615499125b4b5d,ca28cdf526d6b6e9,029afd138865d20a,2023-02-25,0,0,0,900,4,3,45,19,10,35,0,0,35,18,3,0,7,1,651.0,249.0
168,00a94d5fc7ce55cf,dd6103dd7127db1d,f998f5c102250d6e,2023-02-25,0,1,1,255,1,1,17,3,17,0,0,0,0,0,9,6,8,3,0.0,159.0
169,00a94d5fc7ce55cf,f998f5c102250d6e,dd6103dd7127db1d,2023-02-25,0,0,0,255,0,0,4,1,4,0,0,0,0,0,1,0,3,1,0.0,255.0
170,dcc3da324eb5f26c,669970f7feba8ecd,6a1901c62ab3870f,2023-02-18,0,1,1,397,3,1,120,38,120,0,0,0,0,0,15,13,105,38,0.0,334.0
171,dcc3da324eb5f26c,6a1901c62ab3870f,669970f7feba8ecd,2023-02-18,0,0,0,397,1,0,143,28,143,0,0,0,0,0,36,25,107,28,0.0,397.0
172,dc6f69f923744948,5da33b8fbfa5ee95,6370c1c1e12723d5,2023-02-18,0,0,0,900,3,0,33,0,33,0,0,0,0,0,20,8,13,0,0.0,900.0
173,dc6f69f923744948,6370c1c1e12723d5,5da33b8fbfa5ee95,2023-02-18,0,0,0,900,0,0,144,9,144,0,0,0,0,0,108,70,36,9,0.0,900.0
174,d45d9c7d60f332da,d9a56ecb6e94f02e,ff62013d2fce6d13,2023-02-18,1,0,0,638,6,1,142,25,142,0,0,0,0,0,55,45,87,25,0.0,545.0
175,d45d9c7d60f332da,ff62013d2fce6d13,d9a56ecb6e94f02e,2023-02-18,1,0,0,638,1,1,132,38,132,0,0,0,0,0,29,26,103,38,0.0,619.0
176,c3a4187fc821bfff,2eeaefbfc7f9fcff,cc8c623cca88f54f,2023-02-18,0,0,0,585,0,0,50,16,50,0,0,0,0,0,9,9,41,16,0.0,437.6
177,c3a4187fc821bfff,cc8c623cca88f54f,2eeaefbfc7f9fcff,2023-02-18,0,1,1,585,3,2,69,13,60,9,0,0,9,7,31,26,29,6,126.4,276.0
178,682ff095649c9a5c,262a7d06203657e6,d1941565abf50b16,2023-02-18,0,0,0,900,1,0,234,62,226,8,2,2,6,5,63,44,163,57,16.7,877.0
179,682ff095649c9a5c,d1941565abf50b16,262a7d06203657e6,2023-02-18,0,1,0,900,1,0,185,32,185,0,0,0,0,0,48,35,137,32,0.0,843.3
180,43ec12079ccc371c,5c10da56d712ac9c,e00a3dee329a51f7,2023-02-18,0,0,0,900,6,0,114,15,114,0,0,0,0,0,26,15,88,15,0.0,693.8
181,43ec12079ccc371c,e00a3dee329a51f7,5c10da56d712ac9c,2023-02-18,0,0,0,900,3,1,144,27,131,13,1,1,12,7,61,34,70,20,148.2,615.0
182,435ba9b407b844ef,40f3cb27fc7305a1,725b1abc9a39d873,2023-02-18,0,0,0,397,2,2,10,2,10,0,0,0,0,0,4,4,6,2,0.0,96.1
183,435ba9b407b844ef,725b1abc9a39d873,40f3cb27fc7305a1,2023-02-18,0,1,1,397,0,0,17,6,8,9,0,0,9,5,4,1,4,1,180.9,196.0
184,40781a64c4cea877,4a043165cf47cab2,b62d5280966b2460,2023-02-18,0,0,0,193,1,1,7,0,4,3,0,0,3,0,1,1,3,0,82.0,111.0
185,40781a64c4cea877,b62d5280966b2460,4a043165cf47cab2,2023-02-18,0,3,1,193,0,0,5,2,5,0,0,0,0,0,1,1,4,2,0.0,32.0
186,3f837b469ba33c7c,56f7d7ee06be4aab,c878270af633eb11,2023-02-18,0,0,0,900,6,0,85,31,85,0,0,0,0,0,31,28,54,31,0.0,380.0
187,3f837b469ba33c7c,c878270af633eb11,56f7d7ee06be4aab,2023-02-18,0,0,0,900,1,0,78,15,78,0,0,0,0,0,23,14,55,15,0.0,887.0
188,3e90b7fd1e9f86bd,b5da8f7d05e85a55,f41b9f5efc7162d6,2023-02-18,0,0,0,900,2,1,113,19,113,0,0,0,0,0,28,18,85,19,0.0,720.6
189,3e90b7fd1e9f86bd,f41b9f5efc7162d6,b5da8f7d05e85a55,2023-02-18,0,0,0,900,11,5,60,29,56,4,0,0,4,4,4,4,52,25,107.4,551.0
190,3d46d635f9ae5e68,50db8711c70196cd,53c943c873cffe90,2023-02-18,0,0,0,49,0,0,3,0,3,0,0,0,0,0,2,1,1,0,0.0,48.7
191,3d46d635f9ae5e68,53c943c873cffe90,50db8711c70196cd,2023-02-18,1,0,0,49,0,0,44,17,43,1,0,0,1,1,1,1,42,16,0.3,47.0
192,ec03739c836fadc8,70e1f8a821b72c8b,a495f599e787614f,2023-02-11,0,3,0,900,12,6,62,27,59,3,0,0,3,3,4,4,55,24,178.1,248.8
193,ec03739c836fadc8,a495f599e787614f,70e1f8a821b72c8b,2023-02-11,2,0,0,900,0,0,83,53,71,12,0,0,12,10,3,3,68,43,176.2,486.9
194,da22d5a717ae9e35,ac40f7e3cbecdda4,e13abac8089a801a,2023-02-11,0,0,0,66,0,0,16,5,16,0,0,0,0,0,3,2,13,5,0.0,66.0
195,da22d5a717ae9e35,e13abac8089a801a,ac40f7e3cbecdda4,2023-02-11,1,0,0,66,0,0,16,6,16,0,0,0,0,0,3,2,13,6,0.0,66.0
196,ca2672e68fedf4b7,476fe566d2df676e,49e96ff8ab781589,2023-02-11,0,0,0,900,0,0,109,25,109,0,0,0,0,0,21,19,88,25,0.0,817.1
197,ca2672e68fedf4b7,49e96ff8ab781589,476fe566d2df676e,2023-02-11,0,0,0,900,3,2,81,18,80,1,0,0,1,1,36,27,44,17,25.9,719.0
198,a37a6b6f9551a6e8,3920d0cc288f9b0d,af9f42e6894047fc,2023-02-11,0,1,0,900,2,0,75,18,75,0,0,0,0,0,17,10,58,18,0.0,603.0
199,a37a6b6f9551a6e8,af9f42e6894047fc,3920d0cc288f9b0d,2023-02-11,0,0,0,900,4,3,104,28,92,12,1,1,11,9,33,30,59,19,287.0,613.0
200,8b7bc2af1e15b668,6751eacd16bd59bc,a52bc1e62cf0b7c6,2023-02-11,0,1,1,422,0,0,45,3,45,0,0,0,0,0,21,13,24,3,0.0,408.0
201,8b7bc2af1e15b668,a52bc1e62cf0b7c6,6751eacd16bd59bc,2023-02-11,0,0,0,422,0,0,44,6,44,0,0,0,0,0,25,20,19,6,0.0,422.0
202,5c962ea13cb9b937,4cd8b03aee1d0138,5095b0920a3602aa,2023-02-11,0,0,0,900,3,0,196,42,196,0,0,0,0,0,45,38,151,42,0.0,858.4
203,5c962ea13cb9b937,5095b0920a3602aa,4cd8b03aee1d0138,2023-02-11,0,0,0,900,7,1,190,62,187,3,0,0,3,1,56,49,131,61,38.6,797.0
204,51a12878b151d67b,4e30e4250cb08b61,ac7c765882f2c68c,2023-02-11,0,1,1,344,3,2,27,5,25,2,0,0,2,1,19,12,6,4,10.3,253.9
205,51a12878b151d67b,ac7c765882f2c68c,4e30e4250cb08b61,2023-02-11,0,0,0,344,0,0,29,12,24,5,1,1,4,4,5,4,19,8,54.1,214.7
206,4f672dd40867d8c6,6b453bc35a823c3f,c6aee362c7a7d482,2023-02-11,1,1,1,133,0,0,31,9,20,11,0,0,11,7,8,5,12,2,12.7,118.0
207,4f672dd40867d8c6,c6aee362c7a7d482,6b453bc35a823c3f,2023-02-11,0,0,0,133,0,0,39,6,39,0,0,0,0,0,6,5,33,6,0.0,120.3
208,28af78600d6580f1,a9da3158dd2c2b5a,da4628f173337902,2023-02-11,0,0,0,900,5,4,123,45,114,9,0,0,9,8,42,37,72,37,98.2,502.5
209,28af78600d6580f1,da4628f173337902,a9da3158dd2c2b5a,2023-02-11,0,2,0,900,3,1,102,26,94,8,0,0,8,7,34,24,60,19,37.5,665.8
210,256894b49303537b,275aca31f61ba28c,e1248941344b3288,2023-02-11,0,0,0,1500,9,4,95,36,95,0,0,0,0,0,23,21,72,36,0.0,965.2
211,256894b49303537b,e1248941344b3288,275aca31f61ba28c,2023-02-11,1,0,0,1500,4,0,143,37,135,8,0,0,8,6,47,33,88,31,77.8,1325.0
212,2208b9f471a201d9,cbf5e6f231b55443,fba03cd6cc28dc41,2023-02-11,0,1,1,559,0,0,107,36,96,11,0,0,11,8,31,26,65,28,0.0,408.2
213,2208b9f471a201d9,fba03cd6cc28dc41,cbf5e6f231b55443,2023-02-11,0,0,0,559,4,1,52,17,42,10,1,1,9,7,7,4,35,10,150.8,378.0
214,16dbe70eb7007f17,102a8fdf8cbf7467,51c655162e462ceb,2023-02-11,1,0,0,59,0,0,22,8,21,1,0,0,1,0,6,6,15,8,0.0,59.0
215,16dbe70eb7007f17,51c655162e462ceb,102a8fdf8cbf7467,2023-02-11,0,0,0,59,0,0,4,0,4,0,0,0,0,0,3,1,1,0,0.0,59.0
216,0ac5fc42ba039211,48a9a128784d53d1,aceffa19749c4dc0,2023-02-11,0,0,0,900,3,0,157,30,157,0,0,0,0,0,56,39,101,30,0.0,900.0
217,0ac5fc42ba039211,aceffa19749c4dc0,48a9a128784d53d1,2023-02-11,0,0,0,900,4,0,169,64,169,0,0,0,0,0,9,6,160,64,0.0,769.0
218,caeeb398f73d213a,d3df1add9d9a7efb,e2f6b2769aaedd6c,2023-02-04,0,0,0,185,0,0,3,0,3,0,0,0,0,0,1,0,2,0,0.0,33.0
219,caeeb398f73d213a,e2f6b2769aaedd6c,d3df1add9d9a7efb,2023-02-04,0,1,1,185,8,6,21,12,3,18,0,0,18,12,0,0,3,0,152.0,33.0
220,c63d8062c89c4c33,21b5c82c1b89dab1,a01a62132460a98d,2023-02-04,0,0,0,276,1,0,24,6,24,0,0,0,0,0,4,4,20,6,0.0,164.9
221,c63d8062c89c4c33,a01a62132460a98d,21b5c82c1b89dab1,2023-02-04,1,0,0,276,7,4,33,16,26,7,0,0,7,6,10,5,16,10,110.1,103.0
222,b1b20c686dfe3204,57186c150c645200,a72a2a769fa5a2be,2023-02-04,0,0,0,524,0,0,25,2,23,2,0,0,2,2,15,12,8,0,3.6,88.0
223,b1b20c686dfe3204,a72a2a769fa5a2be,57186c150c645200,2023-02-04,1,1,0,524,5,2,51,36,14,37,1,1,36,31,3,1,11,5,427.0,93.4
224,a8067e65eb737a09,148bb103cfbf123e,d8c811df0386d5e8,2023-02-04,0,0,0,33,0,0,10,4,10,0,0,0,0,0,0,0,10,4,0.0,30.0
225,a8067e65eb737a09,d8c811df0386d5e8,148bb103cfbf123e,2023-02-04,2,0,0,33,0,0,25,11,24,1,0,0,1,1,0,0,24,10,3.0,30.0
226,a26ca06cce403ce2,4461d7e47375a895,c051c2e12d692b8a,2023-02-04,0,2,1,260,1,1,1,1,0,1,0,0,1,1,0,0,0,0,229.0,31.0
227,a26ca06cce403ce2,c051c2e12d692b8a,4461d7e47375a895,2023-02-04,0,1,0,260,0,0,2,0,2,0,0,0,0,0,2,2,0,0,0.0,8.0
228,983fab4080743ed0,0112352cb32f5026,285ae0b4a68221f4,2023-02-04,0,0,0,245,0,0,22,4,22,0,0,0,0,0,6,4,16,4,0.0,67.0
229,983fab4080743ed0,285ae0b4a68221f4,0112352cb32f5026,2023-02-04,0,1,1,245,3,1,38,20,27,11,0,0,11,10,5,5,22,10,178.0,67.0
230,98094a500529d442,adccbc19b22e19af,b671bdf981ad527d,2023-02-04,1,0,0,791,2,0,69,12,69,0,0,0,0,0,15,8,54,12,0.0,633.0
231,98094a500529d442,b671bdf981ad527d,adccbc19b22e19af,2023-02-04,0,3,1,791,3,1,91,20,91,0,0,0,0,0,30,18,61,20,0.0,684.0
232,8741e6a3a5a22a7f,1788eee370f077b7,c9cf753cfdf77fc2,2023-02-04,0,0,0,900,0,0,113,24,113,0,0,0,0,0,15,10,98,24,0.0,605.0
233,8741e6a3a5a22a7f,c9cf753cfdf77fc2,1788eee370f077b7,2023-02-04,0,0,0,900,1,1,103,12,102,1,1,1,0,0,32,27,70,12,295.0,605.0
234,7a1abc0230af730c,74f9448b97bf8bec,cc7040fe76f0ef91,2023-02-04,0,0,0,900,5,1,52,11,52,0,0,0,0,0,10,7,42,11,0.0,484.9
235,7a1abc0230af730c,cc7040fe76f0ef91,74f9448b97bf8bec,2023-02-04,0,0,0,900,11,3,70,22,66,4,0,0,4,2,19,17,47,20,67.1,598.0
236,765482eb58e8db48,3f11fd1751fa83b1,d008d785f6347dc2,2023-02-04,0,0,0,900,21,5,58,17,53,5,1,1,4,3,9,6,44,14,207.9,401.0
237,765482eb58e8db48,d008d785f6347dc2,3f11fd1751fa83b1,2023-02-04,0,0,0,900,0,0,57,18,57,0,0,0,0,0,7,7,50,18,0.0,642.1
238,01e8868086004dd8,31f8081c7600da93,e93b04e308913c2e,2023-02-04,0,0,0,900,10,5,58,10,58,0,0,0,0,0,17,10,41,10,0.0,347.8
239,01e8868086004dd8,e93b04e308913c2e,31f8081c7600da93,2023-02-04,0,0,0,900,0,0,78,11,56,22,20,20,2,1,21,19,35,10,218.2,662.0
240,fffdc57255274be1,2f5cbecbbe18bac4,41e83a89929d1327,2023-01-21,0,0,0,476,0,0,1,1,1,0,0,0,0,0,0,0,1,1,0.0,28.0
241,fffdc57255274be1,41e83a89929d1327,2f5cbecbbe18bac4,2023-01-21,1,0,0,476,5,3,57,44,5,52,0,0,52,44,2,1,3,0,448.0,28.0
242,fcf385ae75191b57,68d35296f566792b,862b0b3375aa4b6e,2023-01-21,0,0,0,900,0,0,211,58,211,0,0,0,0,0,61,44,150,58,0.0,778.0
243,fcf385ae75191b57,862b0b3375aa4b6e,68d35296f566792b,2023-01-21,0,0,0,900,0,0,251,89,251,0,0,0,0,0,31,28,220,89,0.0,892.0
244,f09c3d8a26806761,9d19d9e4aa2662e8,d317a5e2b3f88c5f,2023-01-21,0,0,0,900,1,0,248,75,247,1,0,0,1,1,53,44,194,74,6.7,658.0
245,f09c3d8a26806761,d317a5e2b3f88c5f,9d19d9e4aa2662e8,2023-01-21,0,0,0,900,3,1,144,45,144,0,0,0,0,0,27,21,117,45,0.0,764.3
246,dde7d29cc443e263,5444c5a201d3ee5a,7ff97850e8c32bda,2023-01-21,0,0,0,1500,0,0,402,180,368,34,3,3,31,23,56,49,312,157,127.3,1170.4
247,dde7d29cc443e263,7ff97850e8c32bda,5444c5a201d3ee5a,2023-01-21,0,0,0,1500,17,2,160,52,151,9,0,0,9,5,24,23,127,47,123.6,1166.7
248,a3ef3d05ddd80a94,140745cbbcb023ac,260bd4cef10b033f,2023-01-21,0,0,0,245,0,0,31,4,31,0,0,0,0,0,14,13,17,4,0.0,228.8
249,a3ef3d05ddd80a94,260bd4cef10b033f,140745cbbcb023ac,2023-01-21,1,0,0,245,2,0,41,16,37,4,0,0,4,3,6,5,31,13,15.2,207.0
250,911b73db91738da6,809bd1a871491508,eb393afdbe3293d5,2023-01-21,0,0,0,437,2,0,49,10,47,2,2,2,0,0,4,2,43,10,68.0,301.0
251,911b73db91738da6,eb393afdbe3293d5,809bd1a871491508,2023-01-21,1,0,0,437,4,1,49,16,49,0,0,0,0,0,19,18,30,16,0.0,322.0
252,8cdcdfb76d1670dd,20bccc9bb4ceb23e,d945aae53e3e54e6,2023-01-21,0,0,0,545,0,0,50,2,50,0,0,0,0,0,31,21,19,2,0.0,267.2
253,8cdcdfb76d1670dd,d945aae53e3e54e6,20bccc9bb4ceb23e,2023-01-21,0,1,1,545,7,4,33,14,23,10,0,0,10,10,8,8,15,4,275.8,214.0
254,7ed9e8f3258446c7,01641ba5df0c69b0,49ee5024966efc0d,2023-01-21,0,1,1,49,0,0,22,6,22,0,0,0,0,0,4,3,18,6,0.0,45.0
255,7ed9e8f3258446c7,49ee5024966efc0d,01641ba5df0c69b0,2023-01-21,0,0,0,49,1,0,13,0,13,0,0,0,0,0,9,9,4,0,0.0,49.0
256,5ad8aa57c8d69680,1e719d4b676dc19a,d1c65d2cf2925ddd,2023-01-21,1,0,0,253,2,0,45,15,44,1,0,0,1,1,8,7,36,14,0.5,252.0
257,5ad8aa57c8d69680,d1c65d2cf2925ddd,1e719d4b676dc19a,2023-01-21,0,0,0,253,0,0,41,16,41,0,0,0,0,0,6,5,35,16,0.0,242.5
258,354dc211166a3982,6fc506e1099afe20,bf7ad5628363eec9,2023-01-21,0,0,0,900,4,1,181,31,181,0,0,0,0,0,68,49,113,31,0.0,806.0
259,354dc211166a3982,bf7ad5628363eec9,6fc506e1099afe20,2023-01-21,0,0,0,900,2,0,189,62,189,0,0,0,0,0,50,41,139,62,0.0,900.0
260,2d1ac675e6c1e6ea,c21f26bbde777573,eabf206b162b3b83,2023-01-21,1,0,0,136,0,0,20,12,14,6,0,0,6,5,4,4,10,7,2.2,132.0
261,2d1ac675e6c1e6ea,eabf206b162b3b83,c21f26bbde777573,2023-01-21,0,0,0,136,0,0,8,0,8,0,0,0,0,0,5,3,3,0,0.0,133.8
262,1d35e4c0941d1397,72ea1984c52019b5,850266b3dc4e506e,2023-01-21,0,0,0,438,5,0,70,7,70,0,0,0,0,0,23,16,47,7,0.0,300.0
263,1d35e4c0941d1397,850266b3dc4e506e,72ea1984c52019b5,2023-01-21,1,0,0,438,1,0,78,31,77,1,0,0,1,1,26,22,51,30,3.0,378.0
264,1c51f405e5c46572,23024fdfc966410a,84b3e7d38f2d2ec5,2023-01-21,0,1,1,255,1,1,6,4,4,2,0,0,2,2,1,1,3,2,155.0,100.0
265,1c51f405e5c46572,84b3e7d38f2d2ec5,23024fdfc966410a,2023-01-21,0,0,0,255,0,0,11,2,11,0,0,0,0,0,3,2,8,2,0.0,100.0
266,0462bcc27498f7c4,792be9a24df82ed6,aa72b0f831d0bfe5,2023-01-21,1,0,0,900,6,3,74,37,58,16,3,3,13,8,10,8,48,29,299.6,453.0
267,0462bcc27498f7c4,aa72b0f831d0bfe5,792be9a24df82ed6,2023-01-21,0,2,0,900,2,1,43,8,35,8,0,0,8,4,13,11,22,4,35.0,565.4
268,0221982930283140,6a1901c62ab3870f,729d4bd5a6cd0a97,2023-01-21,0,0,0,900,1,1,369,161,368,1,1,1,0,0,76,69,292,161,2.3,829.0
269,0221982930283140,729d4bd5a6cd0a97,6a1901c62ab3870f,2023-01-21,0,0,0,900,15,0,293,81,293,0,0,0,0,0,25,19,268,81,0.0,888.7
270,d4420be78065de03,64facb6cc564262d,9d83f6da776ff7d6,2023-01-14,0,0,0,499,3,0,107,35,107,0,0,0,0,0,6,4,101,35,0.0,493.0
271,d4420be78065de03,9d83f6da776ff7d6,64facb6cc564262d,2023-01-14,1,0,0,499,1,1,128,56,128,0,0,0,0,0,27,26,101,56,0.0,489.0
272,c9144a294c73b06f,253076a23d03dcd0,798e48f9e7f6ba22,2023-01-14,0,1,1,196,4,2,11,2,11,0,0,0,0,0,6,4,5,2,0.0,53.0
273,c9144a294c73b06f,798e48f9e7f6ba22,253076a23d03dcd0,2023-01-14,0,0,0,196,0,0,7,2,7,0,0,0,0,0,2,1,5,2,0.0,196.0
274,c88a7dbe7717d2da,29af297d9f1de0f8,82a5152216251682,2023-01-14,0,0,0,553,1,0,100,22,100,0,0,0,0,0,19,14,81,22,0.0,552.0
275,c88a7dbe7717d2da,82a5152216251682,29af297d9f1de0f8,2023-01-14,1,0,0,553,1,1,74,17,74,0,0,0,0,0,20,17,54,17,0.0,535.0
276,b6723b9c6ff4d594,09e62c450e754913,814e5233e2acf2ee,2023-01-14,0,0,0,273,3,1,13,3,13,0,0,0,0,0,7,4,6,3,0.0,150.0
277,b6723b9c6ff4d594,814e5233e2acf2ee,09e62c450e754913,2023-01-14,1,0,0,273,0,0,57,20,38,19,2,2,17,10,16,12,22,10,99.0,174.0
278,a4c7d59d340794c0,2b6fc1c02736833d,b9f28e7045fdfce7,2023-01-14,1,0,0,280,0,0,51,20,50,1,0,0,1,1,19,16,31,19,2.0,278.0
279,a4c7d59d340794c0,b9f28e7045fdfce7,2b6fc1c02736833d,2023-01-14,0,0,0,280,1,0,24,6,24,0,0,0,0,0,7,7,17,6,0.0,278.0
280,9f09e77e46f15766,0978385b2bd9ef9b,e4ba58725825412d,2023-01-14,0,1,0,900,0,0,44,14,44,0,0,0,0,0,2,0,42,14,0.0,395.2
281,9f09e77e46f15766,e4ba58725825412d,0978385b2bd9ef9b,2023-01-14,0,2,0,900,6,4,85,29,64,21,1,1,20,13,19,17,45,16,429.8,286.0
282,868c83e734dbbceb,0d8011111be000b2,881bf86d4cba8578,2023-01-14,0,0,0,1500,1,1,405,134,405,0,0,0,0,0,58,48,347,134,0.0,1248.0
283,868c83e734dbbceb,881bf86d4cba8578,0d8011111be000b2,2023-01-14,0,0,0,1500,1,0,269,67,269,0,0,0,0,0,62,56,207,67,0.0,1488.0
284,76b6058cddda9238,036e96c1c12b8a59,849c5d9979df5357,2023-01-14,0,0,0,900,3,1,93,25,92,1,0,0,1,1,17,9,75,24,3.4,512.6
285,76b6058cddda9238,849c5d9979df5357,036e96c1c12b8a59,2023-01-14,0,0,0,900,4,3,171,53,148,23,1,1,22,21,45,35,103,32,353.4,389.6
286,622cc4ef46913020,b9706f80d005036c,fc169c387b4b465d,2023-01-14,0,0,0,900,0,0,152,41,152,0,0,0,0,0,30,23,122,41,0.0,615.0
287,622cc4ef46913020,fc169c387b4b465d,b9706f80d005036c,2023-01-14,0,0,0,900,2,0,159,37,159,0,0,0,0,0,48,44,111,37,0.0,822.0
288,5a2fa552e70958d4,48812daf291a4e23,bbab3baf66128ae2,2023-01-14,0,0,0,900,11,2,88,21,85,3,0,0,3,2,16,8,69,19,83.4,553.6
289,5a2fa552e70958d4,bbab3baf66128ae2,48812daf291a4e23,2023-01-14,0,0,0,900,5,3,130,62,104,26,6,6,20,19,31,27,73,43,207.4,497.6
290,5305049e4215d263,972c456ff38b2015,eae431e70064e046,2023-01-14,0,0,0,328,0,0,31,6,31,0,0,0,0,0,13,13,18,6,0.0,312.0
291,5305049e4215d263,eae431e70064e046,972c456ff38b2015,2023-01-14,1,0,0,328,2,0,28,13,28,0,0,0,0,0,4,4,24,13,0.0,140.0
292,f87a7812733f7e8f,5d1b7e3dd9e11074,9ada30894bf04e19,2022-12-17,1,2,0,900,0,0,119,33,104,15,2,2,13,7,32,23,72,26,42.8,789.0
293,f87a7812733f7e8f,9ada30894bf04e19,5d1b7e3dd9e11074,2022-12-17,0,0,0,900,3,2,94,17,93,1,0,0,1,1,26,16,67,16,54.0,695.2
294,efc64d8aae5628c9,8c1ca54b5089d199,e132d47bd9efbbe0,2022-12-17,0,0,0,900,0,0,141,16,140,1,0,0,1,1,31,9,109,15,0.0,671.5
295,efc64d8aae5628c9,e132d47bd9efbbe0,8c1ca54b5089d199,2022-12-17,0,0,0,900,11,6,98,29,77,21,0,0,21,10,28,20,49,19,228.5,530.0
296,ed6203e849a2bf28,0fd5f4b838e890cc,50a28b9f8314e008,2022-12-17,0,3,1,530,2,0,18,3,18,0,0,0,0,0,6,4,12,3,0.0,56.60000000000002
297,ed6203e849a2bf28,50a28b9f8314e008,0fd5f4b838e890cc,2022-12-17,0,1,0,530,12,5,30,8,11,19,1,1,18,5,2,2,9,3,448.4,58.0
298,e0444752d18fda7f,0d65c432720accb9,f14f644d41ade29f,2022-12-17,1,0,0,196,0,0,29,13,1,28,2,2,26,13,0,0,1,0,72.0,124.0
299,e0444752d18fda7f,f14f644d41ade29f,0d65c432720accb9,2022-12-17,0,0,0,196,3,3,2,0,2,0,0,0,0,0,0,0,2,0,0.0,11.0
300,d95eeba3de7ecac5,3fa97913cfd205d3,6d35bf94f7d30241,2022-12-17,0,0,0,733,0,0,71,6,71,0,0,0,0,0,16,11,55,6,0.0,379.0
301,d95eeba3de7ecac5,6d35bf94f7d30241,3fa97913cfd205d3,2022-12-17,2,0,0,733,4,1,81,23,58,23,4,4,19,10,10,10,48,13,354.0,379.0
302,ce7744d45a698aa6,135d124172a0bea3,eae48ff31db420c2,2022-12-17,0,0,0,900,0,0,86,18,85,1,0,0,1,0,26,18,59,18,0.5,781.0
303,ce7744d45a698aa6,eae48ff31db420c2,135d124172a0bea3,2022-12-17,0,0,0,900,21,7,81,14,80,1,0,0,1,1,24,20,56,13,113.0,334.5
304,ccb7e2851319345d,2f6a993c7f547c13,78f485f851891d68,2022-12-17,0,0,0,900,13,6,105,7,99,6,5,5,1,0,24,18,75,7,147.9,481.0
305,ccb7e2851319345d,78f485f851891d68,2f6a993c7f547c13,2022-12-17,0,0,0,900,2,0,106,10,106,0,0,0,0,0,28,16,78,10,0.0,752.1
306,c960184a583f1861,3351aa64aa83c4d9,4959f10a62f3fec3,2022-12-17,0,0,0,900,3,2,81,17,79,2,0,0,2,2,9,5,70,15,232.4,316.8
307,c960184a583f1861,4959f10a62f3fec3,3351aa64aa83c4d9,2022-12-17,0,1,0,900,0,0,74,20,66,8,3,3,5,4,17,10,49,16,2.2,664.6
308,c335f44e4f3515ea,519e4fe37ce9ff75,887961364be5ceb3,2022-12-17,1,0,0,465,1,0,121,16,120,1,1,1,0,0,34,17,86,16,3.5,458.0
309,c335f44e4f3515ea,887961364be5ceb3,519e4fe37ce9ff75,2022-12-17,0,0,0,465,1,0,142,50,142,0,0,0,0,0,29,23,113,50,0.0,450.5
310,9c1a2ac64c98d2f6,7aa3d6964eff4877,902ec2cc48c8ae8a,2022-12-17,1,0,0,184,0,0,30,9,24,6,0,0,6,3,11,7,13,6,5.0,179.0
311,9c1a2ac64c98d2f6,902ec2cc48c8ae8a,7aa3d6964eff4877,2022-12-17,0,0,0,184,0,0,22,2,22,0,0,0,0,0,11,8,11,2,0.0,179.0
312,8f00da6ea8186ce2,8f765fd5775a8873,f626118b6da0e020,2022-12-17,1,0,0,900,9,7,68,38,14,54,1,1,53,32,5,4,9,6,806.2,49.0
313,8f00da6ea8186ce2,f626118b6da0e020,8f765fd5775a8873,2022-12-17,0,0,0,900,1,0,16,1,16,0,0,0,0,0,5,2,11,1,0.0,93.79999999999995
314,5f4e944ff1bdcd9c,4aa58269d0664b5b,a845f0735bc67405,2022-12-17,3,0,0,900,5,3,116,34,87,29,2,2,27,11,25,9,62,23,206.2,618.5
315,5f4e944ff1bdcd9c,a845f0735bc67405,4aa58269d0664b5b,2022-12-17,0,1,0,900,2,1,89,23,88,1,0,0,1,0,12,9,76,23,25.5,591.8
316,4ea48bf2407b405d,0d8011111be000b2,13a0275fa13c4d26,2022-12-17,0,0,0,1500,1,1,400,126,400,0,0,0,0,0,35,26,365,126,0.0,1452.0
317,4ea48bf2407b405d,13a0275fa13c4d26,0d8011111be000b2,2022-12-17,0,0,0,1500,0,0,310,57,310,0,0,0,0,0,123,84,187,57,0.0,1500.0
318,fd7421f421e802bd,01fed6f61ebea01f,fe2babf95de24fb1,2022-12-10,0,0,0,164,0,0,8,3,8,0,0,0,0,0,1,1,7,3,0.0,164.0
319,fd7421f421e802bd,fe2babf95de24fb1,01fed6f61ebea01f,2022-12-10,0,2,1,164,3,2,7,2,7,0,0,0,0,0,2,1,5,2,0.0,32.0
320,ecab8b8b36727b8d,0d7b51c9d2649a6e,9ce6d5a03af801b7,2022-12-10,0,3,1,763,6,6,147,69,99,48,2,2,46,31,22,15,77,38,181.6,409.3
321,ecab8b8b36727b8d,9ce6d5a03af801b7,0d7b51c9d2649a6e,2022-12-10,0,0,0,763,1,1,70,26,61,9,1,1,8,4,12,8,49,22,20.7,558.4
322,a346180c8b109469,5442f1bc4b47eaf3,b9437600497350f3,2022-12-10,1,0,0,469,0,0,87,25,79,8,0,0,8,6,15,11,64,19,5.3,463.0
323,a346180c8b109469,b9437600497350f3,5442f1bc4b47eaf3,2022-12-10,0,0,0,469,0,0,163,27,163,0,0,0,0,0,29,23,134,27,0.0,463.7
324,a1a5d06b0e7ada62,262a7d06203657e6,aa171d55d4b5208f,2022-12-10,0,1,0,570,6,2,94,33,85,9,0,0,9,6,24,15,61,27,111.6,283.9
325,a1a5d06b0e7ada62,aa171d55d4b5208f,262a7d06203657e6,2022-12-10,1,0,0,570,4,2,151,61,131,20,0,0,20,14,28,26,103,47,38.1,378.4
326,5bc31abb5842942a,3c8a5200436e19f3,84512339473dd300,2022-12-10,1,0,0,853,0,0,89,38,61,28,1,1,27,20,19,14,42,18,279.3,289.0
327,5bc31abb5842942a,84512339473dd300,3c8a5200436e19f3,2022-12-10,0,1,0,853,9,5,29,8,24,5,0,0,5,2,4,3,20,6,175.0,293.7
328,4e9d76ed54f1f352,4144798612ef96e5,ce632027bf2a871b,2022-12-10,1,0,0,581,0,0,107,31,82,25,0,0,25,10,29,23,53,21,48.6,513.0
329,4e9d76ed54f1f352,ce632027bf2a871b,4144798612ef96e5,2022-12-10,0,0,0,581,4,0,48,6,48,0,0,0,0,0,24,17,24,6,0.0,517.4
330,4a17876e99f6baf3,54f64b5e283b0ce7,d9c6f19f958643e9,2022-12-10,1,1,1,490,0,0,77,34,68,9,0,0,9,8,14,6,54,26,54.0,352.7
331,4a17876e99f6baf3,d9c6f19f958643e9,54f64b5e283b0ce7,2022-12-10,0,0,0,490,9,1,82,22,80,2,0,0,2,1,25,14,55,21,59.3,347.0
332,3c3a9c1ec0604fc2,99df7d0a2a08a8a8,d802174b0c0c1f4e,2022-12-10,0,0,0,1500,0,0,117,19,116,1,0,0,1,0,46,36,70,19,0.0,928.8
333,3c3a9c1ec0604fc2,d802174b0c0c1f4e,99df7d0a2a08a8a8,2022-12-10,0,0,0,1500,10,2,184,49,142,42,2,2,40,20,43,27,99,29,571.2,820.0
334,2d9d966e0e8df232,21b813b919776d90,d31cbcdd7d69536d,2022-12-10,0,0,0,821,4,3,29,12,27,2,0,0,2,1,10,9,17,11,34.4,396.9
335,2d9d966e0e8df232,d31cbcdd7d69536d,21b813b919776d90,2022-12-10,0,1,1,821,7,2,38,20,32,6,0,0,6,5,5,4,27,15,269.1,203.6
336,1779cc4ae925df01,2cd428e9606856fd,d0aaedcf7ccd0b45,2022-12-10,1,0,0,23,0,0,21,12,17,4,0,0,4,3,0,0,17,9,4.8,17.0
337,1779cc4ae925df01,d0aaedcf7ccd0b45,2cd428e9606856fd,2022-12-10,0,0,0,23,0,0,1,1,1,0,0,0,0,0,0,0,1,1,0.0,18.2
338,144cd3f62591a5fb,7026eca45f65377b,7826923b47f8d72a,2022-12-10,0,0,0,900,6,3,103,32,100,3,0,0,3,2,41,28,59,30,129.3,509.8
339,144cd3f62591a5fb,7826923b47f8d72a,7026eca45f65377b,2022-12-10,0,0,0,900,3,0,155,33,154,1,0,0,1,1,33,30,121,32,2.2,735.7
340,f17813d03fcd8e7a,6a2f7c151031653d,a331233f597090a5,2022-12-03,0,2,1,500,6,4,25,3,11,14,13,13,1,1,4,4,7,2,326.1,86.5
341,f17813d03fcd8e7a,a331233f597090a5,6a2f7c151031653d,2022-12-03,0,0,0,500,0,0,29,6,27,2,0,0,2,2,11,8,16,4,17.5,138.89999999999998
342,ca0f0a35a1fcb453,cad24459b28592ca,d6c0cdd7e467c440,2022-12-03,1,0,0,465,1,1,94,27,63,31,5,5,26,15,19,17,44,12,116.1,304.3
343,ca0f0a35a1fcb453,d6c0cdd7e467c440,cad24459b28592ca,2022-12-03,0,0,0,465,8,0,79,14,78,1,0,0,1,0,24,23,54,14,14.7,304.9
344,be977e524ef56aa4,87c0b1c696ddfb43,92a9aa9c93192871,2022-12-03,0,0,0,900,7,2,222,80,179,43,0,0,43,30,34,30,145,50,145.4,687.0
345,be977e524ef56aa4,92a9aa9c93192871,87c0b1c696ddfb43,2022-12-03,0,0,0,900,5,2,193,47,193,0,0,0,0,0,17,10,176,47,0.0,706.6
346,a71764d5da04e3bc,0a1942069c9ad6b6,327d5f279895110d,2022-12-03,0,0,0,546,3,2,79,16,78,1,0,0,1,1,38,31,40,15,22.4,405.9
347,a71764d5da04e3bc,327d5f279895110d,0a1942069c9ad6b6,2022-12-03,1,3,0,546,0,0,54,23,39,15,0,0,15,12,3,2,36,11,28.1,493.6
348,a419e6df765aa755,3a46b268013afede,4a28cb716c19157a,2022-12-03,0,0,0,1200,6,2,210,52,210,0,0,0,0,0,79,67,131,52,0.0,1119.0
349,a419e6df765aa755,4a28cb716c19157a,3a46b268013afede,2022-12-03,1,0,0,1200,0,0,260,103,260,0,0,0,0,0,68,60,192,103,0.0,1153.0
350,972e17c1b98fca06,c62fbc117d57b943,f14cf73e51b29254,2022-12-03,0,0,0,54,0,0,10,2,10,0,0,0,0,0,1,0,9,2,0.0,48.0
351,972e17c1b98fca06,f14cf73e51b29254,c62fbc117d57b943,2022-12-03,2,0,0,54,0,0,44,23,36,8,0,0,8,6,1,0,35,17,6.0,45.0
352,92c1d9a6d313cb0c,32c355b04fc57f3a,511e82663651438d,2022-12-03,0,0,0,900,6,0,127,21,127,0,0,0,0,0,47,34,80,21,0.0,891.0
353,92c1d9a6d313cb0c,511e82663651438d,32c355b04fc57f3a,2022-12-03,0,0,0,900,3,0,181,37,178,3,0,0,3,1,65,46,113,36,9.0,870.0
354,7fbf09533c59e43f,8e382b585a92affe,d8da10db80131bec,2022-12-03,1,2,0,806,2,1,139,49,136,3,0,0,3,0,16,14,120,49,26.7,692.4
355,7fbf09533c59e43f,d8da10db80131bec,8e382b585a92affe,2022-12-03,0,0,0,806,2,0,247,66,239,8,0,0,8,8,50,44,189,58,24.6,690.3
356,7bd6969c4ed979f9,c47df9303d318c67,df1eb4354d18a906,2022-12-03,0,0,0,900,15,4,183,30,180,3,3,3,0,0,46,33,134,30,100.5,565.0
357,7bd6969c4ed979f9,df1eb4354d18a906,c47df9303d318c67,2022-12-03,0,0,0,900,0,0,166,55,166,0,0,0,0,0,20,10,146,55,0.0,781.5
358,5a8f7afc5ea69537,1a31ef98efce7a79,67c1d46f4ed16f9e,2022-12-03,2,0,0,404,1,1,42,23,25,17,0,0,17,14,11,9,14,9,47.0,357.0
359,5a8f7afc5ea69537,67c1d46f4ed16f9e,1a31ef98efce7a79,2022-12-03,0,0,0,404,0,0,59,16,59,0,0,0,0,0,9,4,50,16,0.0,357.0
360,30abc50a2e71c576,a29db9cd4f9ccea5,cda1099995b46cc2,2022-12-03,0,0,0,900,10,6,135,22,135,0,0,0,0,0,56,45,79,22,0.0,619.7
361,30abc50a2e71c576,cda1099995b46cc2,a29db9cd4f9ccea5,2022-12-03,0,0,0,900,0,0,158,26,155,3,1,1,2,2,36,22,119,24,0.3,899.0
362,2cec230248d7eb97,40cb680ae1cd331f,efc67b07eed39794,2022-12-03,2,0,0,546,3,0,154,54,121,33,1,1,32,21,18,12,103,33,124.7,373.0
363,2cec230248d7eb97,efc67b07eed39794,40cb680ae1cd331f,2022-12-03,1,0,0,546,0,0,60,20,58,2,2,0,0,0,17,16,41,20,3.0,406.3
364,1114cd1515cf3b8f,2804ce8dadab5770,5d495dec23d7c68e,2022-12-03,0,0,0,374,0,0,47,20,41,6,0,0,6,5,12,11,29,15,0.0,244.1
365,1114cd1515cf3b8f,5d495dec23d7c68e,2804ce8dadab5770,2022-12-03,1,0,0,374,3,1,81,20,74,7,2,2,5,4,1,1,73,16,129.9,207.0
366,0c9faf26efe2cdcc,02f8fedc18cbd26c,f0feeb2192937424,2022-12-03,0,0,0,900,2,0,173,49,173,0,0,0,0,0,26,22,147,49,0.0,900.0
367,0c9faf26efe2cdcc,f0feeb2192937424,02f8fedc18cbd26c,2022-12-03,0,0,0,900,0,0,345,95,345,0,0,0,0,0,105,87,240,95,0.0,900.0
368,d0c01840c72429c6,6b453bc35a823c3f,a6cba6bb66c1a8c9,2022-11-19,2,0,0,204,0,0,60,23,52,8,0,0,8,4,19,10,33,19,27.2,170.0
369,d0c01840c72429c6,a6cba6bb66c1a8c9,6b453bc35a823c3f,2022-11-19,0,0,0,204,1,0,33,2,33,0,0,0,0,0,4,3,29,2,0.0,161.8
370,c33257dd0605c7de,8667caa0451d245b,cd13728ae1151f46,2022-11-19,1,0,0,362,1,0,42,22,32,10,0,0,10,9,2,2,30,13,74.0,182.0
371,c33257dd0605c7de,cd13728ae1151f46,8667caa0451d245b,2022-11-19,0,0,0,362,8,2,26,7,25,1,0,0,1,1,3,2,22,6,106.0,76.0
372,c317f85a8266313e,33efaf2d0941cfcf,447f9858ae78f921,2022-11-19,0,0,0,663,0,0,66,10,66,0,0,0,0,0,11,7,55,10,0.0,498.7
373,c317f85a8266313e,447f9858ae78f921,33efaf2d0941cfcf,2022-11-19,1,0,0,663,3,1,95,38,68,27,0,0,27,18,25,18,43,20,144.3,476.0
374,bd064deb3494b41a,2c483cf443f38ece,37d752ec41ed84bb,2022-11-19,1,0,0,900,4,2,80,44,42,38,0,0,38,34,12,11,30,10,444.0,421.0
375,bd064deb3494b41a,37d752ec41ed84bb,2c483cf443f38ece,2022-11-19,0,0,0,900,0,0,154,55,154,0,0,0,0,0,30,28,124,55,0.0,455.0
376,b4cfb34e8224fd77,55fa6ce3e522c8bb,814e5233e2acf2ee,2022-11-19,0,0,0,900,4,1,234,36,233,1,0,0,1,1,115,83,118,35,7.0,837.0
377,b4cfb34e8224fd77,814e5233e2acf2ee,55fa6ce3e522c8bb,2022-11-19,0,0,0,900,2,0,209,64,209,0,0,0,0,0,67,51,142,64,0.0,836.0
378,a3696c847ef6c7f9,7af33fc4435017f1,9e92e1ca498d7244,2022-11-19,0,1,0,900,8,3,34,10,33,1,0,0,1,1,11,9,22,9,184.7,264.0
379,a3696c847ef6c7f9,9e92e1ca498d7244,7af33fc4435017f1,2022-11-19,0,1,0,900,2,1,44,13,43,1,0,0,1,1,8,8,35,12,82.0,633.3
380,594435375d641f63,37098a6e6c27fb66,46e0d677f91bacc0,2022-11-19,0,0,0,900,0,0,131,28,131,0,0,0,0,0,19,11,112,28,0.0,895.0
381,594435375d641f63,46e0d677f91bacc0,37098a6e6c27fb66,2022-11-19,0,0,0,900,12,1,103,28,103,0,0,0,0,0,11,10,92,28,0.0,772.0
382,33719a2d9c69ed17,262d32ebda89efc4,59c438c81fbf3ece,2022-11-19,1,0,0,687,3,0,72,26,68,4,0,0,4,3,22,19,46,23,76.0,554.0
383,33719a2d9c69ed17,59c438c81fbf3ece,262d32ebda89efc4,2022-11-19,0,2,0,687,7,1,47,8,47,0,0,0,0,0,14,10,33,8,0.0,315.0
384,144443d4dbf43990,8e1f36476ef02a6a,b4192a975027aab6,2022-11-19,0,0,0,900,0,0,253,84,253,0,0,0,0,0,29,25,224,84,0.0,796.0
385,144443d4dbf43990,b4192a975027aab6,8e1f36476ef02a6a,2022-11-19,0,0,0,900,0,0,272,55,272,0,0,0,0,0,35,25,237,55,0.0,900.0
386,110f539523a4b571,01b352b6a9074d5c,fc08099550072fe4,2022-11-19,0,0,0,900,2,1,177,25,177,0,0,0,0,0,47,41,130,25,0.0,806.0
387,110f539523a4b571,fc08099550072fe4,01b352b6a9074d5c,2022-11-19,0,0,0,900,0,0,278,124,278,0,0,0,0,0,31,23,247,124,0.0,887.0
388,0f2983fe7753403f,0c258d1d8e16e5f1,cd3d7e37ff2d679c,2022-11-19,1,0,0,900,13,7,81,33,64,17,0,0,17,13,11,8,53,20,196.2,302.8
389,0f2983fe7753403f,cd3d7e37ff2d679c,0c258d1d8e16e5f1,2022-11-19,0,1,0,900,5,2,115,65,74,41,0,0,41,35,3,3,71,30,297.2,326.8
390,ff2e4b411f695017,b4880ef2f838d4e1,d7c3816669784109,2022-11-12,0,0,0,900,0,0,263,46,263,0,0,0,0,0,39,31,224,46,0.0,890.0
391,ff2e4b411f695017,d7c3816669784109,b4880ef2f838d4e1,2022-11-12,0,0,0,900,2,2,202,55,202,0,0,0,0,0,32,19,170,55,0.0,657.0
392,db026ff6eee4d174,8c57c7b8c3bab0eb,9014c02eff8b3d62,2022-11-12,0,0,0,224,0,0,14,0,14,0,0,0,0,0,7,2,7,0,0.0,219.0
393,db026ff6eee4d174,9014c02eff8b3d62,8c57c7b8c3bab0eb,2022-11-12,1,0,0,224,0,0,23,8,20,3,0,0,3,2,8,6,12,6,5.0,219.0
394,bee95769a221af9a,1291edf2d566a71a,cc1a8b4b38b92c6d,2022-11-12,0,0,0,900,2,1,126,13,126,0,0,0,0,0,24,13,102,13,0.0,613.0
395,bee95769a221af9a,cc1a8b4b38b92c6d,1291edf2d566a71a,2022-11-12,1,0,0,900,3,0,106,39,87,19,0,0,19,11,11,9,76,28,281.0,545.0
396,93da91272d4a7ce3,51018a31ddf31eb2,669970f7feba8ecd,2022-11-12,0,0,0,217,0,0,13,2,13,0,0,0,0,0,6,5,7,2,0.0,49.0
397,93da91272d4a7ce3,669970f7feba8ecd,51018a31ddf31eb2,2022-11-12,0,2,1,217,1,1,38,22,19,19,0,0,19,18,4,3,15,4,168.0,49.0
398,85b5d59f8eea976a,1ebe20ebbfa15e29,d910665038efc639,2022-11-12,0,1,1,365,0,0,78,20,63,15,0,0,15,13,20,17,43,7,90.0,220.0
399,85b5d59f8eea976a,d910665038efc639,1ebe20ebbfa15e29,2022-11-12,0,0,0,365,4,1,32,6,31,1,0,0,1,0,1,0,30,6,55.0,220.0
400,7f93b2f38497caec,5bf31a46becc1204,a68575214ecad140,2022-11-12,2,0,0,291,0,0,53,28,41,12,0,0,12,10,4,4,37,18,12.9,277.0
401,7f93b2f38497caec,a68575214ecad140,5bf31a46becc1204,2022-11-12,1,0,0,291,1,0,73,19,73,0,0,0,0,0,12,7,61,19,0.0,266.1
402,77c78d0a71b10692,193b9d1858bc4df3,d747eb273a40a920,2022-11-12,1,1,0,546,0,0,63,8,58,5,5,5,0,0,24,16,34,8,128.0,418.0
403,77c78d0a71b10692,d747eb273a40a920,193b9d1858bc4df3,2022-11-12,0,1,0,546,8,0,18,1,18,0,0,0,0,0,6,4,12,1,0.0,410.0
404,6f22afbc5f8e0bd3,2e19380f34871c6a,a67f5afa8d6a1b80,2022-11-12,0,0,0,80,0,0,12,1,12,0,0,0,0,0,4,4,8,1,0.0,77.0
405,6f22afbc5f8e0bd3,a67f5afa8d6a1b80,2e19380f34871c6a,2022-11-12,1,0,0,80,1,0,17,7,16,1,0,0,1,1,1,1,15,6,3.0,77.0
406,65ce9335b93d9c57,4dcfb28c011c11b2,5f61780fe5e9b6d0,2022-11-12,0,1,0,900,3,1,86,22,83,3,0,0,3,3,32,19,51,19,75.0,400.8
407,65ce9335b93d9c57,5f61780fe5e9b6d0,4dcfb28c011c11b2,2022-11-12,0,2,0,900,11,8,96,32,81,15,0,0,15,7,13,10,68,25,399.2,346.0
408,4bf3010fdeea9d93,029eaff01e6bb8f0,4b93a88f3b1de35b,2022-11-12,0,2,1,720,0,0,76,34,70,6,0,0,6,3,5,4,65,31,28.2,362.2
409,4bf3010fdeea9d93,4b93a88f3b1de35b,029eaff01e6bb8f0,2022-11-12,0,0,0,720,7,3,100,32,78,22,0,0,22,16,20,11,58,16,310.8,352.8
410,40707ddc9fdea500,dccb63727f2f5f74,ee18ff42063174df,2022-11-12,1,0,0,150,0,0,27,10,25,2,0,0,2,2,3,1,22,8,0.8,148.0
411,40707ddc9fdea500,ee18ff42063174df,dccb63727f2f5f74,2022-11-12,0,0,0,150,0,0,22,6,22,0,0,0,0,0,5,4,17,6,0.0,149.2
412,1f922cfe6178e830,37ed1ab2f8b819f4,b6452706b373eea1,2022-11-12,0,0,0,200,1,0,25,6,25,0,0,0,0,0,9,8,16,6,0.0,186.0
413,1f922cfe6178e830,b6452706b373eea1,37ed1ab2f8b819f4,2022-11-12,0,1,1,200,1,0,33,10,33,0,0,0,0,0,1,0,32,10,0.0,166.0
414,09afa6ce4747a1a2,45f0cc9d18f35137,f2688492b9a525a3,2022-11-12,1,0,0,121,0,0,20,6,20,0,0,0,0,0,6,4,14,6,0.0,120.0
415,09afa6ce4747a1a2,f2688492b9a525a3,45f0cc9d18f35137,2022-11-12,0,0,0,121,0,0,12,0,12,0,0,0,0,0,7,2,5,0,0.0,121.0
416,04f32bb0c0d3a8cc,1338e2c7480bdf9e,e5549c82bfb5582d,2022-11-12,0,0,0,1321,4,1,162,41,152,10,2,2,8,4,57,43,95,37,281.4,925.3
417,04f32bb0c0d3a8cc,e5549c82bfb5582d,1338e2c7480bdf9e,2022-11-12,1,0,0,1321,1,1,157,42,156,1,0,0,1,1,68,49,88,41,1.7,1008.6
418,cfca30d3ef3c86b9,60a42bf82447c919,760a55d5b6098cbe,2022-11-05,0,1,1,459,0,0,169,45,145,24,0,0,24,23,51,45,94,22,0.0,459.0
419,cfca30d3ef3c86b9,760a55d5b6098cbe,60a42bf82447c919,2022-11-05,0,0,0,459,1,1,148,31,148,0,0,0,0,0,48,38,100,31,0.0,360.0
420,b87ac039e3b13940,3eb4dc9a7d4ac906,4f3064faf17aa711,2022-11-05,0,0,0,186,0,0,14,3,14,0,0,0,0,0,10,10,4,3,0.0,163.0
421,b87ac039e3b13940,4f3064faf17aa711,3eb4dc9a7d4ac906,2022-11-05,1,0,0,186,1,0,29,6,29,0,0,0,0,0,12,11,17,6,0.0,130.0
422,b279559f15ecf29b,84b3e7d38f2d2ec5,8a1f3b5c526cd6e6,2022-11-05,0,1,1,813,7,5,109,38,108,1,0,0,1,1,24,19,84,37,16.5,534.6
423,b279559f15ecf29b,8a1f3b5c526cd6e6,84b3e7d38f2d2ec5,2022-11-05,0,0,0,813,1,0,108,36,106,2,0,0,2,0,32,30,74,36,30.4,720.5
424,abfc03893551ae73,3df5493bb279226f,cd2c4d30c6e13b47,2022-11-05,1,1,0,654,2,1,53,16,52,1,0,0,1,1,17,13,35,15,37.2,453.0
425,abfc03893551ae73,cd2c4d30c6e13b47,3df5493bb279226f,2022-11-05,0,0,0,654,0,0,52,6,51,1,0,0,1,1,26,13,25,5,15.0,601.8
426,71afa8354da2491e,568bbad0eaced57c,f29a6350c69f4a33,2022-11-05,0,0,0,900,0,0,82,20,82,0,0,0,0,0,9,9,73,20,0.0,405.4
427,71afa8354da2491e,f29a6350c69f4a33,568bbad0eaced57c,2022-11-05,0,1,0,900,8,5,108,43,83,25,4,4,21,18,19,16,64,25,494.6,346.0
428,5475f5b6bad40989,9673a497a9da119a,d05cb1e8d1b885d8,2022-11-05,1,0,0,47,0,0,18,10,16,2,0,0,2,2,1,1,15,8,0.0,47.0
429,5475f5b6bad40989,d05cb1e8d1b885d8,9673a497a9da119a,2022-11-05,0,0,0,47,0,0,14,0,14,0,0,0,0,0,9,6,5,0,0.0,47.0
430,3adecfc4727a8d73,6e9f40c706f91f32,f00ac08ab056af5d,2022-11-05,0,0,0,131,0,0,10,2,9,1,0,0,1,1,2,2,7,1,0.0,68.3
431,3adecfc4727a8d73,f00ac08ab056af5d,6e9f40c706f91f32,2022-11-05,0,1,1,131,2,1,9,4,7,2,0,0,2,2,1,0,6,2,62.7,37.0
432,31cb98ce37fd87dd,1a54231796e24a3f,f6bcbd91b114ff58,2022-11-05,0,0,0,900,2,0,152,42,149,3,0,0,3,3,15,14,134,39,27.0,730.5
433,31cb98ce37fd87dd,f6bcbd91b114ff58,1a54231796e24a3f,2022-11-05,0,0,0,900,4,2,227,55,224,3,0,0,3,3,31,23,193,52,79.5,714.0
434,2ab395e21080b10a,773f7feacf96153e,bc711b6dd95c1af6,2022-11-05,0,0,0,294,0,0,25,6,21,4,0,0,4,4,11,11,10,2,0.0,138.0
435,2ab395e21080b10a,bc711b6dd95c1af6,773f7feacf96153e,2022-11-05,0,3,1,294,1,1,67,20,52,15,1,1,14,11,25,23,27,9,156.0,138.0
436,2664805fde34fb1b,0a73acff6325c1e2,34e516ab361afb1c,2022-11-05,1,0,0,67,0,0,36,19,10,26,0,0,26,15,0,0,10,4,33.0,34.0
437,2664805fde34fb1b,34e516ab361afb1c,0a73acff6325c1e2,2022-11-05,0,0,0,67,0,0,5,0,5,0,0,0,0,0,5,5,0,0,0.0,34.0
438,1535fb6549fa8bab,99bd51917728c25d,da0995f19b749cfa,2022-11-05,1,2,1,725,6,2,49,17,38,11,0,0,11,7,18,16,20,10,523.4,130.0
439,1535fb6549fa8bab,da0995f19b749cfa,99bd51917728c25d,2022-11-05,0,0,0,725,0,0,30,11,23,7,0,0,7,4,4,4,19,7,24.0,177.60000000000002
440,fdb9d29cf0edc16a,5ec591b78349ba7e,69888118d968ba52,2022-10-29,0,1,1,247,2,0,23,8,22,1,0,0,1,1,2,1,20,7,28.0,191.0
441,fdb9d29cf0edc16a,69888118d968ba52,5ec591b78349ba7e,2022-10-29,0,0,0,247,3,2,26,9,26,0,0,0,0,0,11,9,15,9,0.0,156.0
442,f32d918ee06cb83b,327d5f279895110d,547afe1017e72dbe,2022-10-29,1,1,0,249,0,0,42,15,40,2,0,0,2,2,4,3,36,13,0.7,247.0
443,f32d918ee06cb83b,547afe1017e72dbe,327d5f279895110d,2022-10-29,0,0,0,249,1,1,26,5,26,0,0,0,0,0,11,6,15,5,0.0,202.3
444,d6d141afdd31c3f1,285ae0b4a68221f4,8d20d76af3f213ce,2022-10-29,0,2,1,484,4,2,33,13,28,5,0,0,5,4,7,5,21,9,277.0,181.0
445,d6d141afdd31c3f1,8d20d76af3f213ce,285ae0b4a68221f4,2022-10-29,0,0,0,484,0,0,40,8,38,2,0,0,2,1,16,12,22,7,26.0,168.0
446,bf59d9f8bd9536f3,4b47e71384a9522f,b0d6a1d8ac3d563d,2022-10-29,0,0,0,900,5,3,115,18,112,3,2,2,1,1,49,27,63,17,21.8,526.1
447,bf59d9f8bd9536f3,b0d6a1d8ac3d563d,4b47e71384a9522f,2022-10-29,1,0,0,900,6,3,78,25,67,11,0,0,11,6,26,17,41,19,286.9,565.2
448,a554a72bb0377213,040a74bb0a465c54,751de04455cfaac0,2022-10-29,1,0,0,308,0,0,67,21,62,5,0,0,5,1,12,7,50,20,23.0,285.0
449,a554a72bb0377213,751de04455cfaac0,040a74bb0a465c54,2022-10-29,0,0,0,308,0,0,58,5,58,0,0,0,0,0,11,9,47,5,0.0,285.0
450,98b7dd0ddc52cffb,749f572d1d3161fb,e4277e87a789d687,2022-10-29,0,0,0,900,0,0,237,49,237,0,0,0,0,0,44,36,193,49,0.0,900.0
451,98b7dd0ddc52cffb,e4277e87a789d687,749f572d1d3161fb,2022-10-29,0,0,0,900,3,0,255,69,255,0,0,0,0,0,61,51,194,69,0.0,895.0
452,86dff1593d8b9a1f,971246648e162f0d,97cf1a2c7c5e7889,2022-10-29,0,0,0,92,1,0,30,7,30,0,0,0,0,0,5,3,25,7,0.0,75.0
453,86dff1593d8b9a1f,97cf1a2c7c5e7889,971246648e162f0d,2022-10-29,3,0,0,92,0,0,44,19,40,4,0,0,4,3,11,10,29,16,17.0,75.0
454,6a7db3750822d7be,147e70aa6cc48cfc,ca43de99b07b6b40,2022-10-29,0,1,1,349,4,3,20,7,20,0,0,0,0,0,6,3,14,7,0.0,183.0
455,6a7db3750822d7be,ca43de99b07b6b40,147e70aa6cc48cfc,2022-10-29,0,0,0,349,1,0,54,8,54,0,0,0,0,0,19,16,35,8,0.0,310.0
456,5dcba156bd13e0c3,3738e68d2261e60f,ab943cd2c3c17825,2022-10-29,0,0,0,110,0,0,5,1,5,0,0,0,0,0,2,1,3,1,0.0,20.0
457,5dcba156bd13e0c3,ab943cd2c3c17825,3738e68d2261e60f,2022-10-29,1,1,1,110,0,0,11,3,9,2,0,0,2,1,3,3,6,2,90.0,20.0
458,5b6bdaf89e493674,2b68d9f125d07b42,fc08099550072fe4,2022-10-29,0,0,0,900,1,0,138,12,138,0,0,0,0,0,46,44,92,12,0.0,887.0
459,5b6bdaf89e493674,fc08099550072fe4,2b68d9f125d07b42,2022-10-29,0,0,0,900,0,0,158,41,158,0,0,0,0,0,41,32,117,41,0.0,897.0
460,44abbf6b947be6de,7f6ed67d3ed3c036,b15862fcd6ded451,2022-10-29,0,0,0,900,8,4,37,13,20,17,2,2,15,8,2,2,18,5,752.0,137.0
461,44abbf6b947be6de,b15862fcd6ded451,7f6ed67d3ed3c036,2022-10-29,0,1,0,900,0,0,29,6,22,7,0,0,7,5,10,6,12,1,11.0,137.0
462,f4d8266a42a41dff,0845c81e37d3bcb3,1091d4d957141094,2022-10-22,0,0,0,900,1,1,81,35,77,4,0,0,4,3,9,7,68,32,14.5,634.2
463,f4d8266a42a41dff,1091d4d957141094,0845c81e37d3bcb3,2022-10-22,0,1,0,900,20,7,121,42,110,11,0,0,11,7,21,15,89,35,218.8,328.5
464,d325a1483d78ae75,45f7cb591c3ab00b,b1b0729d27936f2f,2022-10-22,0,0,0,587,5,0,118,40,118,0,0,0,0,0,20,18,98,40,0.0,587.0
465,d325a1483d78ae75,b1b0729d27936f2f,45f7cb591c3ab00b,2022-10-22,1,0,0,587,0,0,209,64,209,0,0,0,0,0,26,16,183,64,0.0,587.0
466,cea6760d7bfbe19b,029e1293e609fd74,684d3aee255a3d09,2022-10-22,0,0,0,900,4,1,67,29,65,2,0,0,2,1,12,11,53,28,158.3,409.9
467,cea6760d7bfbe19b,684d3aee255a3d09,029e1293e609fd74,2022-10-22,0,0,0,900,7,1,99,22,95,4,0,0,4,1,30,16,65,21,15.1,673.7
468,69f39e5d959311b1,08af939f41b5a57b,72db2a14ffa73ece,2022-10-22,1,0,0,900,0,0,130,35,124,6,0,0,6,5,30,24,94,30,22.7,866.0
469,69f39e5d959311b1,72db2a14ffa73ece,08af939f41b5a57b,2022-10-22,0,0,0,900,19,4,81,22,81,0,0,0,0,0,14,11,67,22,0.0,750.3
470,5c3c4bcc6c746ca0,b50a426a33da0012,d661ce4da776fc20,2022-10-22,0,0,0,900,1,0,163,63,162,1,0,0,1,0,31,21,131,63,0.4,691.6
471,5c3c4bcc6c746ca0,d661ce4da776fc20,b50a426a33da0012,2022-10-22,0,0,0,900,13,6,96,24,87,9,1,1,8,5,38,33,49,19,206.4,555.6
472,523815acf1bb2420,07225ba28ae309b6,275aca31f61ba28c,2022-10-22,0,0,0,496,1,0,39,7,34,5,1,1,4,1,15,11,19,6,16.2,301.5
473,523815acf1bb2420,275aca31f61ba28c,07225ba28ae309b6,2022-10-22,1,1,1,496,3,2,41,25,36,5,0,0,5,4,6,5,30,21,152.5,174.8
474,4011cdf1f182804c,2eeaefbfc7f9fcff,351c4ec637380ad5,2022-10-22,1,0,0,900,0,0,60,15,58,2,0,0,2,2,21,21,37,13,18.7,472.4
475,4011cdf1f182804c,351c4ec637380ad5,2eeaefbfc7f9fcff,2022-10-22,0,0,0,900,6,3,74,31,58,16,9,8,7,7,19,15,39,24,259.6,297.3
476,2d36e2c10ee349fe,4126a78111c0855a,ea7e5bc78d9de658,2022-10-22,0,2,0,900,2,1,32,13,23,9,0,0,9,9,9,6,14,4,332.0,284.0
477,2d36e2c10ee349fe,ea7e5bc78d9de658,4126a78111c0855a,2022-10-22,0,0,0,900,2,2,35,10,20,15,0,0,15,7,7,4,13,3,284.0,284.0
478,25f3e4fa781c1c8a,34ff304266360297,e872e9a9a902c045,2022-10-22,0,0,0,900,2,1,279,58,278,1,0,0,1,0,54,40,224,58,2.3,886.0
479,25f3e4fa781c1c8a,e872e9a9a902c045,34ff304266360297,2022-10-22,0,0,0,900,0,0,286,35,286,0,0,0,0,0,63,41,223,35,0.0,897.7
480,1f0d4572e0facbea,c849740a3ff51931,cb696ebfb6598724,2022-10-22,0,0,0,524,0,0,26,3,26,0,0,0,0,0,6,5,20,3,0.0,122.0
481,1f0d4572e0facbea,cb696ebfb6598724,c849740a3ff51931,2022-10-22,1,2,0,524,8,5,93,56,34,59,6,6,53,47,12,10,22,9,399.0,98.0
482,1e8c33b1917fe1b7,75353550928a7921,dee294e9717012c2,2022-10-22,0,1,1,866,7,6,30,13,18,12,3,3,9,9,5,5,13,4,618.0,149.4
483,1e8c33b1917fe1b7,dee294e9717012c2,75353550928a7921,2022-10-22,0,1,0,866,1,1,38,15,31,7,0,0,7,7,3,2,28,8,98.6,79.0
484,1b204fc28bb023e6,009c4420727149ea,369ea36e450ae62a,2022-10-22,0,0,0,900,3,3,161,38,161,0,0,0,0,0,25,20,136,38,0.0,851.0
485,1b204fc28bb023e6,369ea36e450ae62a,009c4420727149ea,2022-10-22,0,0,0,900,1,0,246,31,246,0,0,0,0,0,95,87,151,31,0.0,900.0
486,fac560495e61d34c,077e3ace32b72be9,4461d7e47375a895,2022-10-15,0,0,0,559,0,0,30,13,26,4,3,3,1,1,4,3,22,12,20.6,295.6
487,fac560495e61d34c,4461d7e47375a895,077e3ace32b72be9,2022-10-15,0,2,1,559,8,3,36,14,30,6,1,1,5,3,7,7,23,11,227.4,159.4
488,b4bbc1b7efa770f5,11583163f45c7b31,791c8437b341fba5,2022-10-15,0,0,0,122,0,0,2,0,2,0,0,0,0,0,1,1,1,0,0.0,122.0
489,b4bbc1b7efa770f5,791c8437b341fba5,11583163f45c7b31,2022-10-15,0,1,1,122,2,2,8,2,8,0,0,0,0,0,3,2,5,2,0.0,37.0
490,96d4fe315722d1c1,2f13e4020cea5b38,eb8d8c2a95cfccb8,2022-10-15,0,0,0,900,5,2,91,40,86,5,1,1,4,2,25,19,61,38,64.0,631.0
491,96d4fe315722d1c1,eb8d8c2a95cfccb8,2f13e4020cea5b38,2022-10-15,0,0,0,900,1,0,126,23,126,0,0,0,0,0,41,32,85,23,0.0,833.0
492,904cf687d22bb486,36541f1e6c5d4955,e8b731feff72294b,2022-10-15,0,0,0,1500,10,2,264,103,262,2,1,1,1,1,28,22,234,102,139.3,1291.0
493,904cf687d22bb486,e8b731feff72294b,36541f1e6c5d4955,2022-10-15,0,0,0,1500,0,0,311,101,310,1,0,0,1,1,68,52,242,100,0.0,1360.7
494,860050f211b44d10,12585614e0ed2626,d4270315cbcf2569,2022-10-15,0,0,0,900,0,0,102,29,101,1,0,0,1,0,6,5,95,29,4.0,598.0
495,860050f211b44d10,d4270315cbcf2569,12585614e0ed2626,2022-10-15,0,0,0,900,13,9,164,78,149,15,0,0,15,13,6,5,143,65,298.0,439.0
496,84b04e8d6b251c54,0641c21bec209472,776d4262c4da38bf,2022-10-15,0,0,0,93,1,0,15,8,15,0,0,0,0,0,2,2,13,8,0.0,88.0
497,84b04e8d6b251c54,776d4262c4da38bf,0641c21bec209472,2022-10-15,1,0,0,93,0,0,33,12,29,4,0,0,4,3,10,10,19,9,5.0,78.0
498,8252a314c778b8e6,c0386644627a7ee5,cc351e408bbb7d43,2022-10-15,2,0,0,900,4,1,161,45,159,2,0,0,2,2,53,42,106,43,12.9,797.1
499,8252a314c778b8e6,cc351e408bbb7d43,c0386644627a7ee5,2022-10-15,0,0,0,900,3,1,181,43,174,7,0,0,7,4,42,33,132,39,57.9,796.1
500,759c55755d70f7ba,866fd7b1a6c90e7f,c878270af633eb11,2022-10-15,1,0,0,492,4,0,80,49,60,20,0,0,20,14,12,12,48,35,27.8,236.6
501,759c55755d70f7ba,c878270af633eb11,866fd7b1a6c90e7f,2022-10-15,0,1,0,492,5,3,41,20,27,14,1,0,13,11,5,5,22,9,184.4,161.2
502,60bd4d2878c85f70,e375cb5caf4717b6,e94085e821bd81de,2022-10-15,0,0,0,900,11,5,160,32,157,3,0,0,3,3,59,51,98,29,9.2,782.0
503,60bd4d2878c85f70,e94085e821bd81de,e375cb5caf4717b6,2022-10-15,0,0,0,900,1,0,155,55,154,1,0,0,1,0,20,14,134,55,2.0,860.8
504,59695aae245cca73,67f272324a030d00,a495f599e787614f,2022-10-15,0,0,0,88,4,0,8,2,8,0,0,0,0,0,3,3,5,2,0.0,86.2
505,59695aae245cca73,a495f599e787614f,67f272324a030d00,2022-10-15,1,0,0,88,0,0,17,6,14,3,0,0,3,3,2,2,12,3,1.8,85.0
506,1af23e7aa71a1d17,d247691a6c0e9034,f2477cf43c4975cc,2022-10-15,0,0,0,559,1,1,79,10,78,1,0,0,1,0,44,41,34,10,3.3,406.4
507,1af23e7aa71a1d17,f2477cf43c4975cc,d247691a6c0e9034,2022-10-15,2,0,0,559,1,0,102,40,78,24,2,2,22,11,23,20,55,29,132.6,345.7
508,ecc56a86a1eead9d,5580771f383e141f,ae7fe94f117f98cf,2022-10-01,0,0,0,488,1,0,83,22,83,0,0,0,0,0,28,17,55,22,0.0,477.0
509,ecc56a86a1eead9d,ae7fe94f117f98cf,5580771f383e141f,2022-10-01,1,0,0,488,0,0,90,26,76,14,0,0,14,7,23,19,53,19,11.0,477.0
510,de93fda66d203c26,98c23cb6da5b3352,e9a3aeb207578eea,2022-10-01,0,0,0,900,0,0,70,9,70,0,0,0,0,0,24,19,46,9,0.0,534.4
511,de93fda66d203c26,e9a3aeb207578eea,98c23cb6da5b3352,2022-10-01,0,0,0,900,6,3,48,32,33,15,3,3,12,12,5,3,28,20,363.6,391.0
512,d33814971932422a,7447e9f28508106a,c41d426cc7326d1b,2022-10-01,0,2,0,1500,11,2,151,45,143,8,0,0,8,6,19,16,124,39,298.1,822.9
513,d33814971932422a,c41d426cc7326d1b,7447e9f28508106a,2022-10-01,0,0,0,1500,0,0,195,53,187,8,1,1,7,6,68,59,119,47,118.1,950.9
514,a73e33dfce8fcfd8,b9f28e7045fdfce7,ec23c1be628d8057,2022-10-01,1,0,0,900,5,2,119,51,78,41,0,0,41,32,24,22,54,19,397.9,473.0
515,a73e33dfce8fcfd8,ec23c1be628d8057,b9f28e7045fdfce7,2022-10-01,0,0,0,900,2,0,57,5,57,0,0,0,0,0,10,6,47,5,0.0,502.1
516,8c9ff13791378784,2f181c0467965b98,4e06913c91da5200,2022-10-01,0,1,1,257,1,1,6,1,4,2,0,0,2,1,2,2,2,0,144.0,20.0
517,8c9ff13791378784,4e06913c91da5200,2f181c0467965b98,2022-10-01,0,0,0,257,0,0,6,3,3,3,0,0,3,3,1,0,2,0,93.0,20.0
518,7d0d2cecab358ba1,a8283a4f415e1eb9,c6aee362c7a7d482,2022-10-01,0,0,0,900,4,1,67,20,60,7,0,0,7,7,23,20,37,13,280.9,548.6
519,7d0d2cecab358ba1,c6aee362c7a7d482,a8283a4f415e1eb9,2022-10-01,1,1,0,900,1,0,141,30,137,4,1,1,3,3,39,29,98,27,30.4,581.1
520,6c79db79da9ae874,325ad0dd9126d3df,d05412b513b19621,2022-10-01,0,0,0,64,0,0,7,0,7,0,0,0,0,0,4,2,3,0,0.0,64.0
521,6c79db79da9ae874,d05412b513b19621,325ad0dd9126d3df,2022-10-01,0,1,1,64,1,1,13,1,13,0,0,0,0,0,8,7,5,1,0.0,55.0
522,330506571d2778b1,19c591115a58982c,fb3e61720be4690c,2022-10-01,0,0,0,900,0,0,118,29,115,3,1,1,2,0,36,33,79,29,14.0,412.3
523,330506571d2778b1,fb3e61720be4690c,19c591115a58982c,2022-10-01,0,1,0,900,11,9,133,53,76,57,2,2,55,35,13,10,63,18,473.7,404.0
524,1aedd959f1523a27,94426bb170c88115,da4628f173337902,2022-10-01,0,1,1,30,0,0,9,1,9,0,0,0,0,0,8,8,1,1,0.0,28.0
525,1aedd959f1523a27,da4628f173337902,94426bb170c88115,2022-10-01,0,0,0,30,1,0,3,0,3,0,0,0,0,0,3,3,0,0,0.0,19.0
526,f521ecde1e96a1bd,29af297d9f1de0f8,b8bbdeff718dbb7d,2022-09-17,1,0,0,69,1,1,20,11,5,15,0,0,15,7,0,0,5,4,30.0,37.0
527,f521ecde1e96a1bd,b8bbdeff718dbb7d,29af297d9f1de0f8,2022-09-17,0,0,0,69,1,0,3,1,3,0,0,0,0,0,0,0,3,1,0.0,39.0
528,ec0740be19b2ef90,4e30e4250cb08b61,cffb87059e645bd1,2022-09-17,0,0,0,900,5,4,67,31,32,35,0,0,35,26,18,17,14,5,334.9,479.0
529,ec0740be19b2ef90,cffb87059e645bd1,4e30e4250cb08b61,2022-09-17,0,3,0,900,6,0,34,13,34,0,0,0,0,0,9,6,25,13,0.0,234.10000000000002
530,df370b97ea49e6b4,65f09bacd3957381,efb96bf3e9ada36f,2022-09-17,1,0,0,1200,14,1,222,62,219,3,0,0,3,3,36,32,183,59,75.7,973.0
531,df370b97ea49e6b4,efb96bf3e9ada36f,65f09bacd3957381,2022-09-17,0,0,0,1200,2,2,145,36,145,0,0,0,0,0,20,18,125,36,0.0,1025.3
532,d9f5d05b07bae09e,38c7f72747f4f712,a08ddd04eaffd81d,2022-09-17,0,1,1,439,7,3,14,0,14,0,0,0,0,0,9,4,5,0,0.0,128.6
533,d9f5d05b07bae09e,a08ddd04eaffd81d,38c7f72747f4f712,2022-09-17,0,1,0,439,0,0,58,36,33,25,0,0,25,25,5,3,28,11,23.4,410.0
534,ce5ebaf8caf8c4a7,093e1f5bb73850be,8e9eb3fc86db0f7d,2022-09-17,0,2,1,713,14,8,60,31,47,13,2,2,11,11,6,6,41,20,273.0,188.0
535,ce5ebaf8caf8c4a7,8e9eb3fc86db0f7d,093e1f5bb73850be,2022-09-17,0,0,0,713,0,0,53,16,53,0,0,0,0,0,9,9,44,16,0.0,415.0
536,be73f75b52b06f14,601964f9654f911a,bbab3baf66128ae2,2022-09-17,0,0,0,900,13,2,113,17,113,0,0,0,0,0,29,16,84,17,0.0,732.7
537,be73f75b52b06f14,bbab3baf66128ae2,601964f9654f911a,2022-09-17,0,0,0,900,4,2,149,50,144,5,0,0,5,5,36,30,108,45,64.3,707.0
538,bd06f1c2d7e6c4a0,c68c68efaa5ca6ef,d1c65d2cf2925ddd,2022-09-17,0,0,0,387,0,0,65,13,65,0,0,0,0,0,40,31,25,13,0.0,250.0
539,bd06f1c2d7e6c4a0,d1c65d2cf2925ddd,c68c68efaa5ca6ef,2022-09-17,1,0,0,387,3,1,90,34,69,21,0,0,21,7,16,14,53,27,37.0,313.0
540,adb78db5ba8ccc0f,8fd808923cffff82,9abc648e76c4493a,2022-09-17,0,2,0,900,3,1,142,48,142,0,0,0,0,0,17,11,125,48,0.0,642.0
541,adb78db5ba8ccc0f,9abc648e76c4493a,8fd808923cffff82,2022-09-17,0,0,0,900,3,0,170,38,170,0,0,0,0,0,57,43,113,38,0.0,893.0
542,8a044e5400b4318f,37f560436d745c18,87e2468b986ebb79,2022-09-17,1,0,0,229,0,0,45,22,35,10,0,0,10,9,4,2,31,13,5.0,224.0
543,8a044e5400b4318f,87e2468b986ebb79,37f560436d745c18,2022-09-17,0,0,0,229,0,0,40,7,40,0,0,0,0,0,14,8,26,7,0.0,224.0
544,46b9acec12a35d37,afe8d5b39ff7fca2,b27a1fcb56a3035a,2022-09-17,0,1,0,900,1,1,38,5,38,0,0,0,0,0,9,5,29,5,0.0,684.0
545,46b9acec12a35d37,b27a1fcb56a3035a,afe8d5b39ff7fca2,2022-09-17,0,0,0,900,5,2,46,10,46,0,0,0,0,0,17,15,29,10,0.0,771.0
546,3cbd3565dd631cc4,04c8b08b16a5b99e,d31a5546c0e9b213,2022-09-17,0,0,0,900,0,0,115,40,113,2,0,0,2,2,28,22,85,38,38.7,681.7
547,3cbd3565dd631cc4,d31a5546c0e9b213,04c8b08b16a5b99e,2022-09-17,0,1,0,900,7,3,86,32,84,2,0,0,2,2,5,4,79,30,160.3,380.3
548,35d06627d91b840d,4148802ae4a50768,cfc3e7bb44685289,2022-09-17,0,0,0,900,0,0,178,19,178,0,0,0,0,0,53,33,125,19,0.0,900.0
549,35d06627d91b840d,cfc3e7bb44685289,4148802ae4a50768,2022-09-17,0,0,0,900,9,1,168,22,168,0,0,0,0,0,59,49,109,22,0.0,862.0
550,160c17b8fcb0e2a1,70fa1c64a2c439ef,c1085e1701b13eca,2022-09-17,0,0,0,235,0,0,30,4,30,0,0,0,0,0,11,7,19,4,0.0,232.0
551,160c17b8fcb0e2a1,c1085e1701b13eca,70fa1c64a2c439ef,2022-09-17,1,0,0,235,0,0,45,12,44,1,0,0,1,1,3,2,41,11,3.0,232.0
552,db3e26d02d790c97,a7e3f02fe2b2fe30,d3f5d33d61cd00c9,2022-09-10,0,0,0,900,0,0,95,12,94,1,0,0,1,0,15,8,79,12,0.0,607.0
553,db3e26d02d790c97,d3f5d33d61cd00c9,a7e3f02fe2b2fe30,2022-09-10,1,0,0,900,2,2,110,32,91,19,1,1,18,12,29,19,62,20,293.0,499.0
554,d869eaea38426f06,c21f26bbde777573,cd13728ae1151f46,2022-09-10,0,3,1,277,1,1,3,3,2,1,0,0,1,1,0,0,2,2,65.0,65.7
555,d869eaea38426f06,cd13728ae1151f46,c21f26bbde777573,2022-09-10,0,0,0,277,1,1,5,2,3,2,0,0,2,1,1,1,2,1,81.3,90.0
556,bf334cb4e63f3430,7a5e8c94a86f9895,92fa1401b7927da3,2022-09-10,1,0,0,444,0,0,98,48,56,42,0,0,42,28,9,6,47,20,59.9,340.1
557,bf334cb4e63f3430,92fa1401b7927da3,7a5e8c94a86f9895,2022-09-10,1,1,0,444,2,1,98,40,86,12,0,0,12,10,13,11,73,30,36.9,298.1
558,a5cf273faa3982b7,3f4c3bc822bea45d,ac7c765882f2c68c,2022-09-10,0,0,0,900,2,1,78,10,75,3,2,2,1,0,38,33,37,10,44.2,670.4
559,a5cf273faa3982b7,ac7c765882f2c68c,3f4c3bc822bea45d,2022-09-10,1,0,0,900,3,3,70,15,64,6,0,0,6,6,26,23,38,9,67.6,641.8
560,86d57e8ef2191316,326a001926ffb7ec,f998f5c102250d6e,2022-09-10,0,0,0,900,9,1,108,14,108,0,0,0,0,0,48,30,60,14,0.0,791.0
561,86d57e8ef2191316,f998f5c102250d6e,326a001926ffb7ec,2022-09-10,0,0,0,900,2,0,66,10,66,0,0,0,0,0,20,13,46,10,0.0,883.0
562,7e8fd03e070d0c25,22a92d7f62195791,8355922d564b152c,2022-09-10,0,0,0,1072,3,1,172,23,172,0,0,0,0,0,66,57,106,23,0.0,1064.0
563,7e8fd03e070d0c25,8355922d564b152c,22a92d7f62195791,2022-09-10,0,1,1,1072,0,0,217,71,217,0,0,0,0,0,39,30,178,71,0.0,1072.0
564,77acb96700e89c92,0112352cb32f5026,830f60497fab345a,2022-09-10,2,0,0,592,1,0,161,53,148,13,1,1,12,5,29,19,119,48,27.4,533.0
565,77acb96700e89c92,830f60497fab345a,0112352cb32f5026,2022-09-10,0,0,0,592,5,0,111,44,111,0,0,0,0,0,21,16,90,44,0.0,529.6
566,6010f681e54ba2cd,1897b7b913736a7c,c7c39e2fb70248b3,2022-09-10,0,0,0,900,2,2,131,30,123,8,3,3,5,3,26,16,97,27,83.0,817.0
567,6010f681e54ba2cd,c7c39e2fb70248b3,1897b7b913736a7c,2022-09-10,0,0,0,900,0,0,143,25,139,4,2,2,2,2,23,12,116,23,0.0,817.0
568,0e6d624086f7952e,2c9d00968f818270,902ec2cc48c8ae8a,2022-09-10,0,0,0,900,0,0,147,43,146,1,0,0,1,1,38,31,108,42,0.6,827.5
569,0e6d624086f7952e,902ec2cc48c8ae8a,2c9d00968f818270,2022-09-10,0,0,0,900,6,2,188,60,179,9,0,0,9,9,39,32,140,51,60.5,637.4
570,fd47032108b85cf0,1e4f273069fb9e85,b4c57a8c2b773e82,2022-09-03,0,0,0,900,7,3,108,34,81,27,2,1,25,12,25,25,56,22,367.2,408.9
571,fd47032108b85cf0,b4c57a8c2b773e82,1e4f273069fb9e85,2022-09-03,0,0,0,900,5,1,96,13,89,7,0,0,7,3,22,15,67,10,83.1,437.8
572,cf9035f2fc2e232f,36b8f265bcd1b7a4,71505842fb6455c3,2022-09-03,1,0,0,19,0,0,7,6,5,2,0,0,2,2,1,1,4,4,1.0,17.0
573,cf9035f2fc2e232f,71505842fb6455c3,36b8f265bcd1b7a4,2022-09-03,0,0,0,19,0,0,2,0,2,0,0,0,0,0,1,0,1,0,0.0,18.0
574,ce62a50e97d497f9,06e4245d16fc5315,5e6294b37bbef029,2022-09-03,0,0,0,594,3,1,34,7,31,3,1,1,2,1,13,8,18,6,31.0,196.3
575,ce62a50e97d497f9,5e6294b37bbef029,06e4245d16fc5315,2022-09-03,0,1,1,594,7,2,22,9,14,8,0,0,8,7,6,6,8,2,304.7,144.0
576,ca7fd237c16cec84,7debc13b36343605,b4537562f88ac582,2022-09-03,1,0,0,195,0,0,47,17,42,5,0,0,5,4,5,2,37,13,2.0,193.0
577,ca7fd237c16cec84,b4537562f88ac582,7debc13b36343605,2022-09-03,0,0,0,195,0,0,27,5,27,0,0,0,0,0,2,1,25,5,0.0,193.0
578,b8ca1acdf3dc2f58,7acbb0972e75281a,e1147d3d2dabe1ce,2022-09-03,0,0,0,900,1,0,116,15,116,0,0,0,0,0,22,18,94,15,0.0,860.0
579,b8ca1acdf3dc2f58,e1147d3d2dabe1ce,7acbb0972e75281a,2022-09-03,0,0,0,900,1,1,166,49,163,3,0,0,3,2,28,25,135,47,12.0,888.0
580,acc9a109b00a99e1,329e403448756217,f1d64ae34e088832,2022-09-03,0,0,0,900,8,5,202,61,196,6,1,1,5,2,44,35,152,59,57.9,629.4
581,acc9a109b00a99e1,f1d64ae34e088832,329e403448756217,2022-09-03,0,0,0,900,2,1,203,56,202,1,0,0,1,1,38,30,164,55,0.6,818.1
582,810c9da07970c4a6,787bb1f087ccff8a,c62fbc117d57b943,2022-09-03,1,0,0,863,1,0,168,64,166,2,0,0,2,2,58,46,108,62,1.0,860.4
583,810c9da07970c4a6,c62fbc117d57b943,787bb1f087ccff8a,2022-09-03,1,0,0,863,0,0,89,17,87,2,0,0,2,2,28,12,59,15,1.6,858.0
584,7bced112f3229b1b,b7b84ccd221be298,c21a036b4e012f1c,2022-09-03,1,0,0,900,3,2,173,41,173,0,0,0,0,0,34,23,139,41,0.0,865.0
585,7bced112f3229b1b,c21a036b4e012f1c,b7b84ccd221be298,2022-09-03,0,0,0,900,0,0,196,26,196,0,0,0,0,0,74,47,122,26,0.0,900.0
586,3e2f00991f511607,b909a9a9688b5284,c2299ec916bc7c56,2022-09-03,0,0,0,316,3,1,37,13,37,0,0,0,0,0,7,7,30,13,0.0,115.4
587,3e2f00991f511607,c2299ec916bc7c56,b909a9a9688b5284,2022-09-03,3,0,0,316,1,1,67,35,45,22,0,0,22,16,8,7,37,19,180.6,119.0
588,398db40015b3c81c,082eba4cd80f736f,e1d40e8782d80bc2,2022-09-03,0,1,0,900,2,0,53,10,53,0,0,0,0,0,21,10,32,10,0.0,583.5
589,398db40015b3c81c,e1d40e8782d80bc2,082eba4cd80f736f,2022-09-03,0,0,0,900,5,3,70,14,65,5,1,1,4,2,26,17,39,12,302.5,416.0
590,20f316f96c9e4458,881bf86d4cba8578,b9437600497350f3,2022-09-03,0,2,0,900,7,2,109,40,98,11,0,0,11,7,19,11,79,33,123.6,664.0
591,20f316f96c9e4458,b9437600497350f3,881bf86d4cba8578,2022-09-03,0,0,0,900,3,0,174,27,174,0,0,0,0,0,29,19,145,27,0.0,747.4
592,1a191251620a84ca,77d7295d1b22c694,9d83f6da776ff7d6,2022-09-03,0,0,0,669,4,0,126,29,126,0,0,0,0,0,17,10,109,29,0.0,607.0
593,1a191251620a84ca,9d83f6da776ff7d6,77d7295d1b22c694,2022-09-03,1,0,0,669,0,0,122,37,122,0,0,0,0,0,22,22,100,37,0.0,668.0
594,f70c817388602681,f1b2aa7853d1ed6e,f1fac969a1d70b08,2022-08-20,0,0,0,1444,12,5,135,61,107,28,4,4,24,18,22,18,85,43,356.2,727.2
595,f70c817388602681,f1fac969a1d70b08,f1b2aa7853d1ed6e,2022-08-20,1,1,0,1444,5,1,75,20,69,6,0,0,6,6,37,35,32,14,80.8,912.8
596,e0b98f3cf4a7cc3b,c0badf3243907e59,c9cf753cfdf77fc2,2022-08-20,0,0,0,900,6,2,88,24,77,11,0,0,11,10,23,16,54,14,144.4,562.0
597,e0b98f3cf4a7cc3b,c9cf753cfdf77fc2,c0badf3243907e59,2022-08-20,0,0,0,900,0,0,98,30,96,2,2,2,0,0,22,15,74,30,36.0,647.6
598,d497d74a0df9e35e,01fed6f61ebea01f,7d420039bbfe7c1a,2022-08-20,0,0,0,900,7,3,167,63,164,3,0,0,3,2,32,25,132,61,56.7,541.0
599,d497d74a0df9e35e,7d420039bbfe7c1a,01fed6f61ebea01f,2022-08-20,0,0,0,900,3,0,132,51,132,0,0,0,0,0,25,21,107,51,0.0,841.3
600,6b9f82291930bfec,6d35bf94f7d30241,cdadae5363b66eef,2022-08-20,0,1,1,274,4,2,18,10,8,10,1,1,9,8,1,1,7,2,156.0,118.0
601,6b9f82291930bfec,cdadae5363b66eef,6d35bf94f7d30241,2022-08-20,0,0,0,274,0,0,15,2,15,0,0,0,0,0,12,9,3,2,0.0,118.0
602,5abcf9f282983acc,49e96ff8ab781589,f703250471acaf96,2022-08-20,1,0,0,65,0,0,11,5,7,4,0,0,4,2,1,1,6,3,4.0,61.0
603,5abcf9f282983acc,f703250471acaf96,49e96ff8ab781589,2022-08-20,0,0,0,65,0,0,4,0,4,0,0,0,0,0,2,2,2,0,0.0,61.0
604,4dac5258f22be059,1497e735d9f2560a,725b1abc9a39d873,2022-08-20,0,0,0,900,4,2,233,88,207,26,0,0,26,23,45,41,162,65,192.6,565.0
605,4dac5258f22be059,725b1abc9a39d873,1497e735d9f2560a,2022-08-20,0,0,0,900,4,0,181,74,178,3,0,0,3,1,18,13,160,73,9.0,671.4
606,2de6652160cc7b9f,00e11b5c8b7bfeeb,2e5c2aa8e4ab9d82,2022-08-20,0,0,0,900,4,1,70,23,69,1,0,0,1,1,30,28,39,22,15.7,582.0
607,2de6652160cc7b9f,2e5c2aa8e4ab9d82,00e11b5c8b7bfeeb,2022-08-20,0,0,0,900,2,2,103,37,84,19,7,7,12,10,35,29,49,27,271.0,556.3
608,2cd9e3796be57a79,3cf66c62d9069f43,fdbefee0827e1567,2022-08-20,1,1,0,544,3,2,81,29,54,27,0,0,27,21,16,10,38,8,255.2,251.0
609,2cd9e3796be57a79,fdbefee0827e1567,3cf66c62d9069f43,2022-08-20,0,0,0,544,0,0,42,7,42,0,0,0,0,0,24,19,18,7,0.0,284.8
610,2ac9b3ccb43422d8,12e0fdc606f7e274,4682bc59d5f55145,2022-08-20,2,0,0,900,7,1,176,46,171,5,0,0,5,3,68,45,103,43,100.0,700.0
611,2ac9b3ccb43422d8,4682bc59d5f55145,12e0fdc606f7e274,2022-08-20,0,1,0,900,0,0,157,53,157,0,0,0,0,0,24,20,133,53,0.0,778.0
612,2ac3ce1f62b3c4b9,c03520b5c88ed6b4,d0f3959b4a9747e6,2022-08-20,0,0,0,900,16,0,147,20,147,0,0,0,0,0,45,37,102,20,0.0,594.0
613,2ac3ce1f62b3c4b9,d0f3959b4a9747e6,c03520b5c88ed6b4,2022-08-20,0,0,0,900,0,0,67,11,67,0,0,0,0,0,32,27,35,11,0.0,900.0
614,0cf7a4593fd44e59,7026eca45f65377b,9c65736747ca92ec,2022-08-20,0,0,0,900,0,0,174,67,170,4,0,0,4,4,54,49,116,63,24.7,665.0
615,0cf7a4593fd44e59,9c65736747ca92ec,7026eca45f65377b,2022-08-20,0,0,0,900,3,0,81,21,81,0,0,0,0,0,21,15,60,21,0.0,821.3
616,06d6cde7479711ee,31bb0772f21cabd8,dc7927cd622676a7,2022-08-20,1,0,0,219,0,0,45,14,39,6,0,0,6,4,9,8,30,10,1.5,105.2
617,06d6cde7479711ee,dc7927cd622676a7,31bb0772f21cabd8,2022-08-20,1,0,0,219,0,0,83,48,30,53,1,1,52,40,11,9,19,8,110.8,102.5
618,f858f91453555291,318572f6f74b760d,436f970c9ea9169c,2022-08-13,0,0,0,213,0,0,47,17,47,0,0,0,0,0,7,5,40,17,0.0,138.9
619,f858f91453555291,436f970c9ea9169c,318572f6f74b760d,2022-08-13,1,0,0,213,2,1,60,26,30,30,3,3,27,18,11,8,19,8,74.1,129.0
620,efd7efba85092c6f,583ee11abddfc581,ffe9703408fb5964,2022-08-13,0,2,0,900,4,3,185,73,155,30,1,1,29,16,30,17,125,57,140.8,528.3
621,efd7efba85092c6f,ffe9703408fb5964,583ee11abddfc581,2022-08-13,1,0,0,900,6,1,174,62,142,32,0,0,32,20,16,9,126,42,66.7,686.2
622,e05a18b6ce22fa1f,52c2ae6d2f2d2613,da22387a0407a2dc,2022-08-13,0,1,0,900,1,1,150,43,121,29,1,1,28,15,23,19,98,28,235.2,608.0
623,e05a18b6ce22fa1f,da22387a0407a2dc,52c2ae6d2f2d2613,2022-08-13,0,1,0,900,5,1,69,10,69,0,0,0,0,0,27,17,42,10,0.0,433.8
624,d19e010f071a4b45,cc7040fe76f0ef91,e90a2f22417af68e,2022-08-13,0,0,0,678,0,0,52,4,52,0,0,0,0,0,23,10,29,4,0.0,462.9
625,d19e010f071a4b45,e90a2f22417af68e,cc7040fe76f0ef91,2022-08-13,1,0,0,678,1,0,106,41,51,55,21,20,34,26,20,18,31,15,189.1,458.0
626,b96c8fef6c9f92db,0c25d0a5e8cdbf19,8eb046f83e82bf26,2022-08-13,0,0,0,900,0,0,273,49,273,0,0,0,0,0,91,69,182,49,0.0,900.0
627,b96c8fef6c9f92db,8eb046f83e82bf26,0c25d0a5e8cdbf19,2022-08-13,0,0,0,900,0,0,188,50,188,0,0,0,0,0,19,16,169,50,0.0,894.0
628,abd50fad1e7b030b,6551c64fbcd1a467,b1e5bcaad32a3cac,2022-08-13,0,0,0,65,0,0,15,3,15,0,0,0,0,0,3,1,12,3,0.0,54.0
629,abd50fad1e7b030b,b1e5bcaad32a3cac,6551c64fbcd1a467,2022-08-13,1,0,0,65,0,0,35,15,17,18,5,4,13,10,3,1,14,5,11.0,54.0
630,8986373b4a6e90b6,98215d037be5bcb7,d343df8ba11f4c4e,2022-08-13,0,0,0,900,6,3,139,16,139,0,0,0,0,0,53,32,86,16,0.0,771.0
631,8986373b4a6e90b6,d343df8ba11f4c4e,98215d037be5bcb7,2022-08-13,0,0,0,900,1,0,133,17,133,0,0,0,0,0,39,22,94,17,0.0,900.0
632,833d67f423315d18,40cb680ae1cd331f,abcf2cc6efc42031,2022-08-13,0,0,0,900,0,0,218,52,218,0,0,0,0,0,59,34,159,52,0.0,887.0
633,833d67f423315d18,abcf2cc6efc42031,40cb680ae1cd331f,2022-08-13,0,0,0,900,2,0,181,42,181,0,0,0,0,0,33,24,148,42,0.0,866.0
634,38b6ef176439c39b,12ebd7d157e91701,6ac9bc2953c47345,2022-08-13,0,0,0,699,0,0,81,17,81,0,0,0,0,0,21,12,60,17,0.0,566.0
635,38b6ef176439c39b,6ac9bc2953c47345,12ebd7d157e91701,2022-08-13,1,1,1,699,6,1,114,28,95,19,0,0,19,10,22,18,73,18,132.0,567.0
636,11cc331fa40ede63,10f3ba6cd2f44a97,7c7332319c14094c,2022-08-13,0,0,0,1037,7,2,249,54,247,2,2,2,0,0,54,36,193,54,32.5,968.0
637,11cc331fa40ede63,7c7332319c14094c,10f3ba6cd2f44a97,2022-08-13,3,0,0,1037,0,0,156,35,152,4,0,0,4,2,35,26,117,33,4.0,994.5
638,0823f97be9c3a62e,6d68c1afe954f121,6e00cfffd54653c4,2022-08-13,0,0,0,179,0,0,41,7,41,0,0,0,0,0,9,8,32,7,0.0,176.0
639,0823f97be9c3a62e,6e00cfffd54653c4,6d68c1afe954f121,2022-08-13,1,0,0,179,0,0,25,7,23,2,0,0,2,1,10,6,13,6,3.0,176.0
640,eda397c27787afa4,0d65c432720accb9,d156513a19acf856,2022-08-06,2,0,0,116,0,0,37,18,20,17,2,2,15,10,2,2,18,8,53.8,59.0
641,eda397c27787afa4,d156513a19acf856,0d65c432720accb9,2022-08-06,0,0,0,116,1,0,11,1,11,0,0,0,0,0,2,2,9,1,0.0,62.2
642,b530bb13aac1e48b,809bd1a871491508,a2ccf35a88346a91,2022-08-06,0,1,1,137,1,1,37,15,35,2,0,0,2,1,3,3,32,14,20.8,85.0
643,b530bb13aac1e48b,a2ccf35a88346a91,809bd1a871491508,2022-08-06,0,0,0,137,1,0,16,6,16,0,0,0,0,0,5,3,11,6,0.0,116.2
644,b5274277ef6707c9,3351aa64aa83c4d9,7559395ad833c074,2022-08-06,0,2,1,363,4,3,22,11,21,1,0,0,1,1,3,2,18,10,280.0,83.0
645,b5274277ef6707c9,7559395ad833c074,3351aa64aa83c4d9,2022-08-06,0,0,0,363,0,0,34,5,34,0,0,0,0,0,8,8,26,5,0.0,78.0
646,a8bc6e005077bb0b,5444c5a201d3ee5a,dea070ed4a2a8281,2022-08-06,1,0,0,1051,0,0,152,68,128,24,0,0,24,18,21,21,107,50,45.9,876.5
647,a8bc6e005077bb0b,dea070ed4a2a8281,5444c5a201d3ee5a,2022-08-06,0,0,0,1051,20,6,94,28,91,3,1,1,2,1,27,24,64,27,88.5,651.1
648,a6b328733d610e2b,6d4b63c767106d3a,b997be68943010fc,2022-08-06,0,0,0,721,0,0,203,56,203,0,0,0,0,0,47,41,156,56,0.0,715.4
649,a6b328733d610e2b,b997be68943010fc,6d4b63c767106d3a,2022-08-06,2,0,0,721,3,1,211,113,208,3,0,0,3,1,9,8,199,112,5.6,674.0
650,a274ed04c36d40d4,5e6294b37bbef029,cc8c623cca88f54f,2022-08-06,0,0,0,77,1,1,13,6,7,6,0,0,6,6,2,2,5,0,44.0,33.0
651,a274ed04c36d40d4,cc8c623cca88f54f,5e6294b37bbef029,2022-08-06,0,1,1,77,0,0,4,1,4,0,0,0,0,0,3,3,1,1,0.0,33.0
652,4adef20ce69217be,8abac218746e04ca,f626118b6da0e020,2022-08-06,0,0,0,44,0,0,8,0,8,0,0,0,0,0,3,2,5,0,0.0,42.0
653,4adef20ce69217be,f626118b6da0e020,8abac218746e04ca,2022-08-06,1,0,0,44,0,0,10,4,8,2,0,0,2,1,4,3,4,3,2.0,42.0
654,36f38c2534ef646b,56f7d7ee06be4aab,da7f113b5ea39c43,2022-08-06,0,0,0,336,0,0,50,14,50,0,0,0,0,0,21,18,29,14,0.0,334.8
655,36f38c2534ef646b,da7f113b5ea39c43,56f7d7ee06be4aab,2022-08-06,1,0,0,336,1,0,40,11,37,3,0,0,3,2,1,1,36,9,1.2,334.0
656,2b11aa4b90b1dd41,4333a8e70a672eb7,aa0c573da7119292,2022-08-06,0,0,0,837,0,0,48,16,47,1,0,0,1,1,15,14,32,15,25.3,246.89999999999998
657,2b11aa4b90b1dd41,aa0c573da7119292,4333a8e70a672eb7,2022-08-06,1,1,0,837,4,4,85,43,46,39,0,0,39,25,13,11,33,18,514.1,231.7
658,044d210d7b1eb519,441eacbe20e0e80b,e2f6b2769aaedd6c,2022-08-06,0,0,0,522,0,0,23,1,23,0,0,0,0,0,9,7,14,1,0.0,102.0
659,044d210d7b1eb519,e2f6b2769aaedd6c,441eacbe20e0e80b,2022-08-06,1,1,0,522,8,6,49,33,15,34,0,0,34,24,0,0,15,9,397.0,125.0
660,e492dc60d8e44866,a01a62132460a98d,c32aeb1a59e6272d,2022-07-30,0,0,0,669,8,1,113,32,109,4,0,0,4,0,39,32,70,32,31.7,554.5
661,e492dc60d8e44866,c32aeb1a59e6272d,a01a62132460a98d,2022-07-30,2,0,0,669,1,0,151,74,144,7,0,0,7,7,11,9,133,67,3.5,625.3
662,96b62bd56b252bab,a0f0004aadf10b71,ab2b4ff41d6ebe0f,2022-07-30,0,1,1,91,1,1,12,7,12,0,0,0,0,0,1,1,11,7,0.0,25.0
663,96b62bd56b252bab,ab2b4ff41d6ebe0f,a0f0004aadf10b71,2022-07-30,0,0,0,91,1,0,14,9,14,0,0,0,0,0,1,1,13,9,0.0,91.0
664,81a18de517a3336a,029afd138865d20a,519e4fe37ce9ff75,2022-07-30,0,0,0,690,3,1,68,24,61,7,2,2,5,3,11,11,50,21,123.4,545.0
665,81a18de517a3336a,519e4fe37ce9ff75,029afd138865d20a,2022-07-30,1,0,0,690,0,0,151,38,149,2,0,0,2,2,30,24,119,36,4.0,562.6
666,72c3e5eacde4f0e5,3253b16d38ae087d,80fa8218c99f9c58,2022-07-30,0,1,0,1500,0,0,154,54,154,0,0,0,0,0,10,6,144,54,0.0,811.3
667,72c3e5eacde4f0e5,80fa8218c99f9c58,3253b16d38ae087d,2022-07-30,3,1,0,1500,8,6,152,67,118,34,0,0,34,28,24,18,94,39,688.7,791.0
668,66f7bb31d24b3b36,2c010b26a3306969,9edf2c9082cc2cd8,2022-07-30,0,0,0,900,8,3,52,14,41,11,2,2,9,6,12,9,29,8,249.0,332.2
669,66f7bb31d24b3b36,9edf2c9082cc2cd8,2c010b26a3306969,2022-07-30,0,0,0,900,1,0,98,28,97,1,0,0,1,0,43,35,54,28,1.8,583.0
670,5a2b86570110191b,1a9480fc288e55d7,3329d692aea4dc28,2022-07-30,0,0,0,900,0,0,116,28,116,0,0,0,0,0,26,19,90,28,0.0,537.0
671,5a2b86570110191b,3329d692aea4dc28,1a9480fc288e55d7,2022-07-30,1,0,0,900,4,3,110,51,77,33,0,0,33,26,8,7,69,25,363.0,504.0
672,5a1ce88ec1f75160,792be9a24df82ed6,853eb0dd5c0e2149,2022-07-30,1,0,0,874,3,0,151,43,135,16,1,1,15,10,17,14,118,33,37.9,805.0
673,5a1ce88ec1f75160,853eb0dd5c0e2149,792be9a24df82ed6,2022-07-30,0,0,0,874,2,1,110,24,104,6,0,0,6,5,39,29,65,19,24.0,812.1
674,579b5770129b328a,4aa58269d0664b5b,cdb96af67d096b1e,2022-07-30,1,0,0,900,1,1,229,32,221,8,0,0,8,5,59,42,162,27,63.2,739.6
675,579b5770129b328a,cdb96af67d096b1e,4aa58269d0664b5b,2022-07-30,0,0,0,900,4,0,194,92,193,1,0,0,1,1,15,14,178,91,2.4,812.8
676,52f87252af59e23b,d3df1add9d9a7efb,f14cf73e51b29254,2022-07-30,0,0,0,55,0,0,6,2,6,0,0,0,0,0,2,2,4,2,0.0,53.0
677,52f87252af59e23b,f14cf73e51b29254,d3df1add9d9a7efb,2022-07-30,1,0,0,55,0,0,24,15,22,2,0,0,2,1,0,0,22,14,2.0,53.0
678,1ed550f094ca7745,260bd4cef10b033f,8c57c7b8c3bab0eb,2022-07-30,0,0,0,513,0,0,70,26,69,1,0,0,1,1,12,12,57,25,0.0,474.9
679,1ed550f094ca7745,8c57c7b8c3bab0eb,260bd4cef10b033f,2022-07-30,1,0,0,513,3,2,95,44,89,6,0,0,6,3,11,7,78,41,38.1,272.0
680,189b9af881b96de6,7cbf7c78d3b34218,e132d47bd9efbbe0,2022-07-30,0,0,0,900,10,2,115,24,108,7,0,0,7,5,40,37,68,19,27.3,775.0
681,189b9af881b96de6,e132d47bd9efbbe0,7cbf7c78d3b34218,2022-07-30,0,0,0,900,11,3,57,23,57,0,0,0,0,0,12,11,45,23,0.0,698.7
682,058c2724dec1add1,d4c9dcd330403612,d802174b0c0c1f4e,2022-07-30,0,0,0,489,1,0,36,6,35,1,1,1,0,0,14,11,21,6,51.0,296.4
683,058c2724dec1add1,d802174b0c0c1f4e,d4c9dcd330403612,2022-07-30,1,0,0,489,0,0,79,31,47,32,3,3,29,19,16,12,31,12,141.6,292.0
684,0366e183296fea07,a20f234df70f2182,f9ab66e67240db7b,2022-07-30,0,0,0,900,0,0,193,33,192,1,1,1,0,0,60,44,132,33,1.7,853.1
685,0366e183296fea07,f9ab66e67240db7b,a20f234df70f2182,2022-07-30,0,0,0,900,3,1,234,31,231,3,0,0,3,2,128,70,103,29,27.9,777.3
686,f6fd50bf69bb59e6,329e403448756217,40093d1d2d78394e,2022-07-23,0,0,0,900,1,1,159,62,151,8,2,2,6,3,46,33,105,59,45.3,805.5
687,f6fd50bf69bb59e6,40093d1d2d78394e,329e403448756217,2022-07-23,0,1,0,900,9,2,167,21,165,2,0,0,2,2,47,30,118,19,9.5,802.7
688,e600b78e5a652dc0,297a2b35444c245b,9dedfdd91070ddd8,2022-07-23,0,1,0,900,1,0,93,26,92,1,0,0,1,0,27,26,65,26,3.1,818.4
689,e600b78e5a652dc0,9dedfdd91070ddd8,297a2b35444c245b,2022-07-23,0,0,0,900,6,2,110,21,109,1,0,0,1,1,30,18,79,20,26.6,470.9
690,dd6dbe644f599795,32c355b04fc57f3a,38c626ca912c7bac,2022-07-23,0,0,0,900,11,8,32,8,27,5,2,2,3,2,5,3,22,6,582.1,85.0
691,dd6dbe644f599795,38c626ca912c7bac,32c355b04fc57f3a,2022-07-23,0,0,0,900,1,0,10,3,10,0,0,0,0,0,3,2,7,3,0.0,317.9
692,d0fb381cacbb0446,399afbabc02376b5,fa6796c55d6c5440,2022-07-23,0,0,0,15,0,0,5,0,5,0,0,0,0,0,3,3,2,0,0.0,15.0
693,d0fb381cacbb0446,fa6796c55d6c5440,399afbabc02376b5,2022-07-23,1,0,0,15,0,0,10,2,10,0,0,0,0,0,2,2,8,2,0.0,14.0
694,b0d06858fb725654,5b86d491d63890c5,f6ad6a1e4d600e0d,2022-07-23,1,0,0,900,1,0,87,37,72,15,0,0,15,12,19,13,53,25,250.6,485.3
695,b0d06858fb725654,f6ad6a1e4d600e0d,5b86d491d63890c5,2022-07-23,0,0,0,900,3,0,105,16,102,3,1,1,2,0,34,26,68,16,13.7,512.4
696,a57969d4ba7d4a79,26e3f3928b1891d9,51018a31ddf31eb2,2022-07-23,0,0,0,232,5,0,33,5,33,0,0,0,0,0,7,4,26,5,0.0,154.9
697,a57969d4ba7d4a79,51018a31ddf31eb2,26e3f3928b1891d9,2022-07-23,1,0,0,232,1,0,52,20,47,5,0,0,5,3,6,4,41,17,7.1,222.0
698,a1029686c3f1bead,31f8081c7600da93,4c88a1db5a46c6a4,2022-07-23,0,0,0,900,4,0,62,15,62,0,0,0,0,0,28,26,34,15,0.0,688.5
699,a1029686c3f1bead,4c88a1db5a46c6a4,31f8081c7600da93,2022-07-23,0,0,0,900,1,0,64,16,63,1,0,0,1,1,21,20,42,15,25.5,543.0
700,925a36a4af600291,0a1942069c9ad6b6,5442f1bc4b47eaf3,2022-07-23,0,0,0,900,6,0,251,48,251,0,0,0,0,0,75,52,176,48,0.0,900.0
701,925a36a4af600291,5442f1bc4b47eaf3,0a1942069c9ad6b6,2022-07-23,0,0,0,900,0,0,125,18,125,0,0,0,0,0,36,25,89,18,0.0,900.0
702,8e02bdaac8ed50e5,7826923b47f8d72a,ac026518a9b4dc0f,2022-07-23,0,4,1,466,1,1,39,14,31,8,0,0,8,5,5,3,26,9,48.9,362.0
703,8e02bdaac8ed50e5,ac026518a9b4dc0f,7826923b47f8d72a,2022-07-23,0,0,0,466,9,3,22,5,22,0,0,0,0,0,14,11,8,5,0.0,127.1
704,47b1cd4e3e2595f8,0845c81e37d3bcb3,eabf206b162b3b83,2022-07-23,0,0,0,900,2,1,129,45,103,26,1,1,25,15,27,26,76,30,251.1,587.5
705,47b1cd4e3e2595f8,eabf206b162b3b83,0845c81e37d3bcb3,2022-07-23,0,0,0,900,15,0,126,18,123,3,0,0,3,0,24,15,99,18,3.5,641.9
706,3d35f25d9792a69a,87a1dc546b1c5caf,87c0b1c696ddfb43,2022-07-23,0,0,0,550,7,3,22,9,22,0,0,0,0,0,3,2,19,9,0.0,305.0
707,3d35f25d9792a69a,87c0b1c696ddfb43,87a1dc546b1c5caf,2022-07-23,1,0,0,550,5,4,112,75,65,47,4,4,43,33,14,11,51,42,160.0,264.0
708,2dbf9d8d6915711e,75353550928a7921,814e5233e2acf2ee,2022-07-23,0,0,0,900,26,12,29,5,28,1,1,1,0,0,11,6,17,5,234.7,185.2
709,2dbf9d8d6915711e,814e5233e2acf2ee,75353550928a7921,2022-07-23,0,0,0,900,0,0,22,3,20,2,1,1,1,1,16,8,4,2,10.8,638.3
710,1ff520024da5b3b2,1091d4d957141094,3c6976f8182d9527,2022-07-23,2,0,0,67,0,0,44,24,34,10,0,0,10,7,3,2,31,17,6.0,51.0
711,1ff520024da5b3b2,3c6976f8182d9527,1091d4d957141094,2022-07-23,0,0,0,67,0,0,8,4,7,1,0,0,1,0,1,1,6,4,7.0,54.0
712,1c84dafe38694c05,6f7c616b98e18c29,9d19d9e4aa2662e8,2022-07-23,0,0,0,900,12,4,21,4,21,0,0,0,0,0,8,7,13,4,0.0,360.2
713,1c84dafe38694c05,9d19d9e4aa2662e8,6f7c616b98e18c29,2022-07-23,0,1,0,900,1,1,94,32,80,14,0,0,14,8,16,13,64,24,102.8,643.0
714,ebefe958473b3843,64facb6cc564262d,ce632027bf2a871b,2022-07-16,1,0,0,328,1,0,35,8,31,4,0,0,4,4,10,9,21,4,1.8,274.5
715,ebefe958473b3843,ce632027bf2a871b,64facb6cc564262d,2022-07-16,0,0,0,328,2,2,22,6,20,2,0,0,2,2,6,5,14,4,49.5,227.2
716,e57bfadb506e4f51,3df5493bb279226f,eb04b9d31e938edb,2022-07-16,0,1,1,408,0,0,35,11,35,0,0,0,0,0,12,9,23,11,0.0,335.0
717,e57bfadb506e4f51,eb04b9d31e938edb,3df5493bb279226f,2022-07-16,0,0,0,408,2,1,56,7,54,2,0,0,2,2,32,22,22,5,68.0,340.0
718,dd456668731bd52a,447f9858ae78f921,e64b96c07d7ce999,2022-07-16,0,0,0,578,4,1,56,18,52,4,0,0,4,3,8,5,44,15,56.0,498.0
719,dd456668731bd52a,e64b96c07d7ce999,447f9858ae78f921,2022-07-16,1,0,0,578,2,1,87,13,83,4,0,0,4,2,38,25,45,11,10.0,492.0
720,d439374c1fc95581,98d961097baaf308,f1d64ae34e088832,2022-07-16,0,3,0,900,7,2,80,16,79,1,0,0,1,1,33,26,46,15,20.3,505.7
721,d439374c1fc95581,f1d64ae34e088832,98d961097baaf308,2022-07-16,0,0,0,900,1,0,188,72,184,4,2,2,2,2,41,39,143,70,9.3,751.7
722,b1af3bd0f8266a90,02f8fedc18cbd26c,c742287ed86a09bc,2022-07-16,0,0,0,900,0,0,205,41,205,0,0,0,0,0,92,75,113,41,0.0,900.0
723,b1af3bd0f8266a90,c742287ed86a09bc,02f8fedc18cbd26c,2022-07-16,0,0,0,900,8,0,244,37,244,0,0,0,0,0,36,26,208,37,0.0,900.0
724,a5d2f0fed3ce2899,74f9448b97bf8bec,e4277e87a789d687,2022-07-16,0,0,0,193,0,0,39,6,39,0,0,0,0,0,13,8,26,6,0.0,193.0
725,a5d2f0fed3ce2899,e4277e87a789d687,74f9448b97bf8bec,2022-07-16,1,0,0,193,0,0,23,6,23,0,0,0,0,0,9,8,14,6,0.0,193.0
726,9f3326195672c2b9,71505842fb6455c3,8be158ca1e5ea6a0,2022-07-16,0,0,0,900,5,2,112,23,92,20,0,0,20,11,31,26,61,12,214.2,643.0
727,9f3326195672c2b9,8be158ca1e5ea6a0,71505842fb6455c3,2022-07-16,0,0,0,900,0,0,100,35,100,0,0,0,0,0,21,17,79,35,0.0,685.8
728,8e4024cb49c963f2,3cf18e01cb6cbde3,67c1d46f4ed16f9e,2022-07-16,1,0,0,564,0,0,83,37,72,11,3,3,8,7,19,18,53,30,48.8,317.8
729,8e4024cb49c963f2,67c1d46f4ed16f9e,3cf18e01cb6cbde3,2022-07-16,0,2,1,564,3,2,81,36,52,29,0,0,29,22,11,11,41,14,113.2,355.2
730,7503d5c892f238fb,cbf5e6f231b55443,def8166ff24bd237,2022-07-16,1,0,0,251,0,0,46,18,45,1,0,0,1,1,5,5,40,17,0.0,251.0
731,7503d5c892f238fb,def8166ff24bd237,cbf5e6f231b55443,2022-07-16,0,0,0,251,5,1,35,18,35,0,0,0,0,0,5,4,30,18,0.0,107.0
732,74b8a36293758342,5987b2458f4b5290,b8a85389d115e35a,2022-07-16,1,1,1,508,8,2,38,13,34,4,0,0,4,3,13,12,21,10,123.0,262.0
733,74b8a36293758342,b8a85389d115e35a,5987b2458f4b5290,2022-07-16,0,0,0,508,3,0,44,15,44,0,0,0,0,0,4,4,40,15,0.0,372.0
734,4dd2bcd2b025204e,4f140403000158b5,9abc648e76c4493a,2022-07-16,0,2,0,410,2,1,12,6,4,8,0,0,8,6,4,4,0,0,23.3,72.39999999999998
735,4dd2bcd2b025204e,9abc648e76c4493a,4f140403000158b5,2022-07-16,1,0,0,410,1,1,36,21,6,30,4,4,26,20,4,3,2,1,305.6,60.7
736,4965d8eab468b839,729d4bd5a6cd0a97,b96619b3acd7d9da,2022-07-16,0,0,0,900,6,2,184,77,181,3,0,0,3,3,30,25,151,74,5.6,822.0
737,4965d8eab468b839,b96619b3acd7d9da,729d4bd5a6cd0a97,2022-07-16,0,0,0,900,7,0,164,61,164,0,0,0,0,0,42,24,122,61,0.0,769.4
738,fb3f5a65da9f2ac7,50a28b9f8314e008,e7e01e266a9d4342,2022-07-09,0,0,0,900,16,10,59,28,29,30,0,0,30,21,6,4,23,7,568.5,161.0
739,fb3f5a65da9f2ac7,e7e01e266a9d4342,50a28b9f8314e008,2022-07-09,0,0,0,900,2,1,33,8,33,0,0,0,0,0,12,7,21,8,0.0,327.5
740,cd63b4144a45b611,01b352b6a9074d5c,2b68d9f125d07b42,2022-07-09,1,0,0,790,0,0,235,86,234,1,0,0,1,0,60,51,174,86,0.0,790.0
741,cd63b4144a45b611,2b68d9f125d07b42,01b352b6a9074d5c,2022-07-09,0,0,0,790,0,0,266,76,266,0,0,0,0,0,42,33,224,76,0.0,790.0
742,c58b3223b5caa18a,24656ef4d605c96f,cd3d7e37ff2d679c,2022-07-09,0,0,0,900,0,0,105,18,105,0,0,0,0,0,46,36,59,18,0.0,900.0
743,c58b3223b5caa18a,cd3d7e37ff2d679c,24656ef4d605c96f,2022-07-09,0,0,0,900,2,0,235,14,235,0,0,0,0,0,31,13,204,14,0.0,900.0
744,be69cbf1f1671c8e,6a2f7c151031653d,c814b4c899793af6,2022-07-09,0,0,0,1218,16,2,110,31,110,0,0,0,0,0,30,23,80,31,0.0,755.5
745,be69cbf1f1671c8e,c814b4c899793af6,6a2f7c151031653d,2022-07-09,1,0,0,1218,1,0,159,32,157,2,0,0,2,1,57,32,100,31,89.5,1039.0
746,bba6cc8760da34ab,0fd5f4b838e890cc,3a314d9fa7c6825d,2022-07-09,0,0,0,900,5,1,97,21,97,0,0,0,0,0,28,21,69,21,0.0,720.5
747,bba6cc8760da34ab,3a314d9fa7c6825d,0fd5f4b838e890cc,2022-07-09,0,0,0,900,1,1,74,4,69,5,1,1,4,1,39,23,30,3,157.5,648.0
748,a652918360fe9a72,1effd880e1f1bb30,ffe9703408fb5964,2022-07-09,0,0,0,493,2,0,72,15,72,0,0,0,0,0,11,6,61,15,0.0,303.5
749,a652918360fe9a72,ffe9703408fb5964,1effd880e1f1bb30,2022-07-09,0,1,1,493,6,2,72,16,69,3,0,0,3,1,17,13,52,15,77.5,338.0
750,a103b30f6898de7e,511e82663651438d,af9f42e6894047fc,2022-07-09,1,0,0,900,2,0,190,42,184,6,0,0,6,4,43,24,141,38,20.2,859.9
751,a103b30f6898de7e,af9f42e6894047fc,511e82663651438d,2022-07-09,0,0,0,900,2,0,217,54,213,4,0,0,4,2,57,42,156,52,3.1,862.8
752,81cbb709dedc914d,5f179af5fffeb9f6,d7338bcb141abd2c,2022-07-09,0,0,0,900,5,2,86,17,82,4,0,0,4,2,34,16,48,15,94.0,712.0
753,81cbb709dedc914d,d7338bcb141abd2c,5f179af5fffeb9f6,2022-07-09,0,0,0,900,1,0,117,26,117,0,0,0,0,0,44,29,73,26,0.0,696.0
754,6c60e58f8e9e7a4c,369ea36e450ae62a,4126a78111c0855a,2022-07-09,0,0,0,900,0,0,61,2,40,21,20,15,1,0,22,14,18,2,79.0,821.0
755,6c60e58f8e9e7a4c,4126a78111c0855a,369ea36e450ae62a,2022-07-09,0,0,0,900,5,4,25,4,25,0,0,0,0,0,10,8,15,4,0.0,212.0
756,478bc7d1288e043e,37d5b176d438d2a5,8667caa0451d245b,2022-07-09,0,0,0,739,3,0,19,4,19,0,0,0,0,0,6,5,13,4,0.0,70.0
757,478bc7d1288e043e,8667caa0451d245b,37d5b176d438d2a5,2022-07-09,1,1,0,739,7,5,43,18,22,21,1,1,20,16,5,1,17,2,646.0,93.0
758,04e1ff7aeda2a018,147e70aa6cc48cfc,f14f644d41ade29f,2022-07-09,0,0,0,230,0,0,25,2,25,0,0,0,0,0,10,6,15,2,0.0,178.0
759,04e1ff7aeda2a018,f14f644d41ade29f,147e70aa6cc48cfc,2022-07-09,1,0,0,230,2,1,39,10,35,4,0,0,4,2,6,5,29,8,52.0,152.0
760,a7eaf7b101166d3e,1338e2c7480bdf9e,13a0275fa13c4d26,2022-07-02,0,0,0,1500,0,0,230,60,230,0,0,0,0,0,65,56,165,60,0.0,1500.0
761,a7eaf7b101166d3e,13a0275fa13c4d26,1338e2c7480bdf9e,2022-07-02,0,0,0,1500,4,0,157,36,157,0,0,0,0,0,68,54,89,36,0.0,1246.0
762,99ac96bb67e5c5e4,65578a75fa7900e3,886264a0c9f4ea5e,2022-07-02,0,0,0,900,0,0,26,6,17,9,0,0,9,3,0,0,17,3,18.0,357.4
763,99ac96bb67e5c5e4,886264a0c9f4ea5e,65578a75fa7900e3,2022-07-02,0,0,0,900,10,4,39,11,33,6,1,1,5,4,7,5,26,7,524.6,270.0
764,98411542ca0e847d,37ed1ab2f8b819f4,4d8fa64202cee4c1,2022-07-02,0,0,0,45,1,0,3,0,3,0,0,0,0,0,2,2,1,0,0.0,45.0
765,98411542ca0e847d,4d8fa64202cee4c1,37ed1ab2f8b819f4,2022-07-02,0,1,1,45,0,0,5,1,5,0,0,0,0,0,3,2,2,1,0.0,32.0
766,57775c8af89007c7,0c6d9ea8306c029e,0d7b51c9d2649a6e,2022-07-02,0,0,0,900,1,0,150,55,148,2,0,0,2,1,37,27,111,54,13.4,771.2
767,57775c8af89007c7,0d7b51c9d2649a6e,0c6d9ea8306c029e,2022-07-02,0,0,0,900,7,0,212,79,210,2,0,0,2,2,43,34,167,77,7.8,808.6
768,4d8d1701c43c5fea,442c9011034ae1fd,5eb50529a8418b77,2022-07-02,1,0,0,900,2,1,193,87,190,3,0,0,3,3,33,29,157,84,27.6,854.0
769,4d8d1701c43c5fea,5eb50529a8418b77,442c9011034ae1fd,2022-07-02,0,0,0,900,4,1,195,31,195,0,0,0,0,0,83,59,112,31,0.0,735.4
770,459bc7c0b47719c3,1d00756835ca67c9,d1941565abf50b16,2022-07-02,0,0,0,392,0,0,33,12,33,0,0,0,0,0,13,9,20,12,0.0,245.0
771,459bc7c0b47719c3,d1941565abf50b16,1d00756835ca67c9,2022-07-02,0,1,1,392,1,1,36,16,27,9,0,0,9,7,8,8,19,9,63.0,329.0
772,4047e98132306cd5,150ff4cc642270b9,e1248941344b3288,2022-07-02,0,0,0,1500,3,0,301,64,301,0,0,0,0,0,88,63,213,64,0.0,1484.0
773,4047e98132306cd5,e1248941344b3288,150ff4cc642270b9,2022-07-02,0,0,0,1500,0,0,372,152,372,0,0,0,0,0,56,47,316,152,0.0,1383.0
774,39dccca8e8083072,6bd02119599741a4,b50a426a33da0012,2022-07-02,0,0,0,489,0,0,41,0,41,0,0,0,0,0,32,26,9,0,0.0,489.0
775,39dccca8e8083072,b50a426a33da0012,6bd02119599741a4,2022-07-02,0,0,0,489,0,0,47,14,47,0,0,0,0,0,17,11,30,14,0.0,489.0
776,1c85003f6ec59c9d,6a740daf1b279661,f72465a784c1b084,2022-07-02,0,0,0,900,0,0,97,45,92,5,0,0,5,5,19,18,73,40,12.2,741.4
777,1c85003f6ec59c9d,f72465a784c1b084,6a740daf1b279661,2022-07-02,0,0,0,900,4,1,62,23,60,2,2,2,0,0,12,10,48,23,46.6,398.8
778,12a33d16e1d4e2d9,a331233f597090a5,f2925e6db404bf1d,2022-07-02,1,0,0,587,0,0,316,116,316,0,0,0,0,0,36,31,280,116,0.0,587.0
779,12a33d16e1d4e2d9,f2925e6db404bf1d,a331233f597090a5,2022-07-02,0,0,0,587,0,0,141,65,141,0,0,0,0,0,17,16,124,65,0.0,587.0
780,0e2c7ec02a095813,6c8072b61c276e67,a78a87d8c2bbb1cb,2022-07-02,0,0,0,42,0,0,16,6,15,1,0,0,1,0,3,3,12,6,0.0,42.0
781,0e2c7ec02a095813,a78a87d8c2bbb1cb,6c8072b61c276e67,2022-07-02,0,1,1,42,1,1,9,6,9,0,0,0,0,0,0,0,9,6,0.0,25.0
782,0308bcdd00cc72e2,0d8011111be000b2,e5549c82bfb5582d,2022-07-02,0,0,0,156,0,0,29,9,29,0,0,0,0,0,9,6,20,9,0.0,156.0
783,0308bcdd00cc72e2,e5549c82bfb5582d,0d8011111be000b2,2022-07-02,1,0,0,156,0,0,40,5,40,0,0,0,0,0,25,20,15,5,0.0,153.0
784,c57c8e22a3e8dde2,b5da8f7d05e85a55,c9a94278df042f46,2022-06-25,1,0,0,484,4,3,68,27,43,25,0,0,25,18,15,15,28,9,162.9,232.5
785,c57c8e22a3e8dde2,c9a94278df042f46,b5da8f7d05e85a55,2022-06-25,1,0,0,484,0,0,75,34,58,17,3,3,14,12,13,12,45,22,62.5,218.1
786,a457331c27bce6d5,2f6a993c7f547c13,82b4e942781b1046,2022-06-25,0,0,0,900,13,2,127,56,125,2,0,0,2,1,14,12,111,55,110.0,618.5
787,a457331c27bce6d5,82b4e942781b1046,2f6a993c7f547c13,2022-06-25,0,0,0,900,4,1,142,51,141,1,0,0,1,0,22,12,119,51,6.5,777.0
788,8cc43d79b61efc25,0b362247806341e5,7f6ed67d3ed3c036,2022-06-25,0,0,0,68,2,0,11,4,11,0,0,0,0,0,4,3,7,4,0.0,43.4
789,8cc43d79b61efc25,7f6ed67d3ed3c036,0b362247806341e5,2022-06-25,1,0,0,68,0,0,30,21,13,17,0,0,17,14,2,2,11,7,24.6,42.0
790,3f38100fd8dae286,260e9e0d4954aea6,5442f1bc4b47eaf3,2022-06-25,0,0,0,900,20,0,145,64,145,0,0,0,0,0,24,22,121,64,0.0,760.0
791,3f38100fd8dae286,5442f1bc4b47eaf3,260e9e0d4954aea6,2022-06-25,0,0,0,900,0,0,174,80,171,3,2,2,1,1,36,27,135,79,15.0,865.0
792,3c98739eb42f96bf,01afe0916a40c7c5,84b3e7d38f2d2ec5,2022-06-25,0,1,1,598,2,2,36,17,10,26,0,0,26,14,2,2,8,3,546.0,45.0
793,3c98739eb42f96bf,84b3e7d38f2d2ec5,01afe0916a40c7c5,2022-06-25,0,0,0,598,0,0,22,6,16,6,0,0,6,3,6,5,10,3,7.0,45.0
794,2c73bf152247f25a,2c483cf443f38ece,d05cb1e8d1b885d8,2022-06-25,0,0,0,900,7,1,139,34,139,0,0,0,0,0,39,32,100,34,0.0,646.0
795,2c73bf152247f25a,d05cb1e8d1b885d8,2c483cf443f38ece,2022-06-25,0,0,0,900,1,0,133,49,133,0,0,0,0,0,17,13,116,49,0.0,889.0
796,28be3fbe5c377380,6aae253467e8f9ce,9014c02eff8b3d62,2022-06-25,0,0,0,75,0,0,4,0,4,0,0,0,0,0,4,3,0,0,0.0,71.0
797,28be3fbe5c377380,9014c02eff8b3d62,6aae253467e8f9ce,2022-06-25,1,0,0,75,0,0,19,9,15,4,0,0,4,3,6,6,9,6,4.0,71.0
798,28bd070f7ab0a0b9,2b6fc1c02736833d,6e9f40c706f91f32,2022-06-25,0,0,0,900,4,3,100,60,33,67,5,5,62,52,16,9,17,8,649.0,251.0
799,28bd070f7ab0a0b9,6e9f40c706f91f32,2b6fc1c02736833d,2022-06-25,0,0,0,900,0,0,20,1,20,0,0,0,0,0,1,1,19,1,0.0,251.0
800,24a9fc95a3112f51,7be14eaed4c74856,bc711b6dd95c1af6,2022-06-25,0,0,0,147,0,0,3,1,3,0,0,0,0,0,1,1,2,1,0.0,59.0
801,24a9fc95a3112f51,bc711b6dd95c1af6,7be14eaed4c74856,2022-06-25,0,1,1,147,2,2,17,3,15,2,0,0,2,2,3,3,12,1,88.0,59.0
802,21f79cd40513d075,0a73acff6325c1e2,d31cbcdd7d69536d,2022-06-25,1,0,0,900,6,3,79,41,63,16,0,0,16,13,6,6,57,28,401.8,348.6
803,21f79cd40513d075,d31cbcdd7d69536d,0a73acff6325c1e2,2022-06-25,0,4,0,900,2,1,99,30,95,4,1,1,3,2,12,11,83,28,99.4,324.2
804,1f5f59924b59408b,72db2a14ffa73ece,eae48ff31db420c2,2022-06-25,0,0,0,1500,21,6,138,68,134,4,0,0,4,4,17,13,117,64,132.4,1152.5
805,1f5f59924b59408b,eae48ff31db420c2,72db2a14ffa73ece,2022-06-25,1,0,0,1500,8,1,247,43,241,6,1,1,5,3,64,51,177,40,49.5,1268.6
806,029a12d36a4687e1,d945aae53e3e54e6,de45aaae23dfa392,2022-06-25,0,1,1,185,2,1,4,2,4,0,0,0,0,0,1,1,3,2,0.0,31.0
807,029a12d36a4687e1,de45aaae23dfa392,d945aae53e3e54e6,2022-06-25,0,0,0,185,0,0,5,1,5,0,0,0,0,0,1,1,4,1,0.0,185.0
808,e8a5e53ffd33c0f9,327d5f279895110d,d6c0cdd7e467c440,2022-06-18,2,0,0,73,0,0,15,8,7,8,0,0,8,5,1,0,6,3,26.2,37.0
809,e8a5e53ffd33c0f9,d6c0cdd7e467c440,327d5f279895110d,2022-06-18,0,0,0,73,0,0,9,1,9,0,0,0,0,0,3,3,6,1,0.0,46.8
810,9a92d376fba2379d,523fa774700d7d3f,d66a46de8d705353,2022-06-18,0,0,0,94,0,0,8,0,8,0,0,0,0,0,4,3,4,0,0.0,92.0
811,9a92d376fba2379d,d66a46de8d705353,523fa774700d7d3f,2022-06-18,1,0,0,94,0,0,16,7,14,2,0,0,2,2,0,0,14,5,2.0,92.0
812,8b5c760f34daafe0,bf7ad5628363eec9,fc9a9559a05f2704,2022-06-18,1,0,0,59,0,0,38,23,32,6,0,0,6,6,4,4,28,17,1.9,52.0
813,8b5c760f34daafe0,fc9a9559a05f2704,bf7ad5628363eec9,2022-06-18,0,0,0,59,0,0,7,1,7,0,0,0,0,0,2,2,5,1,0.0,57.1
814,897d9e21c59d0633,483a953b18d73bb3,547afe1017e72dbe,2022-06-18,0,0,0,565,0,0,111,24,111,0,0,0,0,0,10,8,101,24,0.0,540.9
815,897d9e21c59d0633,547afe1017e72dbe,483a953b18d73bb3,2022-06-18,1,0,0,565,3,1,175,99,156,19,0,0,19,15,23,19,133,84,24.1,518.0
816,6e559181bfbc77e1,751de04455cfaac0,fba03cd6cc28dc41,2022-06-18,0,0,0,1500,0,0,375,114,375,0,0,0,0,0,24,16,351,114,0.0,1500.0
817,6e559181bfbc77e1,fba03cd6cc28dc41,751de04455cfaac0,2022-06-18,0,0,0,1500,4,0,332,73,332,0,0,0,0,0,46,34,286,73,0.0,1496.0
818,5b5d7f7ae712c6d8,37d752ec41ed84bb,5dd180c8b3196786,2022-06-18,0,0,0,900,4,2,297,66,297,0,0,0,0,0,50,30,247,66,0.0,798.9
819,5b5d7f7ae712c6d8,5dd180c8b3196786,37d752ec41ed84bb,2022-06-18,0,0,0,900,3,2,190,75,189,1,0,0,1,0,35,30,154,75,6.1,851.0
820,5095f6290670009d,d0e1b42d41dab603,d1c65d2cf2925ddd,2022-06-18,0,0,0,198,0,0,42,8,42,0,0,0,0,0,6,5,36,8,0.0,159.6
821,5095f6290670009d,d1c65d2cf2925ddd,d0e1b42d41dab603,2022-06-18,3,0,0,198,0,0,72,46,55,17,0,0,17,13,5,3,50,33,38.4,146.0
822,4e6218b6b892b017,135d124172a0bea3,7772b283d288dbe2,2022-06-18,0,0,0,900,6,0,192,63,192,0,0,0,0,0,19,16,173,63,0.0,851.7
823,4e6218b6b892b017,7772b283d288dbe2,135d124172a0bea3,2022-06-18,0,0,0,900,7,1,187,29,186,1,1,1,0,0,57,48,129,29,2.3,861.0
824,2c7c7648e847f2e5,262d32ebda89efc4,a9e260472d321361,2022-06-18,0,0,0,900,3,2,185,55,170,15,0,0,15,10,48,41,122,45,62.8,833.0
825,2c7c7648e847f2e5,a9e260472d321361,262d32ebda89efc4,2022-06-18,0,0,0,900,6,0,101,12,101,0,0,0,0,0,29,19,72,12,0.0,620.2
826,20cefe64f4b28be8,0232cabbc30a2372,1a08b01fdabb6ae2,2022-06-18,1,0,0,229,0,0,67,29,62,5,0,0,5,5,7,6,55,24,2.9,225.0
827,20cefe64f4b28be8,1a08b01fdabb6ae2,0232cabbc30a2372,2022-06-18,0,0,0,229,0,0,49,12,49,0,0,0,0,0,20,8,29,12,0.0,224.1
828,1bc662949337a8c4,3a46b268013afede,4b47e71384a9522f,2022-06-18,0,1,1,388,1,0,90,26,90,0,0,0,0,0,19,10,71,26,0.0,379.0
829,1bc662949337a8c4,4b47e71384a9522f,3a46b268013afede,2022-06-18,0,0,0,388,5,2,46,8,46,0,0,0,0,0,21,13,25,8,0.0,298.0
830,1378fc2be3819b2b,0de720c0f1d4ab9c,1ae8f3c723aacff4,2022-06-18,0,0,0,72,0,0,9,2,9,0,0,0,0,0,2,1,7,2,0.0,72.0
831,1378fc2be3819b2b,1ae8f3c723aacff4,0de720c0f1d4ab9c,2022-06-18,1,0,0,72,0,0,14,3,14,0,0,0,0,0,2,1,12,3,0.0,71.0
832,11e83902f5b8ff63,6b7c7460855dbbb9,b9437600497350f3,2022-06-18,0,0,0,600,9,2,50,3,50,0,0,0,0,0,12,7,38,3,0.0,488.9
833,11e83902f5b8ff63,b9437600497350f3,6b7c7460855dbbb9,2022-06-18,2,0,0,600,0,0,105,15,104,1,0,0,1,1,25,12,79,14,3.1,578.0
834,fd49f89b9d97566b,009341ed974bad72,7ff97850e8c32bda,2022-06-11,0,1,1,1472,0,0,205,106,153,52,0,0,52,36,15,14,138,70,222.0,670.8
835,fd49f89b9d97566b,7ff97850e8c32bda,009341ed974bad72,2022-06-11,0,1,0,1472,17,5,161,98,93,68,4,4,64,56,12,9,81,42,532.2,663.0
836,f466cd99d02644e9,b4880ef2f838d4e1,ec0dcceace7d25a3,2022-06-11,1,0,0,82,0,0,12,8,12,0,0,0,0,0,0,0,12,8,0.0,82.0
837,f466cd99d02644e9,ec0dcceace7d25a3,b4880ef2f838d4e1,2022-06-11,0,0,0,82,2,0,17,4,17,0,0,0,0,0,0,0,17,4,0.0,73.0
838,f115a91066a77ee7,6b453bc35a823c3f,abd5fb12437eda21,2022-06-11,1,0,0,152,0,0,36,11,32,4,0,0,4,4,10,7,22,7,1.7,149.0
839,f115a91066a77ee7,abd5fb12437eda21,6b453bc35a823c3f,2022-06-11,0,1,0,152,2,1,24,6,24,0,0,0,0,0,2,1,22,6,0.0,125.3
840,d7a7ba46c4f075d7,33efaf2d0941cfcf,a845f0735bc67405,2022-06-11,0,0,0,444,0,0,51,13,49,2,0,0,2,0,7,5,42,13,0.0,444.0
841,d7a7ba46c4f075d7,a845f0735bc67405,33efaf2d0941cfcf,2022-06-11,1,0,0,444,0,0,89,35,87,2,0,0,2,2,14,12,73,33,0.0,444.0
842,c94b153951be7590,6751eacd16bd59bc,a68575214ecad140,2022-06-11,2,0,0,900,0,0,111,40,103,8,0,0,8,5,14,11,89,35,29.0,785.8
843,c94b153951be7590,a68575214ecad140,6751eacd16bd59bc,2022-06-11,0,0,0,900,2,1,163,29,157,6,0,0,6,3,26,17,131,26,56.2,721.0
844,5f4a107d930e4852,3eb4dc9a7d4ac906,f9ab66e67240db7b,2022-06-11,0,0,0,900,11,1,109,23,109,0,0,0,0,0,46,40,63,23,0.0,838.0
845,5f4a107d930e4852,f9ab66e67240db7b,3eb4dc9a7d4ac906,2022-06-11,0,0,0,900,3,0,268,22,268,0,0,0,0,0,185,142,83,22,0.0,848.0
846,50eed57ea1390e16,2f181c0467965b98,d4270315cbcf2569,2022-06-11,0,0,0,900,2,2,74,36,56,18,0,0,18,17,12,9,44,19,193.3,328.3
847,50eed57ea1390e16,d4270315cbcf2569,2f181c0467965b98,2022-06-11,0,0,0,900,14,7,55,29,49,6,0,0,6,3,5,4,44,26,367.7,277.7
848,4a116a55ffaa0d64,8c1ca54b5089d199,97cf1a2c7c5e7889,2022-06-11,2,0,0,74,0,0,10,6,10,0,0,0,0,0,2,1,8,6,0.0,47.8
849,4a116a55ffaa0d64,97cf1a2c7c5e7889,8c1ca54b5089d199,2022-06-11,0,0,0,74,0,0,19,7,16,3,0,0,3,3,4,0,12,4,26.2,39.0
850,4305cb30533dac77,1ebe20ebbfa15e29,3d6749c4267da18f,2022-06-11,1,0,0,448,6,3,102,52,64,38,0,0,38,35,22,17,42,17,149.3,279.0
851,4305cb30533dac77,3d6749c4267da18f,1ebe20ebbfa15e29,2022-06-11,0,0,0,448,0,0,85,20,85,0,0,0,0,0,29,23,56,20,0.0,298.7
852,049ad6d87b42eba8,132deb59abae64b1,f7467152fd9f18a2,2022-06-11,0,1,0,1500,5,3,139,46,133,6,0,0,6,5,39,31,94,41,95.6,919.5
853,049ad6d87b42eba8,f7467152fd9f18a2,132deb59abae64b1,2022-06-11,0,3,0,1500,3,3,102,18,94,8,3,3,5,3,41,34,53,15,325.5,875.4
854,029f5c36820fdc09,3b0a516d2921e0d6,a7897d200692ab64,2022-06-11,0,0,0,900,1,0,284,68,283,1,0,0,1,1,61,41,222,67,0.4,897.0
855,029f5c36820fdc09,a7897d200692ab64,3b0a516d2921e0d6,2022-06-11,0,0,0,900,2,0,155,82,155,0,0,0,0,0,21,18,134,82,0.0,899.6
856,ed32da52aff68944,62f7097c04311193,c2299ec916bc7c56,2022-06-04,0,1,0,392,0,0,14,3,13,1,0,0,1,1,9,8,4,2,0.0,220.0
857,ed32da52aff68944,c2299ec916bc7c56,62f7097c04311193,2022-06-04,0,2,1,392,5,3,10,4,8,2,1,1,1,1,4,3,4,3,172.0,48.0
858,e5e75d831670b401,af65aa688d13eedf,c3ded6f7155f9ea4,2022-06-04,0,3,0,900,4,1,82,32,80,2,0,0,2,2,1,1,79,30,116.4,332.9
859,e5e75d831670b401,c3ded6f7155f9ea4,af65aa688d13eedf,2022-06-04,1,0,0,900,0,0,76,20,69,7,2,2,5,3,16,13,53,17,276.1,428.6
860,aacb47949a572f25,76e2870ffafbe38f,82a5152216251682,2022-06-04,0,0,0,900,16,9,129,50,112,17,0,0,17,15,20,18,92,35,364.2,485.5
861,aacb47949a572f25,82a5152216251682,76e2870ffafbe38f,2022-06-04,0,0,0,900,0,0,106,25,103,3,1,1,2,2,20,16,83,23,7.5,525.8
862,a679800d2e7c3be2,6d68c1afe954f121,79cb2a690b9ba5e8,2022-06-04,1,0,0,61,0,0,15,7,8,7,0,0,7,6,0,0,8,1,3.0,58.0
863,a679800d2e7c3be2,79cb2a690b9ba5e8,6d68c1afe954f121,2022-06-04,0,0,0,61,0,0,13,5,13,0,0,0,0,0,2,2,11,5,0.0,58.0
864,a09447d185a62251,79325a3c1a5c3bf4,8f765fd5775a8873,2022-06-04,0,0,0,900,2,0,33,7,31,2,0,0,2,2,11,11,20,5,7.1,499.5
865,a09447d185a62251,8f765fd5775a8873,79325a3c1a5c3bf4,2022-06-04,0,0,0,900,10,5,61,27,42,19,1,1,18,16,19,17,23,11,361.5,112.9
866,93969a7368dc2e14,a495f599e787614f,e92901944ce91909,2022-06-04,1,0,0,280,3,2,22,18,6,16,0,0,16,16,1,1,5,2,259.0,21.0
867,93969a7368dc2e14,e92901944ce91909,a495f599e787614f,2022-06-04,0,0,0,280,0,0,11,1,11,0,0,0,0,0,2,1,9,1,0.0,21.0
868,7e20b0536fbbd560,008ea710276c9606,55fa6ce3e522c8bb,2022-06-04,0,0,0,900,0,0,148,43,146,2,0,0,2,2,15,13,131,41,3.1,886.0
869,7e20b0536fbbd560,55fa6ce3e522c8bb,008ea710276c9606,2022-06-04,0,0,0,900,13,2,112,10,112,0,0,0,0,0,38,27,74,10,0.0,564.9
870,7a635063e5f1699b,279566840aa55bf2,2cd428e9606856fd,2022-06-04,1,0,0,132,0,0,37,10,37,0,0,0,0,0,11,11,26,10,0.0,132.0
871,7a635063e5f1699b,2cd428e9606856fd,279566840aa55bf2,2022-06-04,0,0,0,132,0,0,18,3,18,0,0,0,0,0,3,3,15,3,0.0,132.0
872,59b2bbb251968ca9,669970f7feba8ecd,6fd953151d981979,2022-06-04,0,1,1,458,4,0,100,29,100,0,0,0,0,0,24,19,76,29,0.0,402.0
873,59b2bbb251968ca9,6fd953151d981979,669970f7feba8ecd,2022-06-04,0,0,0,458,6,2,71,29,71,0,0,0,0,0,5,3,66,29,0.0,416.0
874,4f2501e804c84abe,b6850671a008bf9a,d7c3816669784109,2022-06-04,0,0,0,541,2,0,122,34,122,0,0,0,0,0,30,21,92,34,0.0,476.7
875,4f2501e804c84abe,d7c3816669784109,b6850671a008bf9a,2022-06-04,0,2,1,541,2,0,123,54,114,9,1,1,8,7,28,27,86,47,63.3,351.0
876,43d7d4b67be48553,601964f9654f911a,f6bcbd91b114ff58,2022-06-04,1,0,0,68,0,0,15,4,11,4,0,0,4,3,3,1,8,1,3.0,65.0
877,43d7d4b67be48553,f6bcbd91b114ff58,601964f9654f911a,2022-06-04,0,0,0,68,1,0,7,0,7,0,0,0,0,0,2,2,5,0,0.0,65.0
878,3aa49ed298e4c34f,5c126c6aac3ef364,9d62c2d8ee151f08,2022-06-04,0,0,0,295,0,0,26,10,26,0,0,0,0,0,9,9,17,10,0.0,248.0
879,3aa49ed298e4c34f,9d62c2d8ee151f08,5c126c6aac3ef364,2022-06-04,0,1,1,295,1,1,68,9,63,5,1,1,4,4,18,7,45,5,47.0,248.0
880,344d60564cd136ff,5bf31a46becc1204,710f0f8c5d5c9d41,2022-06-04,1,0,0,655,0,0,62,17,57,5,0,0,5,4,17,14,40,13,73.6,419.0
881,344d60564cd136ff,710f0f8c5d5c9d41,5bf31a46becc1204,2022-06-04,2,0,0,655,0,0,152,32,121,31,1,1,30,20,56,42,65,12,133.0,448.4
882,04e6198326be4857,29af297d9f1de0f8,e4ba58725825412d,2022-06-04,0,1,0,900,4,2,53,23,45,8,0,0,8,8,9,9,36,15,384.6,255.7
883,04e6198326be4857,e4ba58725825412d,29af297d9f1de0f8,2022-06-04,0,0,0,900,3,1,59,24,57,2,0,0,2,1,3,3,54,23,19.3,351.4
884,f682118709b4143e,866fd7b1a6c90e7f,c68c68efaa5ca6ef,2022-05-21,0,0,0,288,7,2,7,4,6,1,0,0,1,1,1,1,5,3,38.6,95.0
885,f682118709b4143e,c68c68efaa5ca6ef,866fd7b1a6c90e7f,2022-05-21,1,1,0,288,0,0,17,3,17,0,0,0,0,0,13,11,4,3,0.0,199.4
886,cbdfb3c648d7bada,70fa1c64a2c439ef,8d20d76af3f213ce,2022-05-21,0,0,0,64,0,0,8,1,8,0,0,0,0,0,1,0,7,1,0.0,45.3
887,cbdfb3c648d7bada,8d20d76af3f213ce,70fa1c64a2c439ef,2022-05-21,1,1,1,64,1,1,23,11,15,8,0,0,8,6,6,5,9,5,18.7,43.0
888,bc7228d30ff5be46,ac7c765882f2c68c,e94085e821bd81de,2022-05-21,0,0,0,832,0,0,41,10,41,0,0,0,0,0,7,7,34,10,0.0,269.29999999999995
889,bc7228d30ff5be46,e94085e821bd81de,ac7c765882f2c68c,2022-05-21,1,0,0,832,7,4,65,33,29,36,5,5,31,25,9,5,20,8,562.7,113.0
890,7a2c841693b54dd7,634e2fb70bde3fd5,b9706f80d005036c,2022-05-21,0,0,0,1500,6,0,157,26,157,0,0,0,0,0,78,70,79,26,0.0,888.8
891,7a2c841693b54dd7,b9706f80d005036c,634e2fb70bde3fd5,2022-05-21,0,1,0,1500,7,1,151,49,147,4,0,0,4,4,42,36,105,45,8.2,1416.0
892,5eaff5c832430378,9673a497a9da119a,d25240135aee03e5,2022-05-21,0,0,0,900,0,0,97,18,93,4,3,3,1,1,20,15,73,17,3.3,355.70000000000005
893,5eaff5c832430378,d25240135aee03e5,9673a497a9da119a,2022-05-21,0,0,0,900,10,5,73,11,58,15,13,10,2,2,17,12,41,9,535.3,325.7
894,5d4fb748ad246269,595db60957de51d3,6d1bffff14897645,2022-05-21,0,0,0,900,0,0,216,52,216,0,0,0,0,0,73,58,143,52,0.0,887.0
895,5d4fb748ad246269,6d1bffff14897645,595db60957de51d3,2022-05-21,0,0,0,900,4,1,220,78,218,2,0,0,2,1,35,27,183,77,12.0,882.0
896,534c07488396e124,681399317dbf4701,a0e6753c42698f13,2022-05-21,2,0,0,485,0,0,86,21,86,0,0,0,0,0,29,26,57,21,0.0,483.0
897,534c07488396e124,a0e6753c42698f13,681399317dbf4701,2022-05-21,0,0,0,485,0,0,85,18,85,0,0,0,0,0,21,15,64,18,0.0,485.0
898,5136dc566f46daf6,971246648e162f0d,dbac0a413af64bbe,2022-05-21,1,3,0,780,7,4,93,57,46,47,0,0,47,39,5,3,41,18,306.6,121.5
899,5136dc566f46daf6,dbac0a413af64bbe,971246648e162f0d,2022-05-21,0,0,0,780,4,2,23,14,11,12,2,2,10,9,5,5,6,5,234.5,219.39999999999998
900,4a789cdd5aaf4439,285ae0b4a68221f4,cad24459b28592ca,2022-05-21,0,0,0,900,1,0,184,74,184,0,0,0,0,0,32,31,152,74,0.0,869.0
901,4a789cdd5aaf4439,cad24459b28592ca,285ae0b4a68221f4,2022-05-21,0,0,0,900,24,3,142,45,142,0,0,0,0,0,30,20,112,45,0.0,615.0
902,3542f9f30926f364,37098a6e6c27fb66,f2477cf43c4975cc,2022-05-21,0,0,0,900,0,0,153,33,152,1,0,0,1,1,26,18,126,32,3.5,886.0
903,3542f9f30926f364,f2477cf43c4975cc,37098a6e6c27fb66,2022-05-21,0,0,0,900,2,2,154,41,154,0,0,0,0,0,56,47,98,41,0.0,855.5
904,1b4d0c9e3c59b33b,41e83a89929d1327,ac40f7e3cbecdda4,2022-05-21,0,1,1,275,2,1,34,16,1,33,2,2,31,15,0,0,1,1,269.0,6.0
905,1b4d0c9e3c59b33b,ac40f7e3cbecdda4,41e83a89929d1327,2022-05-21,0,0,0,275,0,0,0,0,0,0,0,0,0,0,0,0,0,0,0.0,6.0
906,fad150a0288efbd7,beecb672a279223e,e872e9a9a902c045,2022-05-14,0,0,0,900,6,3,169,28,163,6,0,0,6,3,45,27,118,25,133.4,611.0
907,fad150a0288efbd7,e872e9a9a902c045,beecb672a279223e,2022-05-14,0,0,0,900,2,0,222,42,222,0,0,0,0,0,47,21,175,42,0.0,760.6
908,f549164690d723bb,7dda2cf308f24a02,f0feeb2192937424,2022-05-14,0,0,0,900,8,3,60,13,60,0,0,0,0,0,8,1,52,13,0.0,433.3
909,f549164690d723bb,f0feeb2192937424,7dda2cf308f24a02,2022-05-14,0,0,0,900,2,1,55,14,54,1,0,0,1,0,13,7,41,14,42.7,772.0
910,e240d6f77747ec46,2e7878927067fdca,764342d39cdaa54a,2022-05-14,1,0,0,207,1,0,64,27,64,0,0,0,0,0,8,7,56,27,0.0,191.0
911,e240d6f77747ec46,764342d39cdaa54a,2e7878927067fdca,2022-05-14,0,0,0,207,5,0,31,10,31,0,0,0,0,0,7,6,24,10,0.0,193.0
912,b3248692dfb954b2,253076a23d03dcd0,60a42bf82447c919,2022-05-14,0,0,0,900,4,2,52,7,29,23,3,3,20,5,17,9,12,2,521.6,128.6
913,b3248692dfb954b2,60a42bf82447c919,253076a23d03dcd0,2022-05-14,0,1,0,900,0,0,29,5,21,8,1,1,7,3,3,2,18,2,204.4,148.39999999999998
914,afed0bac5ce5a2f3,12585614e0ed2626,5f61780fe5e9b6d0,2022-05-14,0,0,0,76,1,0,11,2,11,0,0,0,0,0,4,2,7,2,0.0,76.0
915,afed0bac5ce5a2f3,5f61780fe5e9b6d0,12585614e0ed2626,2022-05-14,0,1,1,76,0,0,10,0,10,0,0,0,0,0,2,1,8,0,0.0,53.0
916,8a1aa64eb1f17913,511e82663651438d,cd7763bcadb5d4c8,2022-05-14,1,0,0,502,1,1,48,18,45,3,0,0,3,3,13,12,32,15,72.6,381.0
917,8a1aa64eb1f17913,cd7763bcadb5d4c8,511e82663651438d,2022-05-14,0,0,0,502,5,0,47,7,47,0,0,0,0,0,17,15,30,7,0.0,417.4
918,7e047b195135ef06,05fa626cb33d15b8,36541f1e6c5d4955,2022-05-14,1,0,0,900,2,1,82,34,75,7,0,0,7,4,17,13,58,30,18.7,212.0
919,7e047b195135ef06,36541f1e6c5d4955,05fa626cb33d15b8,2022-05-14,0,2,0,900,5,3,79,25,66,13,0,0,13,7,16,14,50,18,640.0,241.3
920,5c281439d20184f1,333b9e5c723ac873,99df7d0a2a08a8a8,2022-05-14,0,0,0,671,4,1,85,14,70,15,0,0,15,10,25,13,45,4,273.0,398.0
921,5c281439d20184f1,99df7d0a2a08a8a8,333b9e5c723ac873,2022-05-14,1,1,0,671,0,0,71,8,71,0,0,0,0,0,40,23,31,8,0.0,397.0
922,43543a2c1c7a7135,113df4fde64735c6,d2bc285ead803db0,2022-05-14,1,0,0,649,1,0,197,36,188,9,1,1,8,6,62,44,126,30,18.5,584.8
923,43543a2c1c7a7135,d2bc285ead803db0,113df4fde64735c6,2022-05-14,0,0,0,649,3,0,139,46,134,5,0,0,5,3,38,25,96,43,29.2,595.5
924,2fa88b72973478b6,a67f5afa8d6a1b80,cd13728ae1151f46,2022-05-14,0,1,1,142,0,0,11,4,11,0,0,0,0,0,0,0,11,4,0.0,120.2
925,2fa88b72973478b6,cd13728ae1151f46,a67f5afa8d6a1b80,2022-05-14,0,0,0,142,3,3,9,2,8,1,0,0,1,1,1,0,7,1,17.8,71.0
926,22f1133d02700bb2,4461d7e47375a895,760a55d5b6098cbe,2022-05-14,1,3,0,900,5,1,87,45,32,55,1,1,54,39,12,11,20,6,402.4,483.0
927,22f1133d02700bb2,760a55d5b6098cbe,4461d7e47375a895,2022-05-14,0,1,0,900,5,2,34,6,34,0,0,0,0,0,7,3,27,6,0.0,289.6
928,ff6c8dab41efcc09,1788eee370f077b7,ab943cd2c3c17825,2022-05-07,0,0,0,900,4,0,128,53,128,0,0,0,0,0,10,9,118,53,0.0,668.0
929,ff6c8dab41efcc09,ab943cd2c3c17825,1788eee370f077b7,2022-05-07,0,0,0,900,5,1,133,46,133,0,0,0,0,0,26,22,107,46,0.0,776.0
930,fc4939b3c9071e66,9cdd2da1a9104a0b,d3f5d33d61cd00c9,2022-05-07,0,0,0,900,12,6,89,14,89,0,0,0,0,0,30,18,59,14,0.0,446.0
931,fc4939b3c9071e66,d3f5d33d61cd00c9,9cdd2da1a9104a0b,2022-05-07,0,0,0,900,0,0,75,27,75,0,0,0,0,0,15,11,60,27,0.0,874.0
932,c020ccbd7cdefb6e,140745cbbcb023ac,50db8711c70196cd,2022-05-07,0,0,0,900,0,0,99,18,99,0,0,0,0,0,46,36,53,18,0.0,900.0
933,c020ccbd7cdefb6e,50db8711c70196cd,140745cbbcb023ac,2022-05-07,0,0,0,900,1,0,112,18,112,0,0,0,0,0,55,44,57,18,0.0,885.0
934,a2ebb5f86eb64f22,22a92d7f62195791,4b93a88f3b1de35b,2022-05-07,0,0,0,317,0,0,50,13,42,8,1,0,7,3,11,7,31,10,0.0,168.0
935,a2ebb5f86eb64f22,4b93a88f3b1de35b,22a92d7f62195791,2022-05-07,1,0,0,317,1,1,53,15,38,15,0,0,15,9,14,12,24,6,149.0,168.0
936,9d61012a6020516e,47b63240018d5d86,d910665038efc639,2022-05-07,0,0,0,1500,1,1,136,30,136,0,0,0,0,0,14,7,122,30,0.0,1490.0
937,9d61012a6020516e,d910665038efc639,47b63240018d5d86,2022-05-07,0,0,0,1500,11,2,133,15,133,0,0,0,0,0,25,15,108,15,0.0,1478.0
938,88455c967a7ef6fc,8e5d953bdb9ae5e7,c0d5c0c95c59050b,2022-05-07,0,2,0,900,8,8,61,36,31,30,4,4,26,23,8,6,23,13,575.7,94.0
939,88455c967a7ef6fc,c0d5c0c95c59050b,8e5d953bdb9ae5e7,2022-05-07,0,0,0,900,1,0,20,7,18,2,0,0,2,2,2,2,16,5,0.0,324.29999999999995
940,8390441d93736719,2558ae2e5671e318,c6aee362c7a7d482,2022-05-07,1,0,0,900,0,0,224,26,217,7,0,0,7,3,65,49,152,23,102.5,651.0
941,8390441d93736719,c6aee362c7a7d482,2558ae2e5671e318,2022-05-07,0,0,0,900,4,0,177,68,177,0,0,0,0,0,33,25,144,68,0.0,786.5
942,8289033e03b4d9a3,077e3ace32b72be9,102a8fdf8cbf7467,2022-05-07,0,0,0,900,0,0,127,42,102,25,1,1,24,18,37,28,65,24,185.7,559.2
943,8289033e03b4d9a3,102a8fdf8cbf7467,077e3ace32b72be9,2022-05-07,0,1,0,900,7,2,143,39,138,5,0,0,5,5,52,42,86,34,80.8,520.3
944,80ac36a9dbc4b1a1,67c1d46f4ed16f9e,6e15f63b6c2e2c15,2022-05-07,1,0,0,134,0,0,33,9,28,5,0,0,5,2,4,3,24,7,54.0,73.5
945,80ac36a9dbc4b1a1,6e15f63b6c2e2c15,67c1d46f4ed16f9e,2022-05-07,0,1,1,134,0,0,39,9,38,1,0,0,1,0,6,5,32,9,6.5,67.0
946,7d4e49d8a6678157,07225ba28ae309b6,9e8f6c728eb01124,2022-05-07,1,2,1,202,1,0,47,18,44,3,0,0,3,2,15,12,29,16,9.0,163.0
947,7d4e49d8a6678157,9e8f6c728eb01124,07225ba28ae309b6,2022-05-07,1,0,0,202,0,0,33,13,33,0,0,0,0,0,11,8,22,13,0.0,180.0
948,6a902b97ac98c283,a6cba6bb66c1a8c9,a8283a4f415e1eb9,2022-05-07,0,0,0,900,0,0,118,15,117,1,0,0,1,1,26,21,91,14,2.6,778.6
949,6a902b97ac98c283,a8283a4f415e1eb9,a6cba6bb66c1a8c9,2022-05-07,0,1,0,900,1,0,124,62,112,12,1,1,11,7,21,17,91,55,82.4,636.4
950,60d9d50b763adc62,68d4a891e5cf2029,a4a80dd7336ffd59,2022-05-07,0,1,0,900,3,2,66,25,39,27,1,1,26,19,14,10,25,6,441.3,278.2
951,60d9d50b763adc62,a4a80dd7336ffd59,68d4a891e5cf2029,2022-05-07,0,1,0,900,6,3,73,25,70,3,0,0,3,3,12,5,58,22,147.8,261.7
952,430309e0f8a315d5,78f485f851891d68,9e92e1ca498d7244,2022-05-07,0,0,0,900,3,2,143,23,139,4,0,0,4,4,51,34,88,19,33.6,858.0
953,430309e0f8a315d5,9e92e1ca498d7244,78f485f851891d68,2022-05-07,0,0,0,900,0,0,103,24,103,0,0,0,0,0,19,13,84,24,0.0,864.4
954,397dd9a8694ef413,33efaf2d0941cfcf,87e2468b986ebb79,2022-05-07,1,0,0,155,0,0,24,12,23,1,0,0,1,1,5,5,18,11,2.0,153.0
955,397dd9a8694ef413,87e2468b986ebb79,33efaf2d0941cfcf,2022-05-07,0,0,0,155,0,0,31,9,31,0,0,0,0,0,12,10,19,9,0.0,153.0
956,eb277b5ea2a19124,3738e68d2261e60f,92fa1401b7927da3,2022-04-30,0,0,0,900,0,0,164,66,163,1,0,0,1,1,27,25,136,65,0.1,899.0
957,eb277b5ea2a19124,92fa1401b7927da3,3738e68d2261e60f,2022-04-30,0,0,0,900,3,2,188,77,188,0,0,0,0,0,20,16,168,77,0.0,681.9
958,d2484d74f819d813,01b352b6a9074d5c,c0badf3243907e59,2022-04-30,0,0,0,131,0,0,0,0,0,0,0,0,0,0,0,0,0,0,0.0,13.0
959,d2484d74f819d813,c0badf3243907e59,01b352b6a9074d5c,2022-04-30,0,1,1,131,3,3,14,8,0,14,0,0,14,8,0,0,0,0,118.0,13.0
960,9217ecc287ac482d,a29db9cd4f9ccea5,d80ee110748171ac,2022-04-30,0,0,0,900,16,9,141,68,132,9,3,3,6,5,23,21,109,63,115.9,667.1
961,9217ecc287ac482d,d80ee110748171ac,a29db9cd4f9ccea5,2022-04-30,0,0,0,900,4,3,210,64,207,3,0,0,3,2,52,40,155,62,13.9,668.1
962,80cf37627a129145,016a8d958883167c,568bbad0eaced57c,2022-04-30,0,0,0,491,5,1,86,15,86,0,0,0,0,0,36,33,50,15,0.0,356.8
963,80cf37627a129145,568bbad0eaced57c,016a8d958883167c,2022-04-30,1,0,0,491,0,0,102,34,80,22,2,1,20,13,21,14,59,21,52.2,434.0
964,7e4b7a70838e5ba4,31bb0772f21cabd8,cdadae5363b66eef,2022-04-30,0,0,0,78,1,1,6,1,6,0,0,0,0,0,3,3,3,1,0.0,50.0
965,7e4b7a70838e5ba4,cdadae5363b66eef,31bb0772f21cabd8,2022-04-30,0,1,1,78,0,0,5,0,5,0,0,0,0,0,5,5,0,0,0.0,78.0
966,7c8701bb78cb4de8,7026eca45f65377b,99bd51917728c25d,2022-04-30,0,0,0,851,0,0,119,48,114,5,3,3,2,1,33,26,81,47,17.1,625.1
967,7c8701bb78cb4de8,99bd51917728c25d,7026eca45f65377b,2022-04-30,0,2,1,851,17,7,111,42,106,5,0,0,5,5,15,12,91,37,153.9,402.9
968,760e3f292b834637,2ebfbe72ed703925,92a9aa9c93192871,2022-04-30,0,0,0,900,0,0,117,48,114,3,0,0,3,3,21,18,93,45,5.8,734.7
969,760e3f292b834637,92a9aa9c93192871,2ebfbe72ed703925,2022-04-30,0,1,0,900,10,5,151,66,141,10,0,0,10,8,10,9,131,58,107.3,422.2
970,6b956992204ec040,4e06913c91da5200,6ac9bc2953c47345,2022-04-30,0,0,0,900,4,4,124,51,118,6,0,0,6,6,22,14,96,45,139.3,575.0
971,6b956992204ec040,6ac9bc2953c47345,4e06913c91da5200,2022-04-30,0,0,0,900,4,1,91,17,91,0,0,0,0,0,21,20,70,17,0.0,646.7
972,632c2d4ed12f2bdf,791c8437b341fba5,8fd808923cffff82,2022-04-30,1,0,0,41,0,0,20,12,6,14,0,0,14,9,2,2,4,3,7.0,34.0
973,632c2d4ed12f2bdf,8fd808923cffff82,791c8437b341fba5,2022-04-30,0,0,0,41,0,0,15,6,15,0,0,0,0,0,0,0,15,6,0.0,34.0
974,5b731da9e4be4391,5eb50529a8418b77,f998f5c102250d6e,2022-04-30,1,0,0,542,0,0,123,26,110,13,0,0,13,8,25,22,85,18,29.6,452.5
975,5b731da9e4be4391,f998f5c102250d6e,5eb50529a8418b77,2022-04-30,1,1,0,542,4,2,80,15,77,3,1,1,2,2,39,25,38,13,48.5,415.4
976,5ae5eb729c6bb169,05339613bf8e9808,7c7332319c14094c,2022-04-30,0,0,0,1500,2,1,516,199,516,0,0,0,0,0,80,72,436,199,0.0,1370.5
977,5ae5eb729c6bb169,7c7332319c14094c,05339613bf8e9808,2022-04-30,3,0,0,1500,0,0,283,95,250,33,7,5,26,17,71,59,179,78,111.5,1375.0
978,e8c57c6259193466,49e96ff8ab781589,f9d0cae37dabfafc,2022-04-23,1,0,0,295,0,0,29,10,26,3,0,0,3,2,12,12,14,8,0.0,295.0
979,e8c57c6259193466,f9d0cae37dabfafc,49e96ff8ab781589,2022-04-23,0,0,0,295,0,0,22,2,22,0,0,0,0,0,2,2,20,2,0.0,295.0
980,e4d946470fd150fe,9fe7af8b3fbe00a0,d9a56ecb6e94f02e,2022-04-23,0,5,0,900,6,4,112,60,69,43,1,1,42,34,17,14,52,26,372.7,378.5
981,e4d946470fd150fe,d9a56ecb6e94f02e,9fe7af8b3fbe00a0,2022-04-23,0,0,0,900,2,0,60,12,59,1,0,0,1,0,17,15,42,12,53.5,420.3
982,a45d4327bc82bc28,6a740daf1b279661,80d8aed0ca9b00f3,2022-04-23,0,0,0,900,4,1,63,31,55,8,0,0,8,6,21,19,34,25,61.1,456.3
983,a45d4327bc82bc28,80d8aed0ca9b00f3,6a740daf1b279661,2022-04-23,0,0,0,900,2,1,28,7,27,1,0,0,1,1,9,7,18,6,23.7,483.9
984,9b8a82276f06829f,8be158ca1e5ea6a0,90da09db03e41748,2022-04-23,1,0,0,555,1,1,110,35,107,3,0,0,3,2,7,7,100,33,12.0,487.0
985,9b8a82276f06829f,90da09db03e41748,8be158ca1e5ea6a0,2022-04-23,2,0,0,555,1,1,125,35,120,5,0,0,5,2,16,14,104,33,48.0,495.0
986,926977ec3ed0ebe1,5f3da9a9610d8969,7d420039bbfe7c1a,2022-04-23,0,0,0,168,0,0,12,5,11,1,0,0,1,1,2,1,9,4,13.0,65.2
987,926977ec3ed0ebe1,7d420039bbfe7c1a,5f3da9a9610d8969,2022-04-23,1,0,0,168,1,1,64,28,21,43,3,3,40,22,6,6,15,6,89.8,61.0
988,7cf7960c6ccb5fa1,0641c21bec209472,a6f3d15cb84334bb,2022-04-23,0,0,0,232,1,0,37,13,37,0,0,0,0,0,7,5,30,13,0.0,219.2
989,7cf7960c6ccb5fa1,a6f3d15cb84334bb,0641c21bec209472,2022-04-23,1,0,0,232,0,0,90,25,86,4,0,0,4,2,12,11,74,23,3.8,217.0
990,6a4ba72b084193b5,53c943c873cffe90,6370c1c1e12723d5,2022-04-23,0,0,0,900,11,4,110,36,106,4,1,1,3,2,30,27,76,34,93.7,568.9
991,6a4ba72b084193b5,6370c1c1e12723d5,53c943c873cffe90,2022-04-23,0,0,0,900,1,0,117,13,116,1,0,0,1,1,68,61,48,12,3.1,693.3
992,6017351e164dbca3,c47df9303d318c67,d747eb273a40a920,2022-04-23,0,0,0,181,1,0,4,1,3,1,0,0,1,1,2,2,1,0,70.0,97.0
993,6017351e164dbca3,d747eb273a40a920,c47df9303d318c67,2022-04-23,0,2,1,181,0,0,3,1,2,1,0,0,1,1,1,0,1,0,14.0,97.0
994,3a3ac7b3987f6799,3df5493bb279226f,6a1901c62ab3870f,2022-04-23,0,0,0,193,0,0,17,4,17,0,0,0,0,0,5,3,12,4,0.0,193.0
995,3a3ac7b3987f6799,6a1901c62ab3870f,3df5493bb279226f,2022-04-23,0,1,1,193,1,0,9,0,9,0,0,0,0,0,6,3,3,0,0.0,155.0
996,173d576e6247a88a,f1d64ae34e088832,f9b200db02b488d9,2022-04-23,0,1,1,152,0,0,7,2,7,0,0,0,0,0,3,2,4,2,0.0,76.0
997,173d576e6247a88a,f9b200db02b488d9,f1d64ae34e088832,2022-04-23,0,0,0,152,1,1,14,5,13,1,0,0,1,1,4,3,9,4,57.0,95.0
998,fb7ebdda8658fa05,1897b7b913736a7c,35b3772629e27a49,2022-04-16,1,0,0,47,0,0,17,9,15,2,0,0,2,1,1,0,14,8,1.0,46.0
999,fb7ebdda8658fa05,35b3772629e27a49,1897b7b913736a7c,2022-04-16,0,0,0,47,0,0,12,0,12,0,0,0,0,0,7,2,5,0,0.0,46.0
1000,eac46cfead228e11,ac026518a9b4dc0f,cfc3e7bb44685289,2022-04-16,0,0,0,900,3,0,105,6,104,1,0,0,1,0,84,63,20,6,105.7,501.7
1001,eac46cfead228e11,cfc3e7bb44685289,ac026518a9b4dc0f,2022-04-16,0,2,0,900,4,1,90,10,88,2,0,0,2,2,44,31,44,8,81.3,672.3
1002,c20e6697335c3b3d,2eeaefbfc7f9fcff,91dac5e69e28d5b5,2022-04-16,1,0,0,900,3,0,88,30,88,0,0,0,0,0,13,9,75,30,0.0,757.0
1003,c20e6697335c3b3d,91dac5e69e28d5b5,2eeaefbfc7f9fcff,2022-04-16,0,0,0,900,1,1,160,59,160,0,0,0,0,0,20,19,140,59,0.0,629.0
1004,b09f8cd4cbd7ba56,5da33b8fbfa5ee95,cc7040fe76f0ef91,2022-04-16,0,2,0,801,1,1,41,11,41,0,0,0,0,0,12,10,29,11,0.0,499.0
1005,b09f8cd4cbd7ba56,cc7040fe76f0ef91,5da33b8fbfa5ee95,2022-04-16,1,0,0,801,5,2,47,19,42,5,0,0,5,5,17,15,25,14,173.0,455.0
1006,a0a120c50d93f70a,4126a78111c0855a,684d3aee255a3d09,2022-04-16,0,0,0,836,1,1,49,23,27,22,1,1,21,18,13,7,14,5,584.4,214.0
1007,a0a120c50d93f70a,684d3aee255a3d09,4126a78111c0855a,2022-04-16,0,0,0,836,2,1,38,6,36,2,1,1,1,1,9,5,27,5,11.0,229.60000000000002
1008,7c5fc3fc7be4a997,33efaf2d0941cfcf,82d4c957649faf9b,2022-04-16,1,0,0,279,0,0,56,19,54,2,0,0,2,2,15,13,39,17,0.9,276.0
1009,7c5fc3fc7be4a997,82d4c957649faf9b,33efaf2d0941cfcf,2022-04-16,0,0,0,279,0,0,58,15,58,0,0,0,0,0,10,9,48,15,0.0,278.1
1010,74c58b9d638c5eaa,6a8928652fc01bee,7cbf7c78d3b34218,2022-04-16,0,0,0,333,0,0,38,4,38,0,0,0,0,0,15,14,23,4,0.0,288.2
1011,74c58b9d638c5eaa,7cbf7c78d3b34218,6a8928652fc01bee,2022-04-16,2,0,0,333,3,2,108,55,88,20,0,0,20,11,21,21,67,44,34.8,218.0
1012,6d4b6224f26572f9,6d4b63c767106d3a,b1b0729d27936f2f,2022-04-16,0,0,0,1500,0,0,184,54,182,2,0,0,2,2,43,30,139,52,13.2,1392.2
1013,6d4b6224f26572f9,b1b0729d27936f2f,6d4b63c767106d3a,2022-04-16,0,0,0,1500,10,5,155,51,154,1,0,0,1,1,14,9,140,50,74.8,1037.8
1014,559031e51ced0b53,1497e735d9f2560a,49ee5024966efc0d,2022-04-16,0,0,0,900,2,0,213,34,213,0,0,0,0,0,72,54,141,34,0.0,892.0
1015,559031e51ced0b53,49ee5024966efc0d,1497e735d9f2560a,2022-04-16,0,0,0,900,2,0,260,98,260,0,0,0,0,0,52,43,208,98,0.0,838.0
1016,4f6e7159e77d4215,b8bbdeff718dbb7d,cd2e5a390821fb48,2022-04-16,0,0,0,900,10,6,63,29,26,37,0,0,37,22,8,7,18,7,454.4,209.3
1017,4f6e7159e77d4215,cd2e5a390821fb48,b8bbdeff718dbb7d,2022-04-16,0,0,0,900,4,1,31,9,25,6,0,0,6,3,8,6,17,6,211.7,198.60000000000002
1018,2e94ee4b9f5fddea,cc8c623cca88f54f,fdbefee0827e1567,2022-04-16,0,2,0,900,1,0,152,49,141,11,5,0,6,4,50,38,91,45,35.9,744.9
1019,2e94ee4b9f5fddea,fdbefee0827e1567,cc8c623cca88f54f,2022-04-16,0,0,0,900,1,1,218,37,207,11,5,1,6,4,44,24,163,33,106.1,729.1
1020,1ceab8fa45996f51,7a5e8c94a86f9895,8eb046f83e82bf26,2022-04-16,0,0,0,698,0,0,52,12,52,0,0,0,0,0,14,11,38,12,0.0,597.7
1021,1ceab8fa45996f51,8eb046f83e82bf26,7a5e8c94a86f9895,2022-04-16,1,0,0,698,0,0,83,30,76,7,0,0,7,4,27,26,49,26,83.3,234.0
1022,0daf776bd222daad,e94085e821bd81de,efc67b07eed39794,2022-04-16,0,0,0,900,5,2,182,67,163,19,0,0,19,13,15,9,148,54,150.5,694.0
1023,0daf776bd222daad,efc67b07eed39794,e94085e821bd81de,2022-04-16,0,0,0,900,0,0,228,52,226,2,0,0,2,1,55,37,171,51,0.0,749.5
1024,0987b3f785e26d1c,5580771f383e141f,e132d47bd9efbbe0,2022-04-16,0,0,0,590,1,0,61,13,61,0,0,0,0,0,13,12,48,13,0.0,338.7
1025,0987b3f785e26d1c,e132d47bd9efbbe0,5580771f383e141f,2022-04-16,0,1,1,590,4,3,80,31,71,9,0,0,9,8,4,4,67,23,249.3,313.0
1026,dc0ab34f1952cb48,c451d67c09c55418,e1248941344b3288,2022-04-09,0,0,0,945,0,0,125,31,125,0,0,0,0,0,22,17,103,31,0.0,846.7
1027,dc0ab34f1952cb48,e1248941344b3288,c451d67c09c55418,2022-04-09,1,0,0,945,8,4,213,102,197,16,1,1,15,11,41,35,156,91,98.3,773.0
1028,d8945e21a63e2451,31ef8b67e13495b3,7447e9f28508106a,2022-04-09,0,0,0,900,2,0,124,19,122,2,0,0,2,1,63,57,59,18,174.0,690.0
1029,d8945e21a63e2451,7447e9f28508106a,31ef8b67e13495b3,2022-04-09,0,3,0,900,5,0,156,42,155,1,0,0,1,1,9,8,146,41,36.0,582.0
1030,9e52a67410f2c879,4100c7a09497ad41,e375cb5caf4717b6,2022-04-09,0,0,0,900,8,2,77,22,76,1,0,0,1,1,16,9,60,21,17.6,601.7
1031,9e52a67410f2c879,e375cb5caf4717b6,4100c7a09497ad41,2022-04-09,0,0,0,900,4,3,88,26,82,6,2,2,4,4,26,22,56,22,104.3,569.4
1032,9a8964b148cb5923,cb696ebfb6598724,d661ce4da776fc20,2022-04-09,0,0,0,1500,22,2,110,29,91,19,2,1,17,14,42,32,49,15,373.4,805.3
1033,9a8964b148cb5923,d661ce4da776fc20,cb696ebfb6598724,2022-04-09,0,0,0,1500,0,0,103,32,91,12,4,4,8,5,28,27,63,27,183.7,774.6
1034,88c6e7f71b79fd65,d4691518d012b9e7,fc169c387b4b465d,2022-04-09,0,0,0,900,4,2,160,37,160,0,0,0,0,0,42,28,118,37,0.0,724.0
1035,88c6e7f71b79fd65,fc169c387b4b465d,d4691518d012b9e7,2022-04-09,0,0,0,900,1,0,195,57,195,0,0,0,0,0,62,57,133,57,0.0,798.0
1036,7c6ed5b3d830d0cb,093e1f5bb73850be,ca43de99b07b6b40,2022-04-09,0,3,0,900,11,8,71,39,34,37,6,6,31,28,3,3,31,11,518.8,213.7
1037,7c6ed5b3d830d0cb,ca43de99b07b6b40,093e1f5bb73850be,2022-04-09,0,1,0,900,1,1,54,16,49,5,1,1,4,3,16,14,33,13,41.3,224.20000000000005
1038,7458a37feabf8788,9e50097a89442158,dd6103dd7127db1d,2022-04-09,0,0,0,221,1,1,30,13,30,0,0,0,0,0,1,0,29,13,0.0,199.7
1039,7458a37feabf8788,dd6103dd7127db1d,9e50097a89442158,2022-04-09,1,0,0,221,0,0,44,21,38,6,0,0,6,6,7,7,31,15,4.3,216.0
1040,394b0347b0438622,23024fdfc966410a,767755fd74662dbf,2022-04-09,0,0,0,900,5,0,200,89,188,12,1,1,11,10,33,29,155,79,3.3,809.1
1041,394b0347b0438622,767755fd74662dbf,23024fdfc966410a,2022-04-09,1,0,0,900,3,2,223,84,204,19,2,2,17,8,30,22,174,76,84.9,753.7
1042,313c36ce9bde6cf6,1291edf2d566a71a,b67d6bacc68d4c92,2022-04-09,0,0,0,900,1,0,265,100,265,0,0,0,0,0,37,27,228,100,0.0,882.0
1043,313c36ce9bde6cf6,b67d6bacc68d4c92,1291edf2d566a71a,2022-04-09,0,0,0,900,2,0,229,27,229,0,0,0,0,0,32,22,197,27,0.0,854.0
1044,313b85fe82b2ba80,326a001926ffb7ec,442c9011034ae1fd,2022-04-09,0,0,0,900,3,1,77,17,77,0,0,0,0,0,30,23,47,17,0.0,728.0
1045,313b85fe82b2ba80,442c9011034ae1fd,326a001926ffb7ec,2022-04-09,0,0,0,900,0,0,144,47,144,0,0,0,0,0,31,27,113,47,0.0,861.0
1046,278b965694e563b2,2b68d9f125d07b42,98c23cb6da5b3352,2022-04-09,0,0,0,219,0,0,40,13,31,9,0,0,9,7,3,2,28,6,48.6,165.0
1047,278b965694e563b2,98c23cb6da5b3352,2b68d9f125d07b42,2022-04-09,0,1,1,219,0,0,22,3,22,0,0,0,0,0,6,5,16,3,0.0,126.4
1048,15311d4b33d93004,c77a953488e5607d,da0995f19b749cfa,2022-04-09,0,0,0,900,2,1,123,32,117,6,1,1,5,4,44,35,73,28,16.9,714.2
1049,15311d4b33d93004,da0995f19b749cfa,c77a953488e5607d,2022-04-09,0,0,0,900,3,3,87,27,83,4,0,0,4,4,12,12,71,23,137.8,573.1
1050,f6afaf2a39fa441c,19c591115a58982c,32c355b04fc57f3a,2022-03-26,0,0,0,900,0,0,21,6,18,3,0,0,3,3,6,6,12,3,11.7,386.7
1051,f6afaf2a39fa441c,32c355b04fc57f3a,19c591115a58982c,2022-03-26,0,0,0,900,18,11,20,6,11,9,3,3,6,5,9,8,2,1,478.3,144.3
1052,f3c37e23ca30c87d,31123249b0bbf52e,a331233f597090a5,2022-03-26,0,0,0,900,7,5,129,36,123,6,5,5,1,1,49,40,74,35,53.1,592.9
1053,f3c37e23ca30c87d,a331233f597090a5,31123249b0bbf52e,2022-03-26,0,0,0,900,0,0,211,82,206,5,0,0,5,5,41,29,165,77,6.1,789.9
1054,d0b7a79d3e7f3362,3b0a516d2921e0d6,45f0cc9d18f35137,2022-03-26,0,0,0,454,1,1,104,20,96,8,0,0,8,5,16,10,80,15,21.3,417.0
1055,d0b7a79d3e7f3362,45f0cc9d18f35137,3b0a516d2921e0d6,2022-03-26,1,0,0,454,0,0,79,20,74,5,0,0,5,4,26,21,48,16,13.0,419.7
1056,c4e866d9dd606faa,d0aaedcf7ccd0b45,fa6796c55d6c5440,2022-03-26,0,0,0,317,0,0,38,12,38,0,0,0,0,0,2,1,36,12,0.0,314.0
1057,c4e866d9dd606faa,fa6796c55d6c5440,d0aaedcf7ccd0b45,2022-03-26,1,0,0,317,0,0,63,23,54,9,1,1,8,5,7,6,47,18,3.0,314.0
1058,bb31c77bddd1317e,351c4ec637380ad5,7be74a12d7352df2,2022-03-26,0,0,0,900,2,1,43,20,32,11,4,3,7,3,3,3,29,17,70.9,407.8
1059,bb31c77bddd1317e,7be74a12d7352df2,351c4ec637380ad5,2022-03-26,0,0,0,900,6,4,41,15,29,12,0,0,12,10,13,9,16,5,376.2,202.1
1060,97e522591ac7eb29,0e5c4e72237461bb,12e0fdc606f7e274,2022-03-26,0,0,0,900,2,1,178,37,178,0,0,0,0,0,44,29,134,37,0.0,846.9
1061,97e522591ac7eb29,12e0fdc606f7e274,0e5c4e72237461bb,2022-03-26,0,0,0,900,5,2,168,41,165,3,0,0,3,3,59,43,106,38,41.1,804.0
1062,82b2b97b85c7225c,1a31ef98efce7a79,9ada30894bf04e19,2022-03-26,1,0,0,900,2,0,81,21,78,3,1,1,2,1,18,14,60,20,36.0,821.1
1063,82b2b97b85c7225c,9ada30894bf04e19,1a31ef98efce7a79,2022-03-26,0,0,0,900,2,0,110,25,106,4,0,0,4,2,23,14,83,23,30.9,779.0
1064,6ed495c177d69a3a,0112352cb32f5026,7ab478c397cd68ef,2022-03-26,0,0,0,418,1,0,82,28,82,0,0,0,0,0,4,3,78,28,0.0,295.3
1065,6ed495c177d69a3a,7ab478c397cd68ef,0112352cb32f5026,2022-03-26,0,1,1,418,3,2,67,31,59,8,1,1,7,7,13,10,46,24,120.7,252.0
1066,410e65e4d1782bfc,853eb0dd5c0e2149,b1d19449397541dc,2022-03-26,0,0,0,900,1,0,130,26,128,2,0,0,2,2,34,25,94,24,0.0,900.0
1067,410e65e4d1782bfc,b1d19449397541dc,853eb0dd5c0e2149,2022-03-26,0,2,0,900,14,2,60,25,60,0,0,0,0,0,5,2,55,25,0.0,586.0
1068,3f92025b29e06bfd,84b3e7d38f2d2ec5,b0d6a1d8ac3d563d,2022-03-26,0,0,0,900,9,1,144,42,144,0,0,0,0,0,18,12,126,42,0.0,611.4
1069,3f92025b29e06bfd,b0d6a1d8ac3d563d,84b3e7d38f2d2ec5,2022-03-26,1,0,0,900,2,0,123,34,119,4,1,1,3,1,35,32,84,33,15.6,861.0
1070,3ecccdab76baa59c,34ff304266360297,8e1f36476ef02a6a,2022-03-26,0,0,0,900,4,2,138,40,133,5,0,0,5,5,47,43,86,35,112.1,735.4
1071,3ecccdab76baa59c,8e1f36476ef02a6a,34ff304266360297,2022-03-26,0,0,0,900,4,1,121,23,120,1,0,0,1,1,18,14,102,22,7.6,711.9
1072,1b650c76387c0f4b,12f91bfa8f1f723b,e8b731feff72294b,2022-03-26,0,0,0,237,0,0,49,22,47,2,0,0,2,2,16,12,31,20,0.0,203.2
1073,1b650c76387c0f4b,e8b731feff72294b,12f91bfa8f1f723b,2022-03-26,0,1,1,237,2,2,28,13,27,1,0,0,1,1,3,3,24,12,33.8,102.0
1074,ce3d94186567a684,040a74bb0a465c54,193b9d1858bc4df3,2022-03-19,1,0,0,153,0,0,84,43,84,0,0,0,0,0,6,6,78,43,0.0,151.0
1075,ce3d94186567a684,193b9d1858bc4df3,040a74bb0a465c54,2022-03-19,0,0,0,153,0,0,49,11,49,0,0,0,0,0,5,3,44,11,0.0,153.0
1076,bcd1e1d71a172d53,8abac218746e04ca,fd55393021a8c255,2022-03-19,0,0,0,900,0,0,23,4,23,0,0,0,0,0,7,5,16,4,0.0,438.9
1077,bcd1e1d71a172d53,fd55393021a8c255,8abac218746e04ca,2022-03-19,0,1,0,900,3,3,55,36,22,33,1,1,32,32,7,7,15,4,461.1,411.0
1078,ae989e21c3839b49,2f5cbecbbe18bac4,f14cf73e51b29254,2022-03-19,0,0,0,243,1,0,34,4,34,0,0,0,0,0,18,13,16,4,0.0,234.8
1079,ae989e21c3839b49,f14cf73e51b29254,2f5cbecbbe18bac4,2022-03-19,1,0,0,243,0,0,47,21,30,17,0,0,17,11,1,0,29,10,8.2,231.0
1080,a200b5dcbdd2506e,4c88a1db5a46c6a4,54f64b5e283b0ce7,2022-03-19,1,0,0,367,0,0,63,20,60,3,0,0,3,2,3,2,57,18,5.2,252.7
1081,a200b5dcbdd2506e,54f64b5e283b0ce7,4c88a1db5a46c6a4,2022-03-19,1,0,0,367,4,1,41,17,37,4,0,0,4,4,4,3,33,13,107.3,200.8
1082,766b4f5e77ab0860,1091d4d957141094,eabf206b162b3b83,2022-03-19,0,0,0,237,1,1,25,18,3,22,0,0,22,16,1,1,2,2,229.0,6.0
1083,766b4f5e77ab0860,eabf206b162b3b83,1091d4d957141094,2022-03-19,0,1,1,237,1,1,3,2,0,3,0,0,3,2,0,0,0,0,2.0,6.0
1084,6e705b2365bc03fa,56fcb2c4d99f9d1b,87a1dc546b1c5caf,2022-03-19,0,0,0,57,1,1,3,0,3,0,0,0,0,0,1,0,2,0,0.0,26.0
1085,6e705b2365bc03fa,87a1dc546b1c5caf,56fcb2c4d99f9d1b,2022-03-19,0,1,1,57,0,0,1,0,1,0,0,0,0,0,0,0,1,0,0.0,42.0
1086,5e378c52f26935d6,3351aa64aa83c4d9,ac7c765882f2c68c,2022-03-19,0,0,0,900,7,3,160,53,152,8,0,0,8,7,10,7,142,46,129.1,664.2
1087,5e378c52f26935d6,ac7c765882f2c68c,3351aa64aa83c4d9,2022-03-19,0,0,0,900,0,0,140,44,136,4,0,0,4,3,42,32,94,41,9.8,748.9
1088,5a878a6bebc973d7,51018a31ddf31eb2,528b071cf3da7c56,2022-03-19,1,0,0,712,2,2,159,52,157,2,2,2,0,0,39,31,118,52,27.0,442.0
1089,5a878a6bebc973d7,528b071cf3da7c56,51018a31ddf31eb2,2022-03-19,0,0,0,712,0,0,132,26,132,0,0,0,0,0,44,38,88,26,0.0,658.0
1090,53d0df57a917c6a0,45e738622ea2c02c,b8a85389d115e35a,2022-03-19,0,1,0,900,3,2,150,23,150,0,0,0,0,0,67,49,83,23,0.0,604.7
1091,53d0df57a917c6a0,b8a85389d115e35a,45e738622ea2c02c,2022-03-19,2,0,0,900,7,3,107,46,96,11,0,0,11,11,26,24,70,35,172.3,618.0
1092,4c7e55061dc3bf89,75353550928a7921,7f6ed67d3ed3c036,2022-03-19,1,1,1,58,0,0,5,1,4,1,0,0,1,0,2,1,2,1,11.0,47.0
1093,4c7e55061dc3bf89,7f6ed67d3ed3c036,75353550928a7921,2022-03-19,0,0,0,58,1,1,5,0,5,0,0,0,0,0,3,1,2,0,0.0,47.0
1094,06641a8c62e45661,279566840aa55bf2,399afbabc02376b5,2022-03-19,0,0,0,225,0,0,23,6,22,1,0,0,1,0,7,7,15,6,0.0,117.7
1095,06641a8c62e45661,399afbabc02376b5,279566840aa55bf2,2022-03-19,0,1,1,225,2,2,43,16,27,16,2,2,14,10,11,11,16,6,107.3,111.0
1096,001441f70c293931,7826923b47f8d72a,ec18eb918121787c,2022-03-19,0,1,1,229,2,1,6,1,5,1,0,0,1,1,2,2,3,0,26.5,78.2
1097,001441f70c293931,ec18eb918121787c,7826923b47f8d72a,2022-03-19,0,0,0,229,0,0,9,5,6,3,0,0,3,3,2,2,4,2,97.8,39.5
1098,f10c2c84652ef573,6aae253467e8f9ce,e90a2f22417af68e,2022-03-12,0,0,0,644,0,0,98,14,98,0,0,0,0,0,39,29,59,14,0.0,630.0
1099,f10c2c84652ef573,e90a2f22417af68e,6aae253467e8f9ce,2022-03-12,1,0,0,644,5,1,69,25,69,0,0,0,0,0,9,3,60,25,0.0,605.0
1100,b70313eae7c24b27,bbab3baf66128ae2,ec23c1be628d8057,2022-03-12,0,0,0,900,0,0,164,52,164,0,0,0,0,0,45,37,119,52,0.0,900.0
1101,b70313eae7c24b27,ec23c1be628d8057,bbab3baf66128ae2,2022-03-12,0,0,0,900,3,0,178,33,178,0,0,0,0,0,36,29,142,33,0.0,897.0
1102,b55de7d791b9f62d,70d2329a92864fdb,f29a6350c69f4a33,2022-03-12,0,0,0,435,0,0,48,8,46,2,2,0,0,0,9,7,37,8,0.0,227.6
1103,b55de7d791b9f62d,f29a6350c69f4a33,70d2329a92864fdb,2022-03-12,0,1,1,435,7,4,50,10,44,6,0,0,6,3,14,9,30,7,207.4,193.0
1104,b400c29fbeee0206,9c27f3217891f3f0,d05412b513b19621,2022-03-12,0,0,0,127,0,0,30,8,30,0,0,0,0,0,6,3,24,8,0.0,127.0
1105,b400c29fbeee0206,d05412b513b19621,9c27f3217891f3f0,2022-03-12,1,0,0,127,0,0,44,18,44,0,0,0,0,0,13,10,31,18,0.0,126.0
1106,9cb78122a23e6a7d,ce632027bf2a871b,f14f644d41ade29f,2022-03-12,0,0,0,221,1,1,56,26,41,15,0,0,15,8,4,3,37,18,42.0,109.0
1107,9cb78122a23e6a7d,f14f644d41ade29f,ce632027bf2a871b,2022-03-12,0,1,1,221,4,1,8,2,8,0,0,0,0,0,3,2,5,2,0.0,144.0
1108,9b46a662b8fa1d8d,efb96bf3e9ada36f,fea79f9bc8c68769,2022-03-12,1,0,0,126,0,0,35,10,35,0,0,0,0,0,6,4,29,10,0.0,126.0
1109,9b46a662b8fa1d8d,fea79f9bc8c68769,efb96bf3e9ada36f,2022-03-12,0,0,0,126,0,0,25,9,25,0,0,0,0,0,0,0,25,9,0.0,126.0
1110,8aa16cc1ba99aac1,d802174b0c0c1f4e,dea070ed4a2a8281,2022-03-12,0,0,0,1500,2,1,155,33,153,2,0,0,2,2,61,45,92,31,28.7,1273.7
1111,8aa16cc1ba99aac1,dea070ed4a2a8281,d802174b0c0c1f4e,2022-03-12,1,0,0,1500,0,0,138,14,136,2,1,1,1,1,62,45,74,13,11.3,1454.3
1112,70b8d357e89383bd,7aa3d6964eff4877,94426bb170c88115,2022-03-12,0,0,0,900,3,1,138,43,138,0,0,0,0,0,31,23,107,43,0.0,879.0
1113,70b8d357e89383bd,94426bb170c88115,7aa3d6964eff4877,2022-03-12,0,0,0,900,3,1,123,18,123,0,0,0,0,0,53,46,70,18,0.0,738.0
1114,5cad3ab6553e9ec9,29af297d9f1de0f8,c7d7fda69ec410d3,2022-03-12,0,1,1,582,3,2,78,22,70,8,0,0,8,3,17,10,53,19,269.6,245.0
1115,5cad3ab6553e9ec9,c7d7fda69ec410d3,29af297d9f1de0f8,2022-03-12,0,0,0,582,0,0,54,14,54,0,0,0,0,0,11,8,43,14,0.0,312.4
1116,463fac0e48505b62,519e4fe37ce9ff75,809bd1a871491508,2022-03-12,1,0,0,197,1,0,37,14,21,16,0,0,16,9,3,3,18,5,21.3,96.0
1117,463fac0e48505b62,809bd1a871491508,519e4fe37ce9ff75,2022-03-12,1,0,0,197,3,2,61,33,37,24,0,0,24,16,4,3,33,17,77.0,82.7
1118,3b06c512abfa0494,4aa58269d0664b5b,725b1abc9a39d873,2022-03-12,0,0,0,900,1,1,82,32,54,28,1,1,27,16,14,7,40,16,266.5,320.0
1119,3b06c512abfa0494,725b1abc9a39d873,4aa58269d0664b5b,2022-03-12,0,2,0,900,6,4,64,21,59,5,0,0,5,4,15,13,44,17,285.0,291.5
1120,26fbee4ed13ff35d,38c7f72747f4f712,6fd953151d981979,2022-03-12,0,0,0,900,6,1,139,17,139,0,0,0,0,0,58,35,81,17,0.0,847.2
1121,26fbee4ed13ff35d,6fd953151d981979,38c7f72747f4f712,2022-03-12,0,0,0,900,1,0,118,56,116,2,0,0,2,2,4,4,112,54,28.8,713.0
1122,23eec2d9cb2d78cd,37d5b176d438d2a5,749f572d1d3161fb,2022-03-12,0,0,0,325,0,0,28,4,28,0,0,0,0,0,18,13,10,4,0.0,317.5
1123,23eec2d9cb2d78cd,749f572d1d3161fb,37d5b176d438d2a5,2022-03-12,2,0,0,325,1,0,69,16,62,7,3,2,4,2,13,8,49,14,7.5,310.0
1124,226884e46a10865d,12ebd7d157e91701,e5549c82bfb5582d,2022-03-12,0,0,0,900,8,2,147,39,147,0,0,0,0,0,28,20,119,39,0.0,702.2
1125,226884e46a10865d,e5549c82bfb5582d,12ebd7d157e91701,2022-03-12,0,0,0,900,0,0,179,60,178,1,0,0,1,0,59,48,119,60,2.8,823.0
1126,fce6ab43b7d09aa4,4d8fa64202cee4c1,af9f42e6894047fc,2022-03-05,1,0,0,346,1,1,111,34,101,10,0,0,10,4,25,18,76,30,1.3,283.3
1127,fce6ab43b7d09aa4,af9f42e6894047fc,4d8fa64202cee4c1,2022-03-05,0,0,0,346,3,1,59,22,55,4,0,0,4,3,18,13,37,19,60.7,253.7
1128,ee278a5a25744cac,8667caa0451d245b,8c57c7b8c3bab0eb,2022-03-05,0,0,0,900,0,0,190,84,190,0,0,0,0,0,13,11,177,84,0.0,900.0
1129,ee278a5a25744cac,8c57c7b8c3bab0eb,8667caa0451d245b,2022-03-05,0,0,0,900,5,1,160,36,160,0,0,0,0,0,34,28,126,36,0.0,692.0
1130,d5323490163dde0e,0d65c432720accb9,e4277e87a789d687,2022-03-05,0,0,0,900,2,1,173,59,173,0,0,0,0,0,13,10,160,59,0.0,876.4
1131,d5323490163dde0e,e4277e87a789d687,0d65c432720accb9,2022-03-05,0,0,0,900,2,1,243,74,242,1,0,0,1,1,21,15,221,73,6.6,710.0
1132,d03d0abf331df751,47b9e0e7703a4868,dc9572dd6ec74859,2022-03-05,0,0,0,1500,0,0,140,38,140,0,0,0,0,0,46,29,94,38,0.0,695.0
1133,d03d0abf331df751,dc9572dd6ec74859,47b9e0e7703a4868,2022-03-05,0,1,0,1500,15,6,201,84,168,33,2,2,31,23,9,8,159,61,784.0,526.0
1134,cda06ff86cfe4f5f,85073dbd1be65ed9,e2f6b2769aaedd6c,2022-03-05,0,0,0,136,0,0,12,3,12,0,0,0,0,0,4,4,8,3,0.0,55.0
1135,cda06ff86cfe4f5f,e2f6b2769aaedd6c,85073dbd1be65ed9,2022-03-05,1,0,0,136,4,3,27,14,7,20,0,0,20,14,0,0,7,0,81.0,55.0
1136,c6fc43c351b08bda,a08ddd04eaffd81d,b4192a975027aab6,2022-03-05,0,0,0,507,0,0,27,7,27,0,0,0,0,0,12,9,15,7,0.0,147.0
1137,c6fc43c351b08bda,b4192a975027aab6,a08ddd04eaffd81d,2022-03-05,0,3,1,507,5,2,42,21,15,27,0,0,27,19,9,7,6,2,320.0,104.0
1138,c420c376cc1d149c,c96d9178c9ed9e62,f00ac08ab056af5d,2022-03-05,1,0,0,900,9,3,179,30,179,0,0,0,0,0,66,49,113,30,0.0,826.9
1139,c420c376cc1d149c,f00ac08ab056af5d,c96d9178c9ed9e62,2022-03-05,0,1,0,900,10,2,186,70,184,2,0,0,2,2,24,20,160,68,21.1,605.0
1140,abd45edc07a8d9e3,64a50dad704d1d49,d9c6f19f958643e9,2022-03-05,0,0,0,900,0,0,37,3,36,1,0,0,1,1,20,13,16,2,2.0,210.0
1141,abd45edc07a8d9e3,d9c6f19f958643e9,64a50dad704d1d49,2022-03-05,1,0,0,900,4,4,47,28,18,29,1,1,28,24,6,5,12,4,688.0,210.0
1142,9321b3c90ea5ca6c,c41d426cc7326d1b,cd2c4d30c6e13b47,2022-03-05,0,0,0,900,4,2,132,37,132,0,0,0,0,0,27,19,105,37,0.0,807.0
1143,9321b3c90ea5ca6c,cd2c4d30c6e13b47,c41d426cc7326d1b,2022-03-05,0,0,0,900,0,0,200,46,200,0,0,0,0,0,34,26,166,46,0.0,859.0
1144,59d44b6888885500,2b6fc1c02736833d,7be14eaed4c74856,2022-03-05,0,1,1,195,5,1,26,9,26,0,0,0,0,0,11,9,15,9,0.0,108.0
1145,59d44b6888885500,7be14eaed4c74856,2b6fc1c02736833d,2022-03-05,0,0,0,195,0,0,19,0,19,0,0,0,0,0,6,1,13,0,0.0,189.0
1146,43b43c5d439b2f98,3a46b268013afede,57b10fca4f9c9a7a,2022-03-05,1,0,0,338,0,0,76,24,53,23,0,0,23,16,28,26,25,8,14.4,301.0
1147,43b43c5d439b2f98,57b10fca4f9c9a7a,3a46b268013afede,2022-03-05,0,1,0,338,3,2,44,6,43,1,0,0,1,1,16,15,27,5,22.0,301.6
1148,36d9337a27b71ba9,207773daeb4afa7b,5b86d491d63890c5,2022-03-05,0,0,0,900,3,0,98,19,98,0,0,0,0,0,40,34,58,19,0.0,886.0
1149,36d9337a27b71ba9,5b86d491d63890c5,207773daeb4afa7b,2022-03-05,0,0,0,900,2,0,95,25,95,0,0,0,0,0,39,35,56,25,0.0,501.0
1150,f087a10a6f2bcc99,3eb4dc9a7d4ac906,68d35296f566792b,2022-02-26,0,0,0,900,10,3,100,25,95,5,1,1,4,2,28,26,67,23,100.5,660.4
1151,f087a10a6f2bcc99,68d35296f566792b,3eb4dc9a7d4ac906,2022-02-26,2,0,0,900,0,0,222,83,209,13,0,0,13,7,17,15,192,76,18.6,756.5
1152,cb1f27818d46af0e,1e4f273069fb9e85,809bd1a871491508,2022-02-26,0,0,0,131,0,0,1,0,1,0,0,0,0,0,1,1,0,0,0.0,4.0
1153,cb1f27818d46af0e,809bd1a871491508,1e4f273069fb9e85,2022-02-26,0,1,1,131,0,0,4,2,1,3,1,1,2,2,1,0,0,0,123.0,8.0
1154,c5d5fcf290cc029e,3d074044a33825e7,ce175eaafe867d1f,2022-02-26,0,3,1,122,1,1,1,0,1,0,0,0,0,0,0,0,1,0,0.0,29.0
1155,c5d5fcf290cc029e,ce175eaafe867d1f,3d074044a33825e7,2022-02-26,0,0,0,122,0,0,2,0,2,0,0,0,0,0,1,0,1,0,0.0,122.0
1156,c4eb14c3de579842,a20f234df70f2182,b1e5bcaad32a3cac,2022-02-26,0,0,0,900,0,0,375,151,375,0,0,0,0,0,24,19,351,151,0.0,895.0
1157,c4eb14c3de579842,b1e5bcaad32a3cac,a20f234df70f2182,2022-02-26,0,0,0,900,1,1,218,78,218,0,0,0,0,0,33,24,185,78,0.0,873.0
1158,901e62b7af57f559,80daefbed11ce998,f2477cf43c4975cc,2022-02-26,1,0,0,900,1,0,146,34,146,0,0,0,0,0,21,18,125,34,0.0,898.0
1159,901e62b7af57f559,f2477cf43c4975cc,80daefbed11ce998,2022-02-26,0,0,0,900,0,0,144,36,144,0,0,0,0,0,52,38,92,36,0.0,900.0
1160,8515f07911765f89,58bbef3770bb2dfc,eae48ff31db420c2,2022-02-26,0,0,0,417,0,0,10,5,6,4,0,0,4,3,2,2,4,2,0.0,49.0
1161,8515f07911765f89,eae48ff31db420c2,58bbef3770bb2dfc,2022-02-26,1,0,0,417,2,2,53,31,9,44,2,2,42,30,3,3,6,1,368.0,49.0
1162,84d633d4a9fbf331,369ea36e450ae62a,d1c65d2cf2925ddd,2022-02-26,0,0,0,900,0,0,231,50,231,0,0,0,0,0,92,77,139,50,0.0,900.0
1163,84d633d4a9fbf331,d1c65d2cf2925ddd,369ea36e450ae62a,2022-02-26,0,2,0,900,3,2,133,45,133,0,0,0,0,0,19,16,114,45,0.0,806.0
1164,61a20ff34b6948ba,a13d755965a4ec9f,e4a47b07044ddd72,2022-02-26,0,0,0,700,4,1,129,34,128,1,0,0,1,1,15,14,113,33,6.7,614.2
1165,61a20ff34b6948ba,e4a47b07044ddd72,a13d755965a4ec9f,2022-02-26,0,2,1,700,0,0,194,86,181,13,0,0,13,6,43,40,138,80,65.8,612.3
1166,181ceedcacc01d48,798e48f9e7f6ba22,dc7927cd622676a7,2022-02-26,0,0,0,900,9,2,172,56,170,2,1,1,1,1,37,27,133,55,4.4,811.3
1167,181ceedcacc01d48,dc7927cd622676a7,798e48f9e7f6ba22,2022-02-26,0,0,0,900,4,1,138,32,137,1,0,0,1,0,51,47,86,32,6.7,808.6
1168,01468f766dd7385c,4dcfb28c011c11b2,67f272324a030d00,2022-02-26,0,2,1,389,3,0,19,8,19,0,0,0,0,0,7,7,12,8,0.0,83.1
1169,01468f766dd7385c,67f272324a030d00,4dcfb28c011c11b2,2022-02-26,0,1,0,389,3,1,44,20,18,26,5,4,21,16,6,6,12,4,170.9,205.0
1170,f7865e5a6d009a87,5444c5a201d3ee5a,c21f26bbde777573,2022-02-19,1,0,0,175,0,0,19,5,18,1,0,0,1,1,2,1,16,4,3.0,172.0
1171,f7865e5a6d009a87,c21f26bbde777573,5444c5a201d3ee5a,2022-02-19,0,0,0,175,0,0,25,4,25,0,0,0,0,0,10,8,15,4,0.0,150.0
1172,ea63f56779100678,8c39367b53eadf8a,c7c39e2fb70248b3,2022-02-19,0,0,0,813,7,4,126,17,126,0,0,0,0,0,62,47,64,17,0.0,577.0
1173,ea63f56779100678,c7c39e2fb70248b3,8c39367b53eadf8a,2022-02-19,2,2,0,813,1,0,130,53,112,18,0,0,18,14,20,14,92,39,36.0,733.0
1174,e36a5d4d53b97d4e,5e6294b37bbef029,6c8072b61c276e67,2022-02-19,0,1,1,224,2,2,10,5,4,6,0,0,6,5,0,0,4,0,81.0,143.0
1175,e36a5d4d53b97d4e,6c8072b61c276e67,5e6294b37bbef029,2022-02-19,0,0,0,224,1,1,4,1,4,0,0,0,0,0,2,1,2,1,0.0,22.0
1176,958799d957945a3a,37f560436d745c18,d1941565abf50b16,2022-02-19,0,0,0,418,0,0,57,17,57,0,0,0,0,0,4,4,53,17,0.0,388.2
1177,958799d957945a3a,d1941565abf50b16,37f560436d745c18,2022-02-19,1,0,0,418,0,0,92,24,71,21,0,0,21,11,25,24,46,13,29.8,384.0
1178,93026443e5140415,ac40f7e3cbecdda4,c9a94278df042f46,2022-02-19,0,0,0,900,8,2,106,20,101,5,1,1,4,2,25,22,76,18,164.2,506.0
1179,93026443e5140415,c9a94278df042f46,ac40f7e3cbecdda4,2022-02-19,0,0,0,900,0,0,107,43,107,0,0,0,0,0,13,12,94,43,0.0,711.8
1180,8cd583f6d10692bc,01fed6f61ebea01f,bc711b6dd95c1af6,2022-02-19,0,0,0,900,5,2,107,16,107,0,0,0,0,0,40,26,67,16,0.0,739.3
1181,8cd583f6d10692bc,bc711b6dd95c1af6,01fed6f61ebea01f,2022-02-19,0,0,0,900,6,4,125,43,119,6,0,0,6,4,39,29,80,39,55.7,510.0
1182,528c208293bdef13,5ec591b78349ba7e,87c0b1c696ddfb43,2022-02-19,0,3,0,900,2,2,60,21,59,1,0,0,1,1,6,5,53,20,13.0,527.3
1183,528c208293bdef13,87c0b1c696ddfb43,5ec591b78349ba7e,2022-02-19,0,2,0,900,10,6,44,9,39,5,1,1,4,2,12,8,27,7,307.7,210.0
1184,33cc40fc1da409d3,5dd180c8b3196786,d7e40dca3ae125be,2022-02-19,0,0,0,900,5,1,175,70,175,0,0,0,0,0,19,18,156,70,0.0,576.0
1185,33cc40fc1da409d3,d7e40dca3ae125be,5dd180c8b3196786,2022-02-19,0,0,0,900,1,0,252,43,252,0,0,0,0,0,52,44,200,43,0.0,856.0
1186,2d8db91f91f68069,4bd6b4800070b069,ef1182eb28c17d4e,2022-02-19,1,0,0,421,3,1,30,12,22,8,0,0,8,4,3,2,19,8,162.2,143.3
1187,2d8db91f91f68069,ef1182eb28c17d4e,4bd6b4800070b069,2022-02-19,0,0,0,421,2,0,17,4,15,2,0,0,2,1,6,4,9,3,54.7,176.8
1188,25da52bc590ef664,436f970c9ea9169c,ffe9703408fb5964,2022-02-19,0,0,0,264,0,0,96,19,96,0,0,0,0,0,28,27,68,19,0.0,264.0
1189,25da52bc590ef664,ffe9703408fb5964,436f970c9ea9169c,2022-02-19,1,0,0,264,2,0,94,30,94,0,0,0,0,0,8,6,86,30,0.0,254.0
1190,04e2d50c24a88dbd,b9437600497350f3,eae431e70064e046,2022-02-19,0,0,0,900,8,5,153,32,152,1,0,0,1,1,25,19,127,31,13.9,600.4
1191,04e2d50c24a88dbd,eae431e70064e046,b9437600497350f3,2022-02-19,0,0,0,900,4,3,94,40,63,31,0,0,31,19,12,6,51,21,174.6,672.1
1192,ca8f73d038c4d6e7,1338e2c7480bdf9e,e1147d3d2dabe1ce,2022-02-12,1,0,0,1500,0,0,169,36,169,0,0,0,0,0,61,43,108,36,0.0,1500.0
1193,ca8f73d038c4d6e7,e1147d3d2dabe1ce,1338e2c7480bdf9e,2022-02-12,0,0,0,1500,10,4,136,38,136,0,0,0,0,0,31,21,105,38,0.0,1280.0
1194,c16bda7548181613,009c4420727149ea,d4270315cbcf2569,2022-02-12,0,0,0,900,0,0,90,41,87,3,1,1,2,2,10,10,77,39,6.8,370.9
1195,c16bda7548181613,d4270315cbcf2569,009c4420727149ea,2022-02-12,0,0,0,900,16,6,128,70,64,64,5,5,59,42,5,5,59,28,502.1,336.2
1196,bb42336d6417914c,c62fbc117d57b943,d3df1add9d9a7efb,2022-02-12,1,0,0,400,0,0,36,12,36,0,0,0,0,0,14,12,22,12,0.0,224.9
1197,bb42336d6417914c,d3df1add9d9a7efb,c62fbc117d57b943,2022-02-12,0,0,0,400,4,2,43,24,33,10,0,0,10,8,4,3,29,16,49.1,292.0
1198,b1e048825b5bbe1c,04835018f90b118c,4498b382c65a7faa,2022-02-12,0,0,0,900,2,0,393,187,393,0,0,0,0,0,45,42,348,187,0.0,898.0
1199,b1e048825b5bbe1c,4498b382c65a7faa,04835018f90b118c,2022-02-12,0,0,0,900,4,2,358,98,358,0,0,0,0,0,28,22,330,98,0.0,834.0
1200,a0ba726da4a50458,2804ce8dadab5770,60425d07ef4b91a7,2022-02-12,0,0,0,708,0,0,153,32,153,0,0,0,0,0,30,23,123,32,0.0,601.5
1201,a0ba726da4a50458,60425d07ef4b91a7,2804ce8dadab5770,2022-02-12,0,2,1,708,8,3,164,52,155,9,0,0,9,9,29,28,126,43,76.5,555.0
1202,821bef3a3394dd96,2f6a993c7f547c13,3a314d9fa7c6825d,2022-02-12,1,0,0,504,5,1,65,24,55,10,0,0,10,6,9,8,46,18,136.4,347.1
1203,821bef3a3394dd96,3a314d9fa7c6825d,2f6a993c7f547c13,2022-02-12,3,2,1,504,1,0,64,16,63,1,0,0,1,0,24,21,39,16,6.9,312.6
1204,81c22cfa22002ea4,2b68d9f125d07b42,3738e68d2261e60f,2022-02-12,0,0,0,900,0,0,156,30,156,0,0,0,0,0,46,40,110,30,0.0,736.0
1205,81c22cfa22002ea4,3738e68d2261e60f,2b68d9f125d07b42,2022-02-12,0,0,0,900,0,0,133,40,133,0,0,0,0,0,33,24,100,40,0.0,900.0
1206,6708f3a32861038a,5da33b8fbfa5ee95,950d0ef5c17157c5,2022-02-12,0,0,0,900,9,3,68,9,68,0,0,0,0,0,29,12,39,9,0.0,669.5
1207,6708f3a32861038a,950d0ef5c17157c5,5da33b8fbfa5ee95,2022-02-12,0,0,0,900,0,0,89,16,85,4,0,0,4,4,57,53,28,12,73.5,753.0
1208,507080ccded73591,9edf2c9082cc2cd8,d66a46de8d705353,2022-02-12,0,0,0,278,0,0,3,0,3,0,0,0,0,0,1,1,2,0,0.0,25.599999999999994
1209,507080ccded73591,d66a46de8d705353,9edf2c9082cc2cd8,2022-02-12,0,1,1,278,5,1,19,14,3,16,0,0,16,14,2,1,1,0,249.4,13.0
1210,3bebd99d5f94bec7,78a68f1dade6aaf7,9014c02eff8b3d62,2022-02-12,0,0,0,900,0,0,41,7,41,0,0,0,0,0,11,6,30,7,0.0,803.0
1211,3bebd99d5f94bec7,9014c02eff8b3d62,78a68f1dade6aaf7,2022-02-12,0,0,0,900,2,2,112,25,111,1,0,0,1,0,46,41,65,25,75.0,825.0
1212,388adad23aaa9d39,887961364be5ceb3,b7b84ccd221be298,2022-02-12,0,0,0,900,1,0,355,152,355,0,0,0,0,0,42,36,313,152,0.0,900.0
1213,388adad23aaa9d39,b7b84ccd221be298,887961364be5ceb3,2022-02-12,0,0,0,900,0,0,193,48,193,0,0,0,0,0,43,28,150,48,0.0,900.0
1214,238832b58a66ae07,262a7d06203657e6,b6452706b373eea1,2022-02-12,0,0,0,383,1,0,79,19,78,1,0,0,1,1,24,18,54,18,1.7,316.2
1215,238832b58a66ae07,b6452706b373eea1,262a7d06203657e6,2022-02-12,0,1,1,383,6,2,60,25,54,6,0,0,6,3,9,8,45,22,61.8,278.3
1216,19e742ccaa09cf08,c0386644627a7ee5,e7e01e266a9d4342,2022-02-12,2,1,0,900,0,0,78,24,67,11,0,0,11,7,19,15,48,17,6.8,403.0
1217,19e742ccaa09cf08,e7e01e266a9d4342,c0386644627a7ee5,2022-02-12,3,0,0,900,7,6,82,30,49,33,0,0,33,18,23,16,26,12,489.0,404.2
1218,18a1617ee7356352,13a0275fa13c4d26,b1a3e0aca758b322,2022-02-12,1,0,0,569,1,1,89,42,84,5,0,0,5,5,14,13,70,37,1.4,485.0
1219,18a1617ee7356352,b1a3e0aca758b322,13a0275fa13c4d26,2022-02-12,1,1,0,569,13,3,97,25,93,4,0,0,4,1,28,18,65,24,79.0,409.6
1220,f9ab966e63968c15,8e9eb3fc86db0f7d,c68c68efaa5ca6ef,2022-02-05,0,0,0,16,0,0,2,1,2,0,0,0,0,0,1,1,1,1,0.0,12.0
1221,f9ab966e63968c15,c68c68efaa5ca6ef,8e9eb3fc86db0f7d,2022-02-05,1,0,0,16,0,0,11,9,4,7,0,0,7,7,2,2,2,2,4.0,12.0
1222,e82f15afac3dac93,41e83a89929d1327,687c15b2eddfaa63,2022-02-05,1,0,0,177,2,2,51,30,1,50,0,0,50,30,0,0,1,0,168.0,9.0
1223,e82f15afac3dac93,687c15b2eddfaa63,41e83a89929d1327,2022-02-05,0,0,0,177,0,0,0,0,0,0,0,0,0,0,0,0,0,0,0.0,9.0
1224,c816a969cb001168,46e0d677f91bacc0,5fa2974cbd18e05c,2022-02-05,0,0,0,698,1,0,85,27,85,0,0,0,0,0,9,7,76,27,0.0,657.2
1225,c816a969cb001168,5fa2974cbd18e05c,46e0d677f91bacc0,2022-02-05,1,1,1,698,1,0,147,40,140,7,0,0,7,4,34,18,106,36,40.8,593.0
1226,ace166f26c2ac2e8,12585614e0ed2626,64facb6cc564262d,2022-02-05,0,1,0,900,16,11,45,19,41,4,0,0,4,4,12,10,29,15,150.0,285.8
1227,ace166f26c2ac2e8,64facb6cc564262d,12585614e0ed2626,2022-02-05,0,0,0,900,0,0,63,28,40,23,12,12,11,11,5,5,35,17,89.2,653.0
1228,84ebbad426d25713,2c9d00968f818270,5bf31a46becc1204,2022-02-05,0,0,0,900,0,0,214,60,214,0,0,0,0,0,93,81,121,60,0.0,674.0
1229,84ebbad426d25713,5bf31a46becc1204,2c9d00968f818270,2022-02-05,0,0,0,900,1,1,133,36,133,0,0,0,0,0,39,34,94,36,0.0,867.0
1230,6b4c2cc27855506a,01afe0916a40c7c5,a53d30163304aa6e,2022-02-05,1,0,0,250,3,1,28,10,20,8,0,0,8,4,3,3,17,6,52.0,198.0
1231,6b4c2cc27855506a,a53d30163304aa6e,01afe0916a40c7c5,2022-02-05,0,0,0,250,0,0,27,3,27,0,0,0,0,0,14,7,13,3,0.0,154.0
1232,673ed36fa5c12d5f,4c2d90e335e6df19,a78a87d8c2bbb1cb,2022-02-05,0,0,0,900,1,1,120,55,65,55,2,2,53,41,32,28,33,14,539.2,351.0
1233,673ed36fa5c12d5f,a78a87d8c2bbb1cb,4c2d90e335e6df19,2022-02-05,0,3,0,900,0,0,113,40,109,4,0,0,4,4,19,16,90,36,0.0,360.79999999999995
1234,4b67a1875390e7ad,0a1942069c9ad6b6,0d8011111be000b2,2022-02-05,0,0,0,1500,8,0,353,22,353,0,0,0,0,0,159,115,194,22,0.0,1469.0
1235,4b67a1875390e7ad,0d8011111be000b2,0a1942069c9ad6b6,2022-02-05,0,0,0,1500,0,0,330,125,330,0,0,0,0,0,44,28,286,125,0.0,1500.0
1236,342779192b116314,5f3805dda9661cba,8e382b585a92affe,2022-02-05,0,0,0,435,7,4,22,5,21,1,0,0,1,1,7,3,14,4,155.5,123.3
1237,342779192b116314,8e382b585a92affe,5f3805dda9661cba,2022-02-05,1,0,0,435,0,0,17,8,15,2,0,0,2,2,1,0,14,6,0.7,278.5
1238,208c5dc52ccfd47a,902ec2cc48c8ae8a,b93c06d09d1c4ac0,2022-02-05,0,0,0,900,5,3,291,120,286,5,1,1,4,4,48,34,238,116,26.7,785.8
1239,208c5dc52ccfd47a,b93c06d09d1c4ac0,902ec2cc48c8ae8a,2022-02-05,0,2,0,900,2,0,247,113,246,1,0,0,1,0,43,35,203,113,2.2,829.3
1240,1765fc442ea03873,2526be54e6a0e62a,dee294e9717012c2,2022-02-05,0,0,0,82,1,1,5,2,5,0,0,0,0,0,2,2,3,2,0.0,45.0
1241,1765fc442ea03873,dee294e9717012c2,2526be54e6a0e62a,2022-02-05,1,1,0,82,1,1,11,3,11,0,0,0,0,0,0,0,11,3,0.0,67.0
1242,0730c4e6fb247fa1,2f181c0467965b98,d156513a19acf856,2022-02-05,1,1,1,430,1,0,54,15,50,4,0,0,4,2,22,21,28,13,25.1,386.0
1243,0730c4e6fb247fa1,d156513a19acf856,2f181c0467965b98,2022-02-05,0,0,0,430,0,0,57,20,57,0,0,0,0,0,5,4,52,20,0.0,397.9
1244,0489b42ac0ab6d4b,147e70aa6cc48cfc,f626118b6da0e020,2022-02-05,0,1,0,900,3,2,95,31,91,4,0,0,4,4,28,26,63,27,19.0,824.0
1245,0489b42ac0ab6d4b,f626118b6da0e020,147e70aa6cc48cfc,2022-02-05,0,0,0,900,8,1,193,49,193,0,0,0,0,0,76,63,117,49,0.0,681.0
1246,e786542667fdecf0,787bb1f087ccff8a,8d03ce87ca14e778,2022-01-22,0,3,0,1500,3,1,91,15,91,0,0,0,0,0,59,48,32,15,0.0,1119.4
1247,e786542667fdecf0,8d03ce87ca14e778,787bb1f087ccff8a,2022-01-22,0,0,0,1500,5,4,104,9,97,7,1,1,6,2,47,33,50,7,209.6,991.0
1248,cddd3d4febe097f8,792be9a24df82ed6,aa72b0f831d0bfe5,2022-01-22,0,0,0,1500,2,1,259,71,259,0,0,0,0,0,45,34,214,71,0.0,1423.3
1249,cddd3d4febe097f8,aa72b0f831d0bfe5,792be9a24df82ed6,2022-01-22,3,0,0,1500,11,2,169,40,167,2,1,1,1,0,62,45,105,40,30.7,1362.0
1250,9687021e5c4d092a,601964f9654f911a,72ea1984c52019b5,2022-01-22,0,0,0,900,15,11,99,36,57,42,0,0,42,18,12,10,45,18,589.7,212.0
1251,9687021e5c4d092a,72ea1984c52019b5,601964f9654f911a,2022-01-22,0,4,0,900,0,0,71,21,71,0,0,0,0,0,18,14,53,21,0.0,295.29999999999995
1252,80f65ee9b6f8d63b,0fd5f4b838e890cc,bf7ad5628363eec9,2022-01-22,0,1,1,47,1,0,13,4,13,0,0,0,0,0,4,3,9,4,0.0,45.0
1253,80f65ee9b6f8d63b,bf7ad5628363eec9,0fd5f4b838e890cc,2022-01-22,0,0,0,47,2,0,4,1,4,0,0,0,0,0,0,0,4,1,0.0,37.0
1254,5da7168ac2ff0e1d,cda1099995b46cc2,dccb63727f2f5f74,2022-01-22,0,0,0,195,1,0,38,9,38,0,0,0,0,0,2,1,36,9,0.0,133.6
1255,5da7168ac2ff0e1d,dccb63727f2f5f74,cda1099995b46cc2,2022-01-22,4,0,0,195,0,0,101,56,42,59,3,1,56,42,5,3,37,14,53.4,128.0
1256,5ba543efdce072f5,33efaf2d0941cfcf,595db60957de51d3,2022-01-22,0,0,0,900,0,0,135,40,129,6,0,0,6,2,7,5,122,38,20.8,855.0
1257,5ba543efdce072f5,595db60957de51d3,33efaf2d0941cfcf,2022-01-22,0,0,0,900,4,1,202,49,202,0,0,0,0,0,80,58,122,49,0.0,835.2
1258,453283e947919ff7,b27a1fcb56a3035a,c32aeb1a59e6272d,2022-01-22,0,1,0,246,4,1,15,3,15,0,0,0,0,0,5,5,10,3,0.0,109.0
1259,453283e947919ff7,c32aeb1a59e6272d,b27a1fcb56a3035a,2022-01-22,1,0,0,246,1,0,42,23,24,18,0,0,18,14,3,3,21,9,65.0,181.0
1260,44a55ba1de2b30e2,b9f28e7045fdfce7,eb8d8c2a95cfccb8,2022-01-22,0,0,0,900,7,1,277,107,275,2,1,1,1,0,32,26,243,107,3.0,885.0
1261,44a55ba1de2b30e2,eb8d8c2a95cfccb8,b9f28e7045fdfce7,2022-01-22,0,0,0,900,1,0,352,102,352,0,0,0,0,0,100,79,252,102,0.0,800.0
1262,4047c2e259529179,2c483cf443f38ece,b4880ef2f838d4e1,2022-01-22,0,2,1,145,0,0,12,0,12,0,0,0,0,0,8,4,4,0,0.0,74.0
1263,4047c2e259529179,b4880ef2f838d4e1,2c483cf443f38ece,2022-01-22,1,0,0,145,0,0,18,9,6,12,0,0,12,7,2,1,4,2,71.0,74.0
1264,0a0beb5aa9810de4,4100c7a09497ad41,a9e260472d321361,2022-01-22,0,0,0,900,7,1,101,31,100,1,1,0,0,0,19,13,81,31,16.6,605.6
1265,0a0beb5aa9810de4,a9e260472d321361,4100c7a09497ad41,2022-01-22,0,0,0,900,3,2,110,37,92,18,0,0,18,15,21,13,71,22,211.4,519.4
1266,0669231ebe3dd560,6b453bc35a823c3f,776d4262c4da38bf,2022-01-22,1,0,0,179,0,0,81,38,78,3,0,0,3,3,6,5,72,35,1.0,178.0
1267,0669231ebe3dd560,776d4262c4da38bf,6b453bc35a823c3f,2022-01-22,0,0,0,179,0,0,69,12,69,0,0,0,0,0,22,13,47,12,0.0,178.0
1268,f9a4e625dffc30d4,8e1f36476ef02a6a,e872e9a9a902c045,2022-01-15,0,0,0,900,2,0,171,31,171,0,0,0,0,0,28,21,143,31,0.0,859.0
1269,f9a4e625dffc30d4,e872e9a9a902c045,8e1f36476ef02a6a,2022-01-15,0,0,0,900,4,1,177,44,177,0,0,0,0,0,41,28,136,44,0.0,686.0
1270,e8517ed0b49abc37,830f60497fab345a,8d20d76af3f213ce,2022-01-15,0,0,0,900,4,2,122,22,122,0,0,0,0,0,36,28,86,22,0.0,718.0
1271,e8517ed0b49abc37,8d20d76af3f213ce,830f60497fab345a,2022-01-15,0,0,0,900,2,0,93,30,93,0,0,0,0,0,28,21,65,30,0.0,705.0
1272,b5b5156c713c5d47,19c591115a58982c,3033c1c080672475,2022-01-15,1,0,0,227,0,0,27,9,19,8,2,2,6,4,6,5,13,5,18.7,169.0
1273,b5b5156c713c5d47,3033c1c080672475,19c591115a58982c,2022-01-15,0,0,0,227,3,2,30,8,29,1,0,0,1,1,5,3,24,7,30.0,118.3
1274,9dfcf675cf2c1575,751de04455cfaac0,9560ff14eb3129f7,2022-01-15,1,1,0,1500,7,2,402,127,392,10,0,0,10,7,33,17,359,120,185.0,1278.0
1275,9dfcf675cf2c1575,9560ff14eb3129f7,751de04455cfaac0,2022-01-15,0,0,0,1500,0,0,347,94,347,0,0,0,0,0,50,34,297,94,0.0,1306.0
1276,8d89f3b8798f444d,07a2bdaa0afdd831,6e15f63b6c2e2c15,2022-01-15,0,0,0,900,9,8,58,16,52,6,0,0,6,1,12,12,40,15,461.0,339.6
1277,8d89f3b8798f444d,6e15f63b6c2e2c15,07a2bdaa0afdd831,2022-01-15,0,3,0,900,0,0,132,21,104,28,3,2,25,9,33,17,71,12,99.4,336.0
1278,8693027377658e61,791c8437b341fba5,9abc648e76c4493a,2022-01-15,0,0,0,900,4,2,104,24,103,1,0,0,1,0,21,16,82,24,42.0,514.5
1279,8693027377658e61,9abc648e76c4493a,791c8437b341fba5,2022-01-15,0,0,0,900,2,2,118,44,108,10,1,1,9,9,27,14,81,35,91.5,556.0
1280,7c2a02b5ea169b54,35b3772629e27a49,7be14eaed4c74856,2022-01-15,0,0,0,900,1,0,174,36,174,0,0,0,0,0,33,24,141,36,0.0,568.6
1281,7c2a02b5ea169b54,7be14eaed4c74856,35b3772629e27a49,2022-01-15,1,0,0,900,8,6,77,25,63,14,0,0,14,10,19,13,44,15,284.4,514.0
1282,3bcbb0e039f4f5d8,01b352b6a9074d5c,92fa1401b7927da3,2022-01-15,0,0,0,146,0,0,17,8,17,0,0,0,0,0,2,2,15,8,0.0,79.0
1283,3bcbb0e039f4f5d8,92fa1401b7927da3,01b352b6a9074d5c,2022-01-15,0,1,1,146,1,1,49,18,36,13,0,0,13,8,3,2,33,10,67.0,79.0
1284,3a8c0158d910546d,40093d1d2d78394e,d31cbcdd7d69536d,2022-01-15,0,1,0,900,0,0,107,21,101,6,0,0,6,3,31,25,70,18,121.5,470.2
1285,3a8c0158d910546d,d31cbcdd7d69536d,40093d1d2d78394e,2022-01-15,0,3,0,900,8,6,99,46,92,7,0,0,7,7,14,12,78,39,267.8,319.5
1286,3738135e4c9d8273,3d074044a33825e7,523fa774700d7d3f,2022-01-15,0,1,0,900,3,1,62,21,62,0,0,0,0,0,11,11,51,21,0.0,607.2
1287,3738135e4c9d8273,523fa774700d7d3f,3d074044a33825e7,2022-01-15,1,1,0,900,11,5,91,30,87,4,0,0,4,4,28,24,59,26,262.8,243.0
1288,fc0927c657c51622,e13abac8089a801a,f703250471acaf96,2021-12-18,1,0,0,113,0,0,10,4,8,2,1,1,1,0,0,0,8,4,62.0,51.0
1289,fc0927c657c51622,f703250471acaf96,e13abac8089a801a,2021-12-18,0,1,0,113,1,0,9,2,9,0,0,0,0,0,4,3,5,2,0.0,51.0
1290,ea76a3af8c5ecc55,5b8ba8f5512893b1,ac026518a9b4dc0f,2021-12-18,0,1,0,425,1,1,34,2,34,0,0,0,0,0,20,11,14,2,0.0,267.0
1291,ea76a3af8c5ecc55,ac026518a9b4dc0f,5b8ba8f5512893b1,2021-12-18,0,3,1,425,6,1,20,4,19,1,0,0,1,1,8,5,11,3,84.0,257.0
1292,dd552b389152636a,4234f0097c83fa62,a4a80dd7336ffd59,2021-12-18,0,0,0,645,4,1,45,10,35,10,1,0,9,7,7,4,28,3,304.2,171.4
1293,dd552b389152636a,a4a80dd7336ffd59,4234f0097c83fa62,2021-12-18,1,0,0,645,1,0,34,11,31,3,0,0,3,2,7,6,24,9,108.6,159.8
1294,bdaca0a96d44438a,6ac9bc2953c47345,71505842fb6455c3,2021-12-18,0,3,1,778,1,1,22,8,22,0,0,0,0,0,3,3,19,8,0.0,192.89999999999998
1295,bdaca0a96d44438a,71505842fb6455c3,6ac9bc2953c47345,2021-12-18,0,1,0,778,4,4,32,8,25,7,0,0,7,5,4,4,21,3,391.1,331.0
1296,b4f88d65b47c2a39,5f6f049d54728e88,f1d64ae34e088832,2021-12-18,0,0,0,900,1,1,171,26,171,0,0,0,0,0,39,30,132,26,0.0,804.0
1297,b4f88d65b47c2a39,f1d64ae34e088832,5f6f049d54728e88,2021-12-18,0,0,0,900,2,0,228,70,206,22,3,3,19,13,76,64,130,57,61.0,753.0
1298,a760d0f5de2e1aaa,1a9480fc288e55d7,b5da8f7d05e85a55,2021-12-18,1,0,0,806,8,6,41,15,28,13,0,0,13,9,10,10,18,6,562.2,114.0
1299,a760d0f5de2e1aaa,b5da8f7d05e85a55,1a9480fc288e55d7,2021-12-18,0,0,0,806,2,0,16,7,16,0,0,0,0,0,5,3,11,7,0.0,222.79999999999995
1300,a43dcd04788d95c7,2f13e4020cea5b38,5987b2458f4b5290,2021-12-18,0,0,0,434,0,0,25,1,25,0,0,0,0,0,8,6,17,1,0.0,192.0
1301,a43dcd04788d95c7,5987b2458f4b5290,2f13e4020cea5b38,2021-12-18,1,0,0,434,4,2,30,13,19,11,1,1,10,7,4,4,15,6,242.0,192.0
1302,8b3b38167060b1d7,4a28cb716c19157a,b1b0729d27936f2f,2021-12-18,0,0,0,900,1,0,32,14,30,2,0,0,2,1,5,5,25,13,34.7,139.39999999999998
1303,8b3b38167060b1d7,b1b0729d27936f2f,4a28cb716c19157a,2021-12-18,0,1,0,900,9,7,95,56,11,84,0,0,84,55,3,2,8,1,708.6,148.3
1304,85d9a516c3c6c205,9cdd2da1a9104a0b,fc169c387b4b465d,2021-12-18,0,0,0,487,2,1,86,16,85,1,0,0,1,1,21,10,64,15,11.1,409.0
1305,85d9a516c3c6c205,fc169c387b4b465d,9cdd2da1a9104a0b,2021-12-18,0,1,1,487,0,0,79,22,79,0,0,0,0,0,31,23,48,22,0.0,406.9
1306,730f14ccff80f3b0,72db2a14ffa73ece,f53d4f21d1b5f2dc,2021-12-18,1,0,0,506,7,4,58,15,54,4,2,2,2,1,10,8,44,14,65.0,441.0
1307,730f14ccff80f3b0,f53d4f21d1b5f2dc,72db2a14ffa73ece,2021-12-18,0,0,0,506,0,0,101,18,101,0,0,0,0,0,32,18,69,18,0.0,441.0
1308,4b7ec02b39fc6f70,d0aaedcf7ccd0b45,d3df1add9d9a7efb,2021-12-18,0,0,0,216,0,0,19,6,19,0,0,0,0,0,5,4,14,6,0.0,216.0
1309,4b7ec02b39fc6f70,d3df1add9d9a7efb,d0aaedcf7ccd0b45,2021-12-18,1,0,0,216,1,0,28,12,28,0,0,0,0,0,2,2,26,12,0.0,216.0
1310,2e200563dd7c4922,3df5493bb279226f,f0feeb2192937424,2021-12-18,1,0,0,900,3,0,114,32,98,16,0,0,16,8,24,18,74,24,83.8,769.0
1311,2e200563dd7c4922,f0feeb2192937424,3df5493bb279226f,2021-12-18,0,0,0,900,7,1,106,25,106,0,0,0,0,0,32,23,74,25,0.0,552.2
1312,2a5484a6d5e7a2da,92a9aa9c93192871,d247691a6c0e9034,2021-12-18,0,0,0,132,2,0,19,2,19,0,0,0,0,0,1,0,18,2,0.0,123.0
1313,2a5484a6d5e7a2da,d247691a6c0e9034,92a9aa9c93192871,2021-12-18,1,0,0,132,0,0,30,16,26,4,0,0,4,2,2,2,24,14,9.0,123.0
1314,fc2a30bfb760bdf8,669970f7feba8ecd,f29a6350c69f4a33,2021-12-11,0,1,0,900,8,7,69,35,42,27,3,3,24,20,8,8,34,15,607.5,180.0
1315,fc2a30bfb760bdf8,f29a6350c69f4a33,669970f7feba8ecd,2021-12-11,0,0,0,900,1,0,65,10,65,0,0,0,0,0,13,11,52,10,0.0,286.5
1316,b22eab3aa1522f40,029eaff01e6bb8f0,07225ba28ae309b6,2021-12-11,1,0,0,662,0,0,94,56,87,7,0,0,7,4,2,2,85,52,17.5,430.0
1317,b22eab3aa1522f40,07225ba28ae309b6,029eaff01e6bb8f0,2021-12-11,0,3,1,662,6,0,131,48,105,26,2,2,24,16,30,23,75,32,197.0,303.5
1318,abb8c6c0a057184e,10f3ba6cd2f44a97,6bd02119599741a4,2021-12-11,0,0,0,900,9,1,274,79,273,1,0,0,1,1,34,24,239,78,1.5,894.0
1319,abb8c6c0a057184e,6bd02119599741a4,10f3ba6cd2f44a97,2021-12-11,1,0,0,900,1,0,170,45,170,0,0,0,0,0,42,29,128,45,0.0,888.5
1320,9039762cb9f4abdb,12ebd7d157e91701,c878270af633eb11,2021-12-11,1,0,0,88,0,0,29,18,18,11,0,0,11,8,1,1,17,10,6.9,78.0
1321,9039762cb9f4abdb,c878270af633eb11,12ebd7d157e91701,2021-12-11,0,0,0,88,0,0,26,9,26,0,0,0,0,0,11,11,15,9,0.0,58.1
1322,8c01b7dccc4d0926,82b4e942781b1046,b50a426a33da0012,2021-12-11,0,0,0,282,2,0,47,2,47,0,0,0,0,0,15,9,32,2,0.0,280.0
1323,8c01b7dccc4d0926,b50a426a33da0012,82b4e942781b1046,2021-12-11,1,0,0,282,0,0,62,28,59,3,0,0,3,2,12,11,47,26,2.0,280.0
1324,8bcdcfb0f93f1409,1a08b01fdabb6ae2,325ad0dd9126d3df,2021-12-11,1,0,0,555,0,0,169,26,135,34,7,7,27,16,69,49,66,10,92.2,349.0
1325,8bcdcfb0f93f1409,325ad0dd9126d3df,1a08b01fdabb6ae2,2021-12-11,0,0,0,555,1,0,65,20,65,0,0,0,0,0,11,11,54,20,0.0,313.8
1326,795aa42785a46643,853eb0dd5c0e2149,d8c7c61b176e3994,2021-12-11,2,0,0,201,0,0,41,18,37,4,0,0,4,4,9,5,28,14,6.0,195.0
1327,795aa42785a46643,d8c7c61b176e3994,853eb0dd5c0e2149,2021-12-11,0,0,0,201,1,0,17,4,17,0,0,0,0,0,7,5,10,4,0.0,189.0
1328,6537a32e7af905b0,82a5152216251682,fba03cd6cc28dc41,2021-12-11,0,0,0,900,4,1,168,54,167,1,0,0,1,1,21,16,146,53,5.2,855.5
1329,6537a32e7af905b0,fba03cd6cc28dc41,82a5152216251682,2021-12-11,1,0,0,900,0,0,165,51,158,7,2,2,5,5,12,7,146,46,23.5,847.8
1330,537a5aa4c248830e,34e516ab361afb1c,8866c6f509c19089,2021-12-11,0,0,0,900,1,1,45,16,34,11,0,0,11,6,12,10,22,10,234.1,274.1
1331,537a5aa4c248830e,8866c6f509c19089,34e516ab361afb1c,2021-12-11,0,7,0,900,2,0,49,22,13,36,11,11,25,21,7,7,6,1,327.9,328.9
1332,50f2539c73b98eec,441eacbe20e0e80b,c62fbc117d57b943,2021-12-11,0,0,0,326,1,0,29,6,29,0,0,0,0,0,17,15,12,6,0.0,293.0
1333,50f2539c73b98eec,c62fbc117d57b943,441eacbe20e0e80b,2021-12-11,1,0,0,326,1,0,52,26,52,0,0,0,0,0,9,8,43,26,0.0,208.0
1334,505397f405e40206,38c7f72747f4f712,b1e5bcaad32a3cac,2021-12-11,0,1,1,299,4,1,43,26,19,24,0,0,24,21,8,6,11,5,156.0,127.0
1335,505397f405e40206,b1e5bcaad32a3cac,38c7f72747f4f712,2021-12-11,0,0,0,299,0,0,36,17,35,1,0,0,1,1,5,3,30,16,3.0,137.0
1336,2d0d13dfc6c37ba8,6d1bffff14897645,b997be68943010fc,2021-12-11,0,0,0,900,4,1,229,62,229,0,0,0,0,0,34,29,195,62,0.0,877.0
1337,2d0d13dfc6c37ba8,b997be68943010fc,6d1bffff14897645,2021-12-11,0,0,0,900,0,0,161,73,161,0,0,0,0,0,16,12,145,73,0.0,897.0
1338,16243b1470887cb6,886264a0c9f4ea5e,cad24459b28592ca,2021-12-11,0,2,1,193,5,2,16,6,14,2,0,0,2,1,2,2,12,5,69.0,55.0
1339,16243b1470887cb6,cad24459b28592ca,886264a0c9f4ea5e,2021-12-11,0,0,0,193,1,0,13,0,13,0,0,0,0,0,5,3,8,0,0.0,124.0
1340,0b633295d9e017a3,3253b16d38ae087d,80fa8218c99f9c58,2021-12-11,0,1,1,506,1,1,135,69,135,0,0,0,0,0,13,10,122,69,0.0,266.0
1341,0b633295d9e017a3,80fa8218c99f9c58,3253b16d38ae087d,2021-12-11,0,0,0,506,1,1,99,36,97,2,0,0,2,2,14,10,83,34,215.0,291.0
1342,c74b03337a8441ed,d747eb273a40a920,feaf00f3373435d6,2021-12-04,0,1,1,805,8,1,68,31,43,25,1,1,24,18,19,11,24,13,263.9,363.5
1343,c74b03337a8441ed,feaf00f3373435d6,d747eb273a40a920,2021-12-04,0,0,0,805,1,1,55,15,47,8,3,3,5,3,24,20,23,12,61.5,372.1
1344,b3847772199e2639,5444c5a201d3ee5a,70e1f8a821b72c8b,2021-12-04,1,0,0,48,0,0,10,2,9,1,0,0,1,1,2,2,7,1,0.3,47.0
1345,b3847772199e2639,70e1f8a821b72c8b,5444c5a201d3ee5a,2021-12-04,0,0,0,48,1,0,12,2,12,0,0,0,0,0,5,4,7,2,0.0,47.7
1346,a38648a1c190f9be,37ed1ab2f8b819f4,c814b4c899793af6,2021-12-04,0,0,0,740,4,1,115,23,115,0,0,0,0,0,43,36,72,23,0.0,726.0
1347,a38648a1c190f9be,c814b4c899793af6,37ed1ab2f8b819f4,2021-12-04,1,0,0,740,0,0,123,36,123,0,0,0,0,0,45,30,78,36,0.0,731.0
1348,9e5bbbacf1d92cb4,2f181c0467965b98,5442f1bc4b47eaf3,2021-12-04,0,1,0,418,3,0,71,26,71,0,0,0,0,0,18,17,53,26,0.0,387.7
1349,9e5bbbacf1d92cb4,5442f1bc4b47eaf3,2f181c0467965b98,2021-12-04,1,0,0,418,0,0,90,38,86,4,0,0,4,2,25,23,61,36,12.3,375.0
1350,723a8a8c82cab1c8,866fd7b1a6c90e7f,c549573c0df4d676,2021-12-04,1,0,0,274,1,1,53,28,23,30,0,0,30,21,2,2,21,7,160.6,108.0
1351,723a8a8c82cab1c8,c549573c0df4d676,866fd7b1a6c90e7f,2021-12-04,0,1,0,274,0,0,29,5,29,0,0,0,0,0,9,8,20,5,0.0,113.4
1352,657b7da9c89352fe,9e50097a89442158,cdb96af67d096b1e,2021-12-04,0,0,0,900,1,0,144,35,143,1,0,0,1,0,38,30,105,35,4.0,814.9
1353,657b7da9c89352fe,cdb96af67d096b1e,9e50097a89442158,2021-12-04,1,0,0,900,0,0,230,70,217,13,0,0,13,7,30,20,187,63,77.1,813.0
1354,5d64044b985004e7,9c65736747ca92ec,c47df9303d318c67,2021-12-04,1,0,0,381,0,0,60,22,44,16,6,6,10,6,15,13,29,16,25.0,201.8
1355,5d64044b985004e7,c47df9303d318c67,9c65736747ca92ec,2021-12-04,0,1,1,381,7,2,50,8,39,11,8,8,3,3,3,2,36,5,118.2,227.0
1356,42b28adbed6966b7,5da33b8fbfa5ee95,a495f599e787614f,2021-12-04,1,0,0,900,4,1,111,32,103,8,0,0,8,7,29,23,74,25,19.1,857.0
1357,42b28adbed6966b7,a495f599e787614f,5da33b8fbfa5ee95,2021-12-04,0,0,0,900,2,0,77,34,77,0,0,0,0,0,10,10,67,34,0.0,495.9
1358,405bded9cc7a7c15,326a001926ffb7ec,a331233f597090a5,2021-12-04,0,0,0,900,8,4,209,62,205,4,0,0,4,3,73,56,132,59,36.0,702.0
1359,405bded9cc7a7c15,a331233f597090a5,326a001926ffb7ec,2021-12-04,0,0,0,900,0,0,217,55,217,0,0,0,0,0,65,53,152,55,0.0,843.0
1360,3fc8afbb23b9ac16,19b7738321cfae42,4959f10a62f3fec3,2021-12-04,0,0,0,900,5,0,210,65,210,0,0,0,0,0,21,15,189,65,0.0,734.0
1361,3fc8afbb23b9ac16,4959f10a62f3fec3,19b7738321cfae42,2021-12-04,0,0,0,900,0,0,271,102,271,0,0,0,0,0,48,32,223,102,0.0,900.0
1362,376dddfa82debbf4,55fa6ce3e522c8bb,5d1b7e3dd9e11074,2021-12-04,0,0,0,242,0,0,79,19,79,0,0,0,0,0,18,12,61,19,0.0,242.0
1363,376dddfa82debbf4,5d1b7e3dd9e11074,55fa6ce3e522c8bb,2021-12-04,2,0,0,242,0,0,72,39,72,0,0,0,0,0,16,14,56,39,0.0,239.0
1364,3109d1151f149aaf,05339613bf8e9808,d0f3959b4a9747e6,2021-12-04,0,0,0,1500,5,1,305,94,297,8,0,0,8,8,67,55,230,86,64.0,935.2
1365,3109d1151f149aaf,d0f3959b4a9747e6,05339613bf8e9808,2021-12-04,2,1,0,1500,1,0,161,57,149,12,1,1,11,8,31,28,118,49,436.8,890.0
1366,1ce1a43ef68ffc7d,37098a6e6c27fb66,d2bc285ead803db0,2021-12-04,1,0,0,122,0,0,49,16,44,5,0,0,5,5,15,11,29,11,0.0,122.0
1367,1ce1a43ef68ffc7d,d2bc285ead803db0,37098a6e6c27fb66,2021-12-04,0,0,0,122,0,0,32,5,32,0,0,0,0,0,18,18,14,5,0.0,122.0
1368,fd60e75303622e5e,a29db9cd4f9ccea5,e132d47bd9efbbe0,2021-11-20,0,0,0,900,7,3,127,21,127,0,0,0,0,0,33,26,94,21,0.0,641.4
1369,fd60e75303622e5e,e132d47bd9efbbe0,a29db9cd4f9ccea5,2021-11-20,0,0,0,900,12,7,91,21,86,5,0,0,5,1,17,14,69,20,210.6,563.0
1370,f592f168f3b8b807,7832f2f62f04178f,b8bbdeff718dbb7d,2021-11-20,0,0,0,900,1,1,35,5,35,0,0,0,0,0,14,12,21,5,0.0,496.5
1371,f592f168f3b8b807,b8bbdeff718dbb7d,7832f2f62f04178f,2021-11-20,0,3,0,900,11,5,24,9,22,2,0,0,2,2,7,7,15,7,327.5,245.0
1372,bb15c0a2911043bd,12f91bfa8f1f723b,f7467152fd9f18a2,2021-11-20,0,0,0,289,0,0,68,8,68,0,0,0,0,0,32,19,36,8,0.0,212.0
1373,bb15c0a2911043bd,f7467152fd9f18a2,12f91bfa8f1f723b,2021-11-20,2,2,1,289,0,0,60,21,42,18,1,1,17,10,13,8,29,11,77.0,212.0
1374,9b9ef12603e820ec,0232cabbc30a2372,113df4fde64735c6,2021-11-20,0,0,0,900,0,0,255,66,255,0,0,0,0,0,43,34,212,66,0.0,900.0
1375,9b9ef12603e820ec,113df4fde64735c6,0232cabbc30a2372,2021-11-20,0,0,0,900,1,0,273,40,273,0,0,0,0,0,91,58,182,40,0.0,890.0
1376,8dd086e2e70144fd,a3a542074109b347,e94085e821bd81de,2021-11-20,1,1,0,900,3,2,159,40,152,7,0,0,7,5,33,20,119,35,80.8,773.0
1377,8dd086e2e70144fd,e94085e821bd81de,a3a542074109b347,2021-11-20,0,0,0,900,0,0,130,23,130,0,0,0,0,0,58,30,72,23,0.0,800.2
1378,84c68c4c387d2e32,7d420039bbfe7c1a,7f6ed67d3ed3c036,2021-11-20,0,0,0,900,3,1,142,44,138,4,0,0,4,3,26,21,112,41,34.2,721.3
1379,84c68c4c387d2e32,7f6ed67d3ed3c036,7d420039bbfe7c1a,2021-11-20,0,0,0,900,10,5,133,39,130,3,0,0,3,3,23,21,107,36,101.7,526.8
1380,50bf4bb2f8d9aba4,45f7cb591c3ab00b,c58f51dedb310998,2021-11-20,0,0,0,900,8,5,42,8,42,0,0,0,0,0,11,10,31,8,0.0,403.2
1381,50bf4bb2f8d9aba4,c58f51dedb310998,45f7cb591c3ab00b,2021-11-20,0,0,0,900,1,1,57,19,48,9,2,2,7,4,11,8,37,15,31.8,847.0
1382,450534f9fb9b13cd,4e30e4250cb08b61,8e5d953bdb9ae5e7,2021-11-20,0,0,0,900,2,1,39,8,37,2,0,0,2,2,16,7,21,6,69.2,455.8
1383,450534f9fb9b13cd,8e5d953bdb9ae5e7,4e30e4250cb08b61,2021-11-20,0,1,0,900,12,5,45,14,39,6,0,0,6,3,9,9,30,11,271.2,378.8
1384,1ff89e2a9cc2f2d2,0a73acff6325c1e2,bd5403efbaa445c0,2021-11-20,0,0,0,900,8,4,49,11,47,2,0,0,2,2,11,6,36,9,445.0,350.0
1385,1ff89e2a9cc2f2d2,bd5403efbaa445c0,0a73acff6325c1e2,2021-11-20,0,0,0,900,2,2,56,16,49,7,1,1,6,4,21,18,28,12,105.0,350.0
1386,1cd8f5a107f64e39,94527830000ab715,a7897d200692ab64,2021-11-20,0,1,0,900,8,3,48,7,47,1,0,0,1,1,23,20,24,6,636.0,199.0
1387,1cd8f5a107f64e39,a7897d200692ab64,94527830000ab715,2021-11-20,1,0,0,900,0,0,82,36,78,4,2,1,2,2,7,6,71,34,65.0,199.0
1388,18f19b1422e8154b,b96619b3acd7d9da,b9706f80d005036c,2021-11-20,0,0,0,1500,6,1,276,52,276,0,0,0,0,0,101,70,175,52,0.0,1328.0
1389,18f19b1422e8154b,b9706f80d005036c,b96619b3acd7d9da,2021-11-20,0,0,0,1500,1,0,263,95,263,0,0,0,0,0,20,18,243,95,0.0,1498.0
1390,e6ce8360ef43891c,39d91e95949de3d9,8cb78f3a6c2a08f7,2021-11-13,1,0,0,865,13,4,78,44,62,16,0,0,16,12,13,12,49,32,188.3,147.0
1391,e6ce8360ef43891c,8cb78f3a6c2a08f7,39d91e95949de3d9,2021-11-13,0,0,0,865,1,1,36,10,36,0,0,0,0,0,9,7,27,10,0.0,615.7
1392,c0518d213b67e754,05fa626cb33d15b8,98215d037be5bcb7,2021-11-13,1,0,0,600,1,0,210,46,210,0,0,0,0,0,55,38,155,46,0.0,600.0
1393,c0518d213b67e754,98215d037be5bcb7,05fa626cb33d15b8,2021-11-13,0,0,0,600,3,1,154,18,154,0,0,0,0,0,55,29,99,18,0.0,561.0
1394,a27a355f52883f3e,047a91d3d9c79b05,4682bc59d5f55145,2021-11-13,0,0,0,270,1,0,40,4,40,0,0,0,0,0,14,4,26,4,0.0,249.7
1395,a27a355f52883f3e,4682bc59d5f55145,047a91d3d9c79b05,2021-11-13,1,0,0,270,0,0,98,23,97,1,0,0,1,0,37,27,60,23,7.3,248.0
1396,8636b67096df4b27,2558ae2e5671e318,82d4c957649faf9b,2021-11-13,1,0,0,662,1,0,131,23,117,14,0,0,14,11,37,26,80,12,37.3,614.0
1397,8636b67096df4b27,82d4c957649faf9b,2558ae2e5671e318,2021-11-13,0,5,0,662,2,0,56,13,56,0,0,0,0,0,21,18,35,13,0.0,624.7
1398,81bb4d9b214adf4b,74f9448b97bf8bec,8667caa0451d245b,2021-11-13,1,0,0,184,0,0,49,15,48,1,0,0,1,1,2,1,46,14,0.0,184.0
1399,81bb4d9b214adf4b,8667caa0451d245b,74f9448b97bf8bec,2021-11-13,0,0,0,184,0,0,18,6,18,0,0,0,0,0,0,0,18,6,0.0,184.0
1400,73c97d5c314f1270,1291edf2d566a71a,efb96bf3e9ada36f,2021-11-13,0,0,0,395,0,0,78,7,78,0,0,0,0,0,9,6,69,7,0.0,395.0
1401,73c97d5c314f1270,efb96bf3e9ada36f,1291edf2d566a71a,2021-11-13,1,0,0,395,0,0,80,15,77,3,0,0,3,3,20,15,57,12,0.0,395.0
1402,66eee2320e900a8a,5f179af5fffeb9f6,eebc23626e38f5dc,2021-11-13,0,0,0,900,0,0,218,61,215,3,0,0,3,1,45,28,170,60,0.0,827.7
1403,66eee2320e900a8a,eebc23626e38f5dc,5f179af5fffeb9f6,2021-11-13,0,0,0,900,3,2,154,29,147,7,0,0,7,3,11,5,136,26,72.3,807.0
1404,2c21abbc28e3876a,029afd138865d20a,32c355b04fc57f3a,2021-11-13,0,1,1,108,0,0,11,3,11,0,0,0,0,0,3,3,8,3,0.0,108.0
1405,2c21abbc28e3876a,32c355b04fc57f3a,029afd138865d20a,2021-11-13,0,0,0,108,1,0,13,0,13,0,0,0,0,0,6,3,7,0,0.0,105.0
1406,147e984aa34e3028,150ff4cc642270b9,cbf5e6f231b55443,2021-11-13,0,1,0,1500,5,3,404,129,371,33,5,5,28,16,121,96,250,113,236.8,1055.4
1407,147e984aa34e3028,cbf5e6f231b55443,150ff4cc642270b9,2021-11-13,0,0,0,1500,5,1,352,78,348,4,2,1,2,1,103,80,245,77,35.6,1183.2
1408,1013cdbb6c9a4a2e,ab943cd2c3c17825,bd58d34e39b7b12a,2021-11-13,1,0,0,32,0,0,24,11,24,0,0,0,0,0,4,3,20,11,0.0,32.0
1409,1013cdbb6c9a4a2e,bd58d34e39b7b12a,ab943cd2c3c17825,2021-11-13,0,0,0,32,1,0,8,2,8,0,0,0,0,0,0,0,8,2,0.0,32.0
1410,0273dbd5dedbdbe0,58bbef3770bb2dfc,d945aae53e3e54e6,2021-11-13,1,0,0,181,0,0,73,27,73,0,0,0,0,0,19,17,54,27,0.0,179.0
1411,0273dbd5dedbdbe0,d945aae53e3e54e6,58bbef3770bb2dfc,2021-11-13,0,0,0,181,0,0,24,5,24,0,0,0,0,0,6,6,18,5,0.0,181.0
1412,fa3b28ff3585b4a0,5442f1bc4b47eaf3,547afe1017e72dbe,2021-11-06,1,0,0,267,0,0,36,15,35,1,0,0,1,1,9,6,26,14,1.0,264.0
1413,fa3b28ff3585b4a0,547afe1017e72dbe,5442f1bc4b47eaf3,2021-11-06,0,0,0,267,3,0,90,24,90,0,0,0,0,0,27,24,63,24,0.0,266.0
1414,e25875165648162b,7a5e8c94a86f9895,fcd448a2fe1a23cc,2021-11-06,1,0,0,443,0,0,70,13,53,17,1,1,16,8,28,24,25,5,11.3,431.0
1415,e25875165648162b,fcd448a2fe1a23cc,7a5e8c94a86f9895,2021-11-06,0,0,0,443,0,0,51,6,51,0,0,0,0,0,27,24,24,6,0.0,423.7
1416,d69e3677060af4c7,59279a7c978f7da0,887961364be5ceb3,2021-11-06,0,0,0,145,0,0,30,5,30,0,0,0,0,0,9,5,21,5,0.0,130.0
1417,d69e3677060af4c7,887961364be5ceb3,59279a7c978f7da0,2021-11-06,1,0,0,145,0,0,40,23,26,14,0,0,14,12,5,5,21,11,15.0,130.0
1418,c634ed84212723ca,7c7332319c14094c,f2688492b9a525a3,2021-11-06,1,1,0,830,0,0,164,60,141,23,0,0,23,12,34,28,107,48,1.0,572.8
1419,c634ed84212723ca,f2688492b9a525a3,7c7332319c14094c,2021-11-06,0,0,0,830,9,3,155,59,126,29,4,4,25,21,38,31,88,38,256.2,564.0
1420,a260238fdb9c47cf,98d961097baaf308,aa171d55d4b5208f,2021-11-06,0,0,0,900,0,0,288,133,287,1,0,0,1,1,69,60,218,132,4.1,754.0
1421,a260238fdb9c47cf,aa171d55d4b5208f,98d961097baaf308,2021-11-06,0,0,0,900,14,0,349,129,349,0,0,0,0,0,48,35,301,129,0.0,766.9
1422,999a0fad4c82148d,4b93a88f3b1de35b,9e8f6c728eb01124,2021-11-06,0,0,0,900,6,1,245,64,245,0,0,0,0,0,46,39,199,64,0.0,825.5
1423,999a0fad4c82148d,9e8f6c728eb01124,4b93a88f3b1de35b,2021-11-06,1,0,0,900,0,0,183,83,169,14,1,1,13,8,39,32,130,75,71.5,803.0
1424,88cc78d2d5d6bcaa,6ebe96a116e79e52,e4277e87a789d687,2021-11-06,0,0,0,900,0,0,189,43,189,0,0,0,0,0,40,34,149,43,0.0,900.0
1425,88cc78d2d5d6bcaa,e4277e87a789d687,6ebe96a116e79e52,2021-11-06,0,0,0,900,0,0,321,110,321,0,0,0,0,0,51,43,270,110,0.0,900.0
1426,8081cb92f71401c6,077e3ace32b72be9,6d68c1afe954f121,2021-11-06,0,0,0,900,0,0,165,35,151,14,1,1,13,8,65,57,86,27,62.6,739.0
1427,8081cb92f71401c6,6d68c1afe954f121,077e3ace32b72be9,2021-11-06,0,0,0,900,7,1,194,61,194,0,0,0,0,0,26,18,168,61,0.0,811.4
1428,73d541adc2909dc8,0e5c4e72237461bb,a52bc1e62cf0b7c6,2021-11-06,0,0,0,900,4,0,103,27,103,0,0,0,0,0,33,19,70,27,0.0,855.0
1429,73d541adc2909dc8,a52bc1e62cf0b7c6,0e5c4e72237461bb,2021-11-06,0,0,0,900,0,0,124,26,124,0,0,0,0,0,61,49,63,26,0.0,890.0
1430,733dcfec0cc9b439,442c9011034ae1fd,e26bd53b751d61d9,2021-11-06,1,0,0,299,0,0,28,11,28,0,0,0,0,0,7,7,21,11,0.0,262.0
1431,733dcfec0cc9b439,e26bd53b751d61d9,442c9011034ae1fd,2021-11-06,0,0,0,299,1,0,50,16,50,0,0,0,0,0,6,6,44,16,0.0,252.0
1432,385101e8ad828c39,79325a3c1a5c3bf4,e5549c82bfb5582d,2021-11-06,0,0,0,318,7,2,11,3,10,1,0,0,1,1,5,0,5,2,39.8,78.1
1433,385101e8ad828c39,e5549c82bfb5582d,79325a3c1a5c3bf4,2021-11-06,1,0,0,318,0,0,18,4,16,2,0,0,2,1,8,7,8,3,0.9,274.2
1434,31b3ae9352d9389b,dc9572dd6ec74859,f1b2aa7853d1ed6e,2021-11-06,0,0,0,1500,11,0,281,79,281,0,0,0,0,0,39,28,242,79,0.0,1338.0
1435,31b3ae9352d9389b,f1b2aa7853d1ed6e,dc9572dd6ec74859,2021-11-06,2,0,0,1500,1,1,293,80,281,12,7,7,5,3,45,36,236,77,48.0,1424.0
1436,19722043e7eb4e39,1ebe20ebbfa15e29,47b63240018d5d86,2021-11-06,0,0,0,1500,11,5,173,36,146,27,4,2,23,12,57,45,89,24,167.4,941.8
1437,19722043e7eb4e39,47b63240018d5d86,1ebe20ebbfa15e29,2021-11-06,0,0,0,1500,2,2,168,57,142,26,3,3,23,17,34,26,108,40,341.2,912.6
1438,095a351dd6f09f7e,4144798612ef96e5,881bf86d4cba8578,2021-11-06,0,0,0,592,5,1,35,10,34,1,0,0,1,1,16,12,18,9,38.5,249.2
1439,095a351dd6f09f7e,881bf86d4cba8578,4144798612ef96e5,2021-11-06,1,4,0,592,1,0,63,34,39,24,0,0,24,21,9,8,30,13,188.8,317.5
1440,efc6af0151f72b87,8adcbd525fab8d9b,c2299ec916bc7c56,2021-10-30,0,0,0,900,4,0,259,96,254,5,1,1,4,4,58,52,196,92,11.5,765.6
1441,efc6af0151f72b87,c2299ec916bc7c56,8adcbd525fab8d9b,2021-10-30,0,0,0,900,14,2,148,40,147,1,0,0,1,0,34,27,113,40,14.4,773.5
1442,d84968d7e9fcb4f3,7dda2cf308f24a02,beecb672a279223e,2021-10-30,1,0,0,900,8,1,155,46,152,3,0,0,3,3,14,4,138,43,79.7,714.0
1443,d84968d7e9fcb4f3,beecb672a279223e,7dda2cf308f24a02,2021-10-30,0,1,0,900,5,1,233,59,233,0,0,0,0,0,39,29,194,59,0.0,777.3
1444,987cdcbc809e210d,767755fd74662dbf,e64b96c07d7ce999,2021-10-30,0,3,1,196,2,1,25,25,1,24,0,0,24,24,0,0,1,1,181.0,15.0
1445,987cdcbc809e210d,e64b96c07d7ce999,767755fd74662dbf,2021-10-30,0,0,0,196,0,0,1,0,1,0,0,0,0,0,0,0,1,0,0.0,15.0
1446,92c49cb075f612d7,0d65c432720accb9,0d980975001ae3d8,2021-10-30,1,0,0,211,0,0,55,27,48,7,0,0,7,3,7,5,41,24,3.0,208.0
1447,92c49cb075f612d7,0d980975001ae3d8,0d65c432720accb9,2021-10-30,0,0,0,211,2,0,67,16,67,0,0,0,0,0,22,19,45,16,0.0,208.0
1448,919fb76d2f3e5827,7ff97850e8c32bda,99df7d0a2a08a8a8,2021-10-30,0,2,1,482,6,2,39,17,25,14,2,2,12,10,4,4,21,7,317.0,157.5
1449,919fb76d2f3e5827,99df7d0a2a08a8a8,7ff97850e8c32bda,2021-10-30,0,0,0,482,0,0,45,20,44,1,0,0,1,1,8,8,36,19,7.5,150.0
1450,768c86e307295944,6b7c7460855dbbb9,9d83f6da776ff7d6,2021-10-30,0,1,0,900,9,1,140,54,92,48,1,1,47,29,21,16,71,25,333.0,550.3
1451,768c86e307295944,9d83f6da776ff7d6,6b7c7460855dbbb9,2021-10-30,1,0,0,900,2,1,93,30,85,8,1,1,7,4,16,11,69,26,16.7,542.0
1452,6163c18411aca830,253076a23d03dcd0,f00ac08ab056af5d,2021-10-30,0,2,0,900,1,0,37,13,27,10,0,0,10,10,13,12,14,3,13.3,160.0
1453,6163c18411aca830,f00ac08ab056af5d,253076a23d03dcd0,2021-10-30,0,1,0,900,5,4,40,16,26,14,0,0,14,10,3,2,23,6,724.0,162.7
1454,5ad4c0eae7512878,193b9d1858bc4df3,275aca31f61ba28c,2021-10-30,0,0,0,145,0,0,13,1,13,0,0,0,0,0,3,3,10,1,0.0,145.0
1455,5ad4c0eae7512878,275aca31f61ba28c,193b9d1858bc4df3,2021-10-30,0,2,1,145,1,1,3,2,3,0,0,0,0,0,0,0,3,2,0.0,37.0
1456,58b19ba734fe93a3,0845c81e37d3bcb3,d802174b0c0c1f4e,2021-10-30,0,0,0,900,1,0,102,23,102,0,0,0,0,0,35,25,67,23,0.0,886.9
1457,58b19ba734fe93a3,d802174b0c0c1f4e,0845c81e37d3bcb3,2021-10-30,1,0,0,900,4,1,108,43,107,1,0,0,1,1,26,23,81,42,13.1,795.0
1458,4a5e5232346993c7,5f61780fe5e9b6d0,f1175ea3aafbf351,2021-10-30,0,6,1,886,8,4,102,60,67,35,0,0,35,30,14,12,53,30,579.0,307.0
1459,4a5e5232346993c7,f1175ea3aafbf351,5f61780fe5e9b6d0,2021-10-30,0,0,0,886,0,0,65,17,65,0,0,0,0,0,8,8,57,17,0.0,294.0
1460,41cdfea7df63003f,1ae8f3c723aacff4,aceffa19749c4dc0,2021-10-30,0,0,0,900,0,0,224,49,224,0,0,0,0,0,37,19,187,49,0.0,900.0
1461,41cdfea7df63003f,aceffa19749c4dc0,1ae8f3c723aacff4,2021-10-30,0,0,0,900,7,2,181,73,181,0,0,0,0,0,7,4,174,73,0.0,845.0
1462,18edff5447989b3f,65f09bacd3957381,d661ce4da776fc20,2021-10-30,0,0,0,1500,6,1,445,118,445,0,0,0,0,0,56,51,389,118,0.0,1445.5
1463,18edff5447989b3f,d661ce4da776fc20,65f09bacd3957381,2021-10-30,1,1,0,1500,2,0,270,100,261,9,1,1,8,6,52,48,209,94,34.5,1431.0
1464,156f2425a937b22f,396fe87b84ac2e1c,87a1dc546b1c5caf,2021-10-30,1,0,0,314,0,0,5,4,2,3,0,0,3,3,0,0,2,1,9.0,60.0
1465,156f2425a937b22f,87a1dc546b1c5caf,396fe87b84ac2e1c,2021-10-30,0,0,0,314,7,5,6,3,2,4,0,0,4,3,1,1,1,0,245.0,60.0
1466,13e3e41e0c6f4e04,279566840aa55bf2,c9cf753cfdf77fc2,2021-10-30,0,0,0,900,0,0,139,53,136,3,0,0,3,3,22,22,114,50,14.4,780.0
1467,13e3e41e0c6f4e04,c9cf753cfdf77fc2,279566840aa55bf2,2021-10-30,0,0,0,900,16,0,139,39,139,0,0,0,0,0,22,19,117,39,0.0,764.6
1468,e078d18fa9ed100d,8c57c7b8c3bab0eb,f9d0cae37dabfafc,2021-10-23,1,0,0,78,1,0,21,8,15,6,0,0,6,3,3,3,12,5,17.1,58.0
1469,e078d18fa9ed100d,f9d0cae37dabfafc,8c57c7b8c3bab0eb,2021-10-23,0,0,0,78,1,0,21,5,21,0,0,0,0,0,2,2,19,5,0.0,60.9
1470,d44d735e5079bfb8,f6ad6a1e4d600e0d,ffe9703408fb5964,2021-10-23,0,0,0,900,14,8,157,65,148,9,0,0,9,8,24,22,124,57,180.3,358.1
1471,d44d735e5079bfb8,ffe9703408fb5964,f6ad6a1e4d600e0d,2021-10-23,0,0,0,900,1,0,153,80,151,2,0,0,2,1,11,10,140,79,0.9,708.7
1472,acec5f4c6fee1ae2,008ea710276c9606,31bb0772f21cabd8,2021-10-23,1,0,0,346,0,0,62,39,13,49,1,1,48,37,7,7,6,2,206.0,91.1
1473,acec5f4c6fee1ae2,31bb0772f21cabd8,008ea710276c9606,2021-10-23,0,0,0,346,2,0,25,7,17,8,0,0,8,6,14,13,3,1,48.9,85.0
1474,9fe62ea683decc55,814ff3018127e8fc,99bd51917728c25d,2021-10-23,0,1,0,900,0,0,41,19,20,21,2,2,19,17,13,7,7,2,257.7,166.2
1475,9fe62ea683decc55,99bd51917728c25d,814ff3018127e8fc,2021-10-23,0,0,0,900,11,3,31,12,9,22,7,7,15,12,7,5,2,0,463.8,136.3
1476,98842f17dfe4b4ef,7aa3d6964eff4877,a68575214ecad140,2021-10-23,0,1,1,511,0,0,64,22,64,0,0,0,0,0,31,24,33,22,0.0,450.5
1477,98842f17dfe4b4ef,a68575214ecad140,7aa3d6964eff4877,2021-10-23,1,0,0,511,0,0,98,18,88,10,0,0,10,4,20,15,68,14,11.5,496.0
1478,88256dd5a9aef1cc,285ae0b4a68221f4,d1c65d2cf2925ddd,2021-10-23,0,0,0,493,0,0,109,50,109,0,0,0,0,0,6,6,103,50,0.0,310.2
1479,88256dd5a9aef1cc,d1c65d2cf2925ddd,285ae0b4a68221f4,2021-10-23,1,0,0,493,4,2,90,53,80,10,0,0,10,8,17,15,63,45,153.8,293.0
1480,860be3cc82895177,2e5c2aa8e4ab9d82,7acbb0972e75281a,2021-10-23,0,0,0,1500,1,1,260,82,254,6,1,1,5,3,85,80,169,79,25.6,1446.1
1481,860be3cc82895177,7acbb0972e75281a,2e5c2aa8e4ab9d82,2021-10-23,0,0,0,1500,5,1,346,154,345,1,0,0,1,1,39,36,306,153,6.9,1267.4
1482,85f920746c58d0a6,830f60497fab345a,a12a8314adc1c1c9,2021-10-23,0,0,0,900,2,2,96,23,95,1,0,0,1,0,32,24,63,23,6.5,743.0
1483,85f920746c58d0a6,a12a8314adc1c1c9,830f60497fab345a,2021-10-23,0,0,0,900,9,1,62,14,62,0,0,0,0,0,14,11,48,14,0.0,567.5
1484,7151ae256e6c181b,41498c2d1a87b154,f2477cf43c4975cc,2021-10-23,0,0,0,900,6,0,160,25,160,0,0,0,0,0,45,38,115,25,0.0,810.0
1485,7151ae256e6c181b,f2477cf43c4975cc,41498c2d1a87b154,2021-10-23,0,0,0,900,0,0,188,65,188,0,0,0,0,0,34,27,154,65,0.0,900.0
1486,6d7eecf4acecda2a,4c88a1db5a46c6a4,78e501478a36a018,2021-10-23,1,0,0,167,0,0,46,21,41,5,0,0,5,3,6,3,35,18,3.6,162.0
1487,6d7eecf4acecda2a,78e501478a36a018,4c88a1db5a46c6a4,2021-10-23,0,0,0,167,0,0,21,5,21,0,0,0,0,0,8,6,13,5,0.0,163.4
1488,69167b996ce7a7e4,6c8072b61c276e67,f9ab66e67240db7b,2021-10-23,0,0,0,900,11,5,27,9,23,4,0,0,4,4,10,9,13,5,350.0,144.0
1489,69167b996ce7a7e4,f9ab66e67240db7b,6c8072b61c276e67,2021-10-23,0,0,0,900,0,0,48,19,44,4,0,0,4,4,15,11,29,15,56.0,452.0
1490,61d9eff5fa4c8578,4a57ebb14315b251,dab8cfbb6b1db10a,2021-10-23,0,0,0,900,0,0,96,55,80,16,2,2,14,14,9,8,71,41,205.7,312.7
1491,61d9eff5fa4c8578,dab8cfbb6b1db10a,4a57ebb14315b251,2021-10-23,0,2,0,900,6,3,27,7,25,2,0,0,2,2,4,4,21,5,60.3,483.3
1492,587d373f18f6c8c0,8be158ca1e5ea6a0,a8283a4f415e1eb9,2021-10-23,0,0,0,900,1,1,133,20,129,4,0,0,4,2,19,11,110,18,8.8,713.6
1493,587d373f18f6c8c0,a8283a4f415e1eb9,8be158ca1e5ea6a0,2021-10-23,0,0,0,900,3,1,70,20,62,8,0,0,8,6,20,16,42,14,175.4,606.2
1494,1fe58cdab57d233b,37d752ec41ed84bb,d25240135aee03e5,2021-10-23,0,0,0,900,0,0,178,34,176,2,0,0,2,1,50,32,126,33,0.3,554.8
1495,1fe58cdab57d233b,d25240135aee03e5,37d752ec41ed84bb,2021-10-23,0,0,0,900,11,5,135,42,103,32,0,0,32,28,26,20,77,14,344.2,501.7
1496,fefa96b6d939ffea,12ebd7d157e91701,fccf811c1e8b01c7,2021-10-16,1,0,0,755,1,0,123,47,114,9,0,0,9,5,27,23,87,42,6.4,402.1
1497,fefa96b6d939ffea,fccf811c1e8b01c7,12ebd7d157e91701,2021-10-16,0,0,0,755,12,7,53,26,48,5,0,0,5,5,10,7,38,21,337.9,275.6
1498,e3881a6895be3e9e,a6cba6bb66c1a8c9,abd5fb12437eda21,2021-10-16,0,0,0,900,3,1,94,17,93,1,0,0,1,0,23,17,70,17,5.3,729.4
1499,e3881a6895be3e9e,abd5fb12437eda21,a6cba6bb66c1a8c9,2021-10-16,0,1,0,900,7,2,79,32,78,1,0,0,1,1,11,8,67,31,12.6,717.7
1500,d9ca00b3c62a874d,a2ccf35a88346a91,d1941565abf50b16,2021-10-16,0,0,0,314,2,1,37,10,35,2,0,0,2,1,7,4,28,9,31.0,200.9
1501,d9ca00b3c62a874d,d1941565abf50b16,a2ccf35a88346a91,2021-10-16,1,0,0,314,2,1,48,25,40,8,0,0,8,6,7,7,33,19,51.1,168.0
1502,cf020c71f1dbfa0b,3b0a516d2921e0d6,cc351e408bbb7d43,2021-10-16,1,0,0,121,0,0,51,20,45,6,0,0,6,2,6,2,39,18,3.8,116.0
1503,cf020c71f1dbfa0b,cc351e408bbb7d43,3b0a516d2921e0d6,2021-10-16,0,0,0,121,0,0,27,4,27,0,0,0,0,0,5,3,22,4,0.0,117.2
1504,be8bee783d22bee2,528b071cf3da7c56,8e5d953bdb9ae5e7,2021-10-16,0,0,0,900,0,0,107,24,107,0,0,0,0,0,37,29,70,24,0.0,681.8
1505,be8bee783d22bee2,8e5d953bdb9ae5e7,528b071cf3da7c56,2021-10-16,0,0,0,900,15,2,54,16,50,4,0,0,4,4,12,7,38,12,166.2,443.0
1506,b193e2317b21125c,34ff304266360297,cc8c623cca88f54f,2021-10-16,0,0,0,900,6,2,267,47,253,14,3,3,11,5,46,41,207,42,155.9,654.3
1507,b193e2317b21125c,cc8c623cca88f54f,34ff304266360297,2021-10-16,0,0,0,900,0,0,111,13,109,2,1,1,1,1,55,34,54,12,0.7,740.1
1508,a2e1116a9fe84aa9,583ee11abddfc581,5b86d491d63890c5,2021-10-16,0,2,1,742,2,1,130,41,130,0,0,0,0,0,45,30,85,41,0.0,516.0
1509,a2e1116a9fe84aa9,5b86d491d63890c5,583ee11abddfc581,2021-10-16,0,0,0,742,2,0,85,20,85,0,0,0,0,0,30,22,55,20,0.0,710.0
1510,814d481e79e9a525,c0d5c0c95c59050b,efc67b07eed39794,2021-10-16,0,1,1,777,7,5,108,33,108,0,0,0,0,0,5,3,103,33,0.0,353.0
1511,814d481e79e9a525,efc67b07eed39794,c0d5c0c95c59050b,2021-10-16,0,0,0,777,0,0,119,37,119,0,0,0,0,0,31,25,88,37,0.0,777.0
1512,330e67abac6e5ce7,d3f5d33d61cd00c9,d4691518d012b9e7,2021-10-16,0,0,0,1500,1,1,149,48,149,0,0,0,0,0,20,17,129,48,0.0,1158.0
1513,330e67abac6e5ce7,d4691518d012b9e7,d3f5d33d61cd00c9,2021-10-16,0,0,0,1500,5,0,110,28,97,13,1,1,12,7,6,4,91,21,235.0,1048.0
1514,188b63ec6ee1c1c9,3738e68d2261e60f,a2ea77e974c5889f,2021-10-16,0,0,0,900,0,0,172,49,172,0,0,0,0,0,39,34,133,49,0.0,865.8
1515,188b63ec6ee1c1c9,a2ea77e974c5889f,3738e68d2261e60f,2021-10-16,0,0,0,900,0,0,172,53,162,10,0,0,10,7,27,20,135,46,34.2,818.0
1516,f526892a27b50576,8e5d953bdb9ae5e7,b4880ef2f838d4e1,2021-10-09,0,1,1,254,6,5,13,8,13,0,0,0,0,0,3,3,10,8,0.0,47.0
1517,f526892a27b50576,b4880ef2f838d4e1,8e5d953bdb9ae5e7,2021-10-09,0,0,0,254,0,0,13,3,13,0,0,0,0,0,0,0,13,3,0.0,254.0
1518,df16b9c2fc9722e9,29af297d9f1de0f8,40093d1d2d78394e,2021-10-09,0,2,0,900,12,6,87,33,61,26,0,0,26,18,10,8,51,15,559.4,254.7
1519,df16b9c2fc9722e9,40093d1d2d78394e,29af297d9f1de0f8,2021-10-09,0,0,0,900,3,2,87,17,84,3,0,0,3,3,21,17,63,14,21.3,262.6
1520,ddb927b0dfcfac2a,318572f6f74b760d,97cf1a2c7c5e7889,2021-10-09,2,0,0,411,0,0,23,7,18,5,0,0,5,1,1,0,17,6,5.7,57.30000000000001
1521,ddb927b0dfcfac2a,97cf1a2c7c5e7889,318572f6f74b760d,2021-10-09,1,0,0,411,5,3,49,30,12,37,2,2,35,25,2,2,10,5,345.7,50.3
1522,d5ffdb5388ffabc6,c6aee362c7a7d482,c730a0be691dc081,2021-10-09,0,0,0,900,1,0,235,81,234,1,0,0,1,1,39,34,195,80,0.8,876.4
1523,d5ffdb5388ffabc6,c730a0be691dc081,c6aee362c7a7d482,2021-10-09,0,0,0,900,0,0,156,19,154,2,0,0,2,0,80,62,74,19,17.6,855.2
1524,777c65184aa63894,2b68d9f125d07b42,c0badf3243907e59,2021-10-09,0,0,0,583,0,0,23,4,23,0,0,0,0,0,11,9,12,4,0.0,192.0
1525,777c65184aa63894,c0badf3243907e59,2b68d9f125d07b42,2021-10-09,1,0,0,583,7,5,78,48,22,56,4,4,52,41,8,4,14,7,391.0,192.0
1526,6101249c2cdd1493,45f0cc9d18f35137,dbac0a413af64bbe,2021-10-09,0,0,0,900,3,0,144,57,142,2,0,0,2,1,43,39,99,56,30.0,810.0
1527,6101249c2cdd1493,dbac0a413af64bbe,45f0cc9d18f35137,2021-10-09,0,0,0,900,7,1,147,23,147,0,0,0,0,0,36,18,111,23,0.0,631.0
1528,38957d8eb185391c,70d2329a92864fdb,a08ddd04eaffd81d,2021-10-09,0,0,0,653,0,0,159,35,159,0,0,0,0,0,46,27,113,35,0.0,618.0
1529,38957d8eb185391c,a08ddd04eaffd81d,70d2329a92864fdb,2021-10-09,1,1,1,653,0,0,164,48,164,0,0,0,0,0,57,45,107,48,0.0,648.0
1530,20f19439e9b100b0,1a31ef98efce7a79,c96d9178c9ed9e62,2021-10-09,0,0,0,900,1,1,109,28,108,1,0,0,1,0,46,36,62,28,64.0,753.5
1531,20f19439e9b100b0,c96d9178c9ed9e62,1a31ef98efce7a79,2021-10-09,0,0,0,900,10,1,215,39,214,1,1,1,0,0,54,30,160,39,18.5,688.0
1532,149d6b90f33634a4,7447e9f28508106a,cd2c4d30c6e13b47,2021-10-09,0,1,0,1500,8,1,174,41,158,16,0,0,16,12,16,8,142,29,371.4,1059.0
1533,149d6b90f33634a4,cd2c4d30c6e13b47,7447e9f28508106a,2021-10-09,0,1,0,1500,0,0,279,72,279,0,0,0,0,0,93,72,186,72,0.0,1118.6
1534,e7423a91a253b416,528c24b99fbaab79,80daefbed11ce998,2021-10-02,0,0,0,553,1,1,59,7,58,1,1,1,0,0,25,23,33,7,18.5,429.7
1535,e7423a91a253b416,80daefbed11ce998,528c24b99fbaab79,2021-10-02,0,2,1,553,1,1,55,11,51,4,1,1,3,2,14,11,37,9,49.3,460.5
1536,dfa2f5c821a52c63,207773daeb4afa7b,af9f42e6894047fc,2021-10-02,0,0,0,471,0,0,64,24,64,0,0,0,0,0,7,5,57,24,0.0,455.3
1537,dfa2f5c821a52c63,af9f42e6894047fc,207773daeb4afa7b,2021-10-02,1,0,0,471,2,1,108,22,97,11,1,1,10,5,42,32,55,17,15.7,424.0
1538,dba710edbc3c29ff,4e06913c91da5200,67f272324a030d00,2021-10-02,0,0,0,900,3,1,95,23,95,0,0,0,0,0,19,18,76,23,0.0,741.2
1539,dba710edbc3c29ff,67f272324a030d00,4e06913c91da5200,2021-10-02,0,0,0,900,17,5,91,13,84,7,7,7,0,0,25,21,59,13,114.8,654.0
1540,ce151e053721fe69,3a46b268013afede,d6c0cdd7e467c440,2021-10-02,0,0,0,223,0,0,7,2,7,0,0,0,0,0,1,1,6,2,0.0,86.8
1541,ce151e053721fe69,d6c0cdd7e467c440,3a46b268013afede,2021-10-02,0,3,0,223,5,1,13,5,8,5,0,0,5,3,4,4,4,2,72.2,93.0
1542,c1e5859053263811,568bbad0eaced57c,5e6294b37bbef029,2021-10-02,0,2,0,442,0,0,50,8,50,0,0,0,0,0,19,14,31,8,0.0,247.7
1543,c1e5859053263811,5e6294b37bbef029,568bbad0eaced57c,2021-10-02,1,0,0,442,4,2,42,20,28,14,0,0,14,12,9,9,19,8,171.3,234.0
1544,a00b4e82f9d4f92c,262a7d06203657e6,d80ee110748171ac,2021-10-02,1,0,0,80,2,0,35,15,35,0,0,0,0,0,6,5,29,15,0.0,80.0
1545,a00b4e82f9d4f92c,d80ee110748171ac,262a7d06203657e6,2021-10-02,0,0,0,80,0,0,15,4,15,0,0,0,0,0,2,2,13,4,0.0,80.0
1546,9c33c8d4a381ba70,57b10fca4f9c9a7a,d8da10db80131bec,2021-10-02,0,0,0,900,2,1,112,31,101,11,3,2,8,5,37,32,64,26,164.2,441.2
1547,9c33c8d4a381ba70,d8da10db80131bec,57b10fca4f9c9a7a,2021-10-02,0,0,0,900,3,1,116,37,95,21,2,2,19,15,31,25,64,22,264.8,445.8
1548,6832e9e62da0f9d3,04835018f90b118c,d7338bcb141abd2c,2021-10-02,1,0,0,587,8,3,110,46,58,52,0,0,52,37,9,6,49,9,320.5,208.0
1549,6832e9e62da0f9d3,d7338bcb141abd2c,04835018f90b118c,2021-10-02,0,0,0,587,1,0,63,32,53,10,0,0,10,8,8,8,45,24,40.0,194.5
1550,5f444eac11e55161,3a314d9fa7c6825d,8765559b6a29a421,2021-10-02,1,0,0,124,0,0,15,6,12,3,0,0,3,3,6,4,6,3,14.2,105.0
1551,5f444eac11e55161,8765559b6a29a421,3a314d9fa7c6825d,2021-10-02,0,0,0,124,0,0,6,0,6,0,0,0,0,0,6,5,0,0,0.0,109.8
1552,3b7eb8e56052a2af,7026eca45f65377b,af65aa688d13eedf,2021-10-02,0,0,0,900,2,1,86,32,83,3,0,0,3,3,26,19,57,29,41.2,401.7
1553,3b7eb8e56052a2af,af65aa688d13eedf,7026eca45f65377b,2021-10-02,0,0,0,900,7,4,69,31,60,9,0,0,9,9,7,7,53,22,251.3,495.8
1554,37c484012ef24a5b,c21f26bbde777573,dea070ed4a2a8281,2021-10-02,0,0,0,1500,0,0,130,7,130,0,0,0,0,0,75,41,55,7,0.0,1500.0
1555,37c484012ef24a5b,dea070ed4a2a8281,c21f26bbde777573,2021-10-02,0,0,0,1500,1,0,105,9,105,0,0,0,0,0,65,35,40,9,0.0,1500.0
1556,16d31775a8dcb31d,351c4ec637380ad5,673ea7dcc786b1b3,2021-10-02,0,0,0,900,2,0,199,70,198,1,0,0,1,1,57,55,141,69,6.3,730.0
1557,16d31775a8dcb31d,673ea7dcc786b1b3,351c4ec637380ad5,2021-10-02,0,0,0,900,2,0,147,18,147,0,0,0,0,0,56,44,91,18,0.0,893.7
1558,f4df74046a1c4364,2cd428e9606856fd,fa6796c55d6c5440,2021-09-25,0,0,0,900,0,0,68,17,68,0,0,0,0,0,3,1,65,17,0.0,521.0
1559,f4df74046a1c4364,fa6796c55d6c5440,2cd428e9606856fd,2021-09-25,0,0,0,900,6,3,96,18,86,10,6,5,4,3,14,9,72,15,379.0,521.0
1560,f4a2806f77ac1cdc,6a1901c62ab3870f,98215d037be5bcb7,2021-09-25,1,0,0,294,0,0,86,34,86,0,0,0,0,0,16,14,70,34,0.0,294.0
1561,f4a2806f77ac1cdc,98215d037be5bcb7,6a1901c62ab3870f,2021-09-25,0,0,0,294,0,0,75,10,75,0,0,0,0,0,23,17,52,10,0.0,294.0
1562,f085f32bbb3220e1,2f5cbecbbe18bac4,d0aaedcf7ccd0b45,2021-09-25,0,0,0,383,0,0,63,13,63,0,0,0,0,0,15,10,48,13,0.0,341.9
1563,f085f32bbb3220e1,d0aaedcf7ccd0b45,2f5cbecbbe18bac4,2021-09-25,2,0,0,383,0,0,93,34,63,30,0,0,30,18,5,4,58,16,41.1,335.0
1564,e7bb37681652c2c2,4498b382c65a7faa,f7467152fd9f18a2,2021-09-25,0,0,0,900,4,0,92,13,92,0,0,0,0,0,7,5,85,13,0.0,424.0
1565,e7bb37681652c2c2,f7467152fd9f18a2,4498b382c65a7faa,2021-09-25,1,0,0,900,5,5,95,38,81,14,0,0,14,7,20,17,61,31,294.0,417.0
1566,d8189169b2c8a2aa,12585614e0ed2626,f14f644d41ade29f,2021-09-25,0,0,0,900,15,4,40,12,31,9,0,0,9,3,3,2,28,9,360.6,259.9
1567,d8189169b2c8a2aa,f14f644d41ade29f,12585614e0ed2626,2021-09-25,0,1,0,900,1,0,53,22,42,11,1,1,10,10,7,5,35,12,79.1,424.4
1568,bc276e0f07e30a54,c03520b5c88ed6b4,fea79f9bc8c68769,2021-09-25,1,0,0,565,4,4,109,63,35,74,5,5,69,52,3,1,32,11,360.0,181.7
1569,bc276e0f07e30a54,fea79f9bc8c68769,c03520b5c88ed6b4,2021-09-25,1,0,0,565,0,0,44,23,37,7,0,0,7,7,8,6,29,16,23.3,175.0
1570,b3c23fb2d71bba51,193b9d1858bc4df3,b7b84ccd221be298,2021-09-25,0,0,0,900,7,3,153,26,149,4,3,3,1,1,53,44,96,25,89.3,476.0
1571,b3c23fb2d71bba51,b7b84ccd221be298,193b9d1858bc4df3,2021-09-25,0,0,0,900,1,0,69,17,69,0,0,0,0,0,13,10,56,17,0.0,807.7
1572,92e006a93f983fb5,f2925e6db404bf1d,f57a8a52ca401ed9,2021-09-25,1,0,0,644,0,0,221,88,220,1,0,0,1,1,45,43,175,87,0.4,630.0
1573,92e006a93f983fb5,f57a8a52ca401ed9,f2925e6db404bf1d,2021-09-25,0,0,0,644,1,0,339,114,339,0,0,0,0,0,45,36,294,114,0.0,643.6
1574,7abc4520f63f2c06,4d8fa64202cee4c1,681399317dbf4701,2021-09-25,0,1,1,241,1,1,47,16,34,13,0,0,13,6,11,9,23,10,117.0,97.0
1575,7abc4520f63f2c06,681399317dbf4701,4d8fa64202cee4c1,2021-09-25,0,0,0,241,0,0,11,2,11,0,0,0,0,0,5,4,6,2,0.0,124.0
1576,7484298ad57099be,87c0b1c696ddfb43,a0e6753c42698f13,2021-09-25,0,1,1,511,11,6,35,9,35,0,0,0,0,0,7,3,28,9,0.0,178.0
1577,7484298ad57099be,a0e6753c42698f13,87c0b1c696ddfb43,2021-09-25,0,0,0,511,0,0,25,9,25,0,0,0,0,0,3,3,22,9,0.0,492.0
1578,73f6b72b4889088f,16a64f93f6678b7b,4aa58269d0664b5b,2021-09-25,0,0,0,15,0,0,3,1,3,0,0,0,0,0,0,0,3,1,0.0,14.0
1579,73f6b72b4889088f,4aa58269d0664b5b,16a64f93f6678b7b,2021-09-25,1,0,0,15,0,0,5,2,4,1,0,0,1,1,1,1,3,1,1.0,14.0
1580,7233b2a56438d77a,132deb59abae64b1,729d4bd5a6cd0a97,2021-09-25,1,0,0,1140,4,3,170,62,145,25,0,0,25,20,44,36,101,42,184.8,896.0
1581,7233b2a56438d77a,729d4bd5a6cd0a97,132deb59abae64b1,2021-09-25,0,0,0,1140,0,0,91,4,91,0,0,0,0,0,18,7,73,4,0.0,914.2
1582,18f1b88d8977c216,def8166ff24bd237,e1248941344b3288,2021-09-25,0,3,0,1500,5,2,234,59,234,0,0,0,0,0,41,29,193,59,0.0,1229.0
1583,18f1b88d8977c216,e1248941344b3288,def8166ff24bd237,2021-09-25,0,0,0,1500,0,0,353,146,260,93,0,0,93,53,83,68,177,93,217.0,1269.0
1584,eb10feae98ea7d36,26e3f3928b1891d9,b3d21b2610dcfaeb,2021-09-18,0,1,1,257,0,0,22,1,22,0,0,0,0,0,10,9,12,1,0.0,49.0
1585,eb10feae98ea7d36,b3d21b2610dcfaeb,26e3f3928b1891d9,2021-09-18,0,0,0,257,2,2,13,3,12,1,0,0,1,0,3,2,9,3,184.0,73.0
1586,dc870fab1e0f15e1,0b362247806341e5,cc1a8b4b38b92c6d,2021-09-18,0,3,0,900,7,1,24,3,23,1,0,0,1,1,14,5,9,2,40.0,402.5
1587,dc870fab1e0f15e1,cc1a8b4b38b92c6d,0b362247806341e5,2021-09-18,4,1,0,900,5,4,43,18,25,18,1,1,17,7,6,6,19,11,417.5,257.0
1588,d1621b3da377f34b,a67f5afa8d6a1b80,d4c9dcd330403612,2021-09-18,0,0,0,227,1,0,20,5,19,1,1,1,0,0,2,2,17,5,15.0,99.0
1589,d1621b3da377f34b,d4c9dcd330403612,a67f5afa8d6a1b80,2021-09-18,2,1,1,227,0,0,28,11,20,8,1,1,7,5,6,5,14,6,98.0,114.0
1590,d06495deb1ff1750,18b602842a24f7c5,6aae253467e8f9ce,2021-09-18,0,0,0,900,0,0,144,19,144,0,0,0,0,0,39,30,105,19,0.0,838.8
1591,d06495deb1ff1750,6aae253467e8f9ce,18b602842a24f7c5,2021-09-18,0,0,0,900,3,3,199,81,188,11,0,0,11,9,55,35,133,72,59.2,615.0
1592,ceaf7ed5ade30d9f,297a2b35444c245b,6551c64fbcd1a467,2021-09-18,0,0,0,900,4,0,108,18,108,0,0,0,0,0,24,18,84,18,0.0,770.4
1593,ceaf7ed5ade30d9f,6551c64fbcd1a467,297a2b35444c245b,2021-09-18,2,0,0,900,1,0,194,27,180,14,5,4,9,4,83,56,97,23,100.6,634.0
1594,85e5498808346d6b,6a8928652fc01bee,a13d755965a4ec9f,2021-09-18,0,0,0,875,0,0,105,17,103,2,0,0,2,2,36,24,67,15,1.1,313.4
1595,85e5498808346d6b,a13d755965a4ec9f,6a8928652fc01bee,2021-09-18,1,0,0,875,8,6,134,71,75,59,6,5,53,37,10,10,65,34,557.6,306.9
1596,576b795e33ddd62d,601964f9654f911a,6e9f40c706f91f32,2021-09-18,1,0,0,430,6,1,68,18,65,3,0,0,3,3,25,18,40,15,33.7,271.7
1597,576b795e33ddd62d,6e9f40c706f91f32,601964f9654f911a,2021-09-18,1,0,0,430,1,1,63,26,54,9,0,0,9,8,6,5,48,18,12.3,381.3
1598,4b5f9b7c31d1205d,cc7040fe76f0ef91,cd13728ae1151f46,2021-09-18,0,0,0,900,6,1,52,10,45,7,0,0,7,3,20,13,25,7,41.3,359.6
1599,4b5f9b7c31d1205d,cd13728ae1151f46,cc7040fe76f0ef91,2021-09-18,1,0,0,900,12,8,101,59,37,64,1,1,63,45,5,4,32,14,422.4,330.7
1600,401f5f4714132d50,61fb8098ccf81c7f,b9437600497350f3,2021-09-18,0,0,0,746,0,0,46,4,46,0,0,0,0,0,24,17,22,4,0.0,666.3
1601,401f5f4714132d50,b9437600497350f3,61fb8098ccf81c7f,2021-09-18,1,0,0,746,6,1,102,12,97,5,0,0,5,5,43,29,54,7,55.7,668.0
1602,2d42742aade53799,91dac5e69e28d5b5,fc169c387b4b465d,2021-09-18,0,0,0,900,2,1,98,26,98,0,0,0,0,0,30,24,68,26,0.0,540.9
1603,2d42742aade53799,fc169c387b4b465d,91dac5e69e28d5b5,2021-09-18,0,0,0,900,3,1,79,26,77,2,0,0,2,2,23,22,54,24,25.1,524.0
1604,178756c3cb23b884,1897b7b913736a7c,93b62c5f2ba18e51,2021-09-18,0,0,0,900,1,0,118,23,118,0,0,0,0,0,16,13,102,23,0.0,817.1
1605,178756c3cb23b884,93b62c5f2ba18e51,1897b7b913736a7c,2021-09-18,0,1,0,900,8,3,115,32,105,10,0,0,10,7,22,12,83,25,76.9,777.0
1606,13a8ddb1c3f55ed4,de45aaae23dfa392,eae48ff31db420c2,2021-09-18,0,0,0,129,0,0,6,0,6,0,0,0,0,0,1,1,5,0,0.0,69.0
1607,13a8ddb1c3f55ed4,eae48ff31db420c2,de45aaae23dfa392,2021-09-18,1,0,0,129,1,0,31,21,10,21,0,0,21,18,2,1,8,3,11.0,118.0
1608,0ce63c2148e70b4c,49b130de1da2e1bf,669970f7feba8ecd,2021-09-18,0,0,0,900,1,0,113,22,113,0,0,0,0,0,26,19,87,22,0.0,382.5
1609,0ce63c2148e70b4c,669970f7feba8ecd,49b130de1da2e1bf,2021-09-18,0,0,0,900,3,3,210,94,131,79,7,7,72,50,21,19,110,44,517.5,317.0
1610,06b3226c34c17001,257b0c8d6f199895,a53d30163304aa6e,2021-09-18,0,0,0,158,0,0,21,5,21,0,0,0,0,0,1,1,20,5,0.0,137.0
1611,06b3226c34c17001,a53d30163304aa6e,257b0c8d6f199895,2021-09-18,1,0,0,158,1,0,46,16,35,11,1,1,10,9,8,7,27,7,21.0,137.0
1612,f09912e9d8eaa968,3bb2dc8e87b10a46,cdb96af67d096b1e,2021-09-04,0,0,0,900,2,1,205,39,205,0,0,0,0,0,55,47,150,39,0.0,861.0
1613,f09912e9d8eaa968,cdb96af67d096b1e,3bb2dc8e87b10a46,2021-09-04,0,0,0,900,0,0,213,81,213,0,0,0,0,0,13,9,200,81,0.0,834.0
1614,b977ffcc6428046f,399afbabc02376b5,e2f6b2769aaedd6c,2021-09-04,1,0,0,150,0,0,26,12,16,10,0,0,10,6,4,4,12,6,2.3,147.0
1615,b977ffcc6428046f,e2f6b2769aaedd6c,399afbabc02376b5,2021-09-04,0,0,0,150,2,0,11,0,11,0,0,0,0,0,0,0,11,0,0.0,147.7
1616,ad81be01a461c936,476fe566d2df676e,749f572d1d3161fb,2021-09-04,0,0,0,450,0,0,49,18,49,0,0,0,0,0,5,5,44,18,0.0,450.0
1617,ad81be01a461c936,749f572d1d3161fb,476fe566d2df676e,2021-09-04,1,0,0,450,0,0,92,18,92,0,0,0,0,0,21,20,71,18,0.0,450.0
1618,a7c38d4d66abf923,8e9eb3fc86db0f7d,ce632027bf2a871b,2021-09-04,0,0,0,900,0,0,289,80,289,0,0,0,0,0,56,38,233,80,0.0,869.0
1619,a7c38d4d66abf923,ce632027bf2a871b,8e9eb3fc86db0f7d,2021-09-04,0,0,0,900,5,2,217,60,217,0,0,0,0,0,32,25,185,60,0.0,868.0
1620,8fc238e84c4624a7,2f1a257d6777096d,7826923b47f8d72a,2021-09-04,0,0,0,265,1,1,51,14,50,1,0,0,1,1,11,11,39,13,4.5,238.0
1621,8fc238e84c4624a7,7826923b47f8d72a,2f1a257d6777096d,2021-09-04,1,0,0,265,2,0,81,29,81,0,0,0,0,0,19,18,62,29,0.0,251.5
1622,4fc128b1bdf088b1,1a54231796e24a3f,b8a85389d115e35a,2021-09-04,0,0,0,900,4,0,92,13,91,1,0,0,1,1,7,6,84,12,28.7,735.2
1623,4fc128b1bdf088b1,b8a85389d115e35a,1a54231796e24a3f,2021-09-04,0,1,0,900,8,2,155,59,150,5,0,0,5,4,39,33,111,55,78.8,603.3
1624,14f2bb86fd888e91,9ce6d5a03af801b7,b1a3e0aca758b322,2021-09-04,0,0,0,733,0,0,50,14,50,0,0,0,0,0,12,12,38,14,0.0,313.7
1625,14f2bb86fd888e91,b1a3e0aca758b322,9ce6d5a03af801b7,2021-09-04,0,1,1,733,6,3,84,37,39,45,0,0,45,29,8,4,31,8,415.3,290.0
1626,06c0c7dda5a5909d,51018a31ddf31eb2,a20f234df70f2182,2021-09-04,0,0,0,900,3,2,272,110,272,0,0,0,0,0,23,17,249,110,0.0,827.2
1627,06c0c7dda5a5909d,a20f234df70f2182,51018a31ddf31eb2,2021-09-04,0,0,0,900,2,0,361,87,359,2,2,2,0,0,43,33,316,87,25.8,745.0
1628,ef4484943b1c68a9,b8bbdeff718dbb7d,e00a3dee329a51f7,2021-08-28,0,2,1,113,1,0,9,1,9,0,0,0,0,0,0,0,9,1,0.0,64.0
1629,ef4484943b1c68a9,e00a3dee329a51f7,b8bbdeff718dbb7d,2021-08-28,0,1,0,113,0,0,14,3,12,2,1,1,1,1,6,6,6,2,49.0,64.0
1630,ed64e42263bf50bf,7af33fc4435017f1,cd3d7e37ff2d679c,2021-08-28,0,0,0,900,11,6,134,59,127,7,1,1,6,5,9,6,118,54,189.4,390.6
1631,ed64e42263bf50bf,cd3d7e37ff2d679c,7af33fc4435017f1,2021-08-28,1,0,0,900,4,2,171,83,158,13,0,0,13,11,21,17,137,72,49.4,558.6
1632,e24c8aab497b4fe1,77d7295d1b22c694,eae431e70064e046,2021-08-28,0,0,0,17,0,0,2,0,2,0,0,0,0,0,2,1,0,0,0.0,17.0
1633,e24c8aab497b4fe1,eae431e70064e046,77d7295d1b22c694,2021-08-28,1,0,0,17,0,0,1,1,1,0,0,0,0,0,0,0,1,1,0.0,17.0
1634,be4890f4aaadec28,c0386644627a7ee5,d05412b513b19621,2021-08-28,0,0,0,900,3,2,157,35,151,6,0,0,6,4,59,44,92,31,40.2,812.0
1635,be4890f4aaadec28,d05412b513b19621,c0386644627a7ee5,2021-08-28,0,0,0,900,0,0,109,21,106,3,0,0,3,2,52,45,54,19,21.0,831.8
1636,ad3aa9520131ff2e,5f61780fe5e9b6d0,ce175eaafe867d1f,2021-08-28,1,1,0,792,9,4,80,36,42,38,1,1,37,28,10,9,32,8,458.0,331.0
1637,ad3aa9520131ff2e,ce175eaafe867d1f,5f61780fe5e9b6d0,2021-08-28,0,0,0,792,0,0,52,14,49,3,0,0,3,3,18,17,31,11,3.0,331.0
1638,5cd1869013741767,64a50dad704d1d49,9560ff14eb3129f7,2021-08-28,0,0,0,704,0,0,95,15,95,0,0,0,0,0,25,18,70,15,0.0,663.0
1639,5cd1869013741767,9560ff14eb3129f7,64a50dad704d1d49,2021-08-28,2,2,0,704,0,0,117,31,113,4,0,0,4,4,37,29,76,27,41.0,663.0
1640,58d5e4afc2dd35d1,4dcfb28c011c11b2,d156513a19acf856,2021-08-28,0,0,0,900,9,2,119,36,119,0,0,0,0,0,42,33,77,36,0.0,726.0
1641,58d5e4afc2dd35d1,d156513a19acf856,4dcfb28c011c11b2,2021-08-28,0,0,0,900,0,0,122,55,122,0,0,0,0,0,17,13,105,55,0.0,786.0
1642,5086f9fb4fdc2f60,b12fb759e02378de,f626118b6da0e020,2021-08-28,0,0,0,435,6,2,76,33,62,14,0,0,14,12,14,12,48,21,60.5,270.7
1643,5086f9fb4fdc2f60,f626118b6da0e020,b12fb759e02378de,2021-08-28,0,1,1,435,1,1,87,17,86,1,0,0,1,1,33,29,53,16,4.3,292.5
1644,2cb9ba68fc855f33,2c483cf443f38ece,6fd953151d981979,2021-08-28,0,0,0,900,5,0,162,41,160,2,0,0,2,2,40,29,120,39,9.4,572.2
1645,2cb9ba68fc855f33,6fd953151d981979,2c483cf443f38ece,2021-08-28,0,0,0,900,2,1,134,75,100,34,0,0,34,23,20,18,80,52,214.8,631.6
1646,1de342e9309c5f0f,6ac9bc2953c47345,ea7e5bc78d9de658,2021-08-28,0,1,1,409,10,3,56,23,56,0,0,0,0,0,11,9,45,23,0.0,354.0
1647,1de342e9309c5f0f,ea7e5bc78d9de658,6ac9bc2953c47345,2021-08-28,0,0,0,409,0,0,99,27,99,0,0,0,0,0,18,13,81,27,0.0,393.0
1648,0f3a91caeaa55094,a17ad5a5048e8c3f,e4277e87a789d687,2021-08-28,0,0,0,184,2,2,33,11,33,0,0,0,0,0,7,7,26,11,0.0,138.4
1649,0f3a91caeaa55094,e4277e87a789d687,a17ad5a5048e8c3f,2021-08-28,1,0,0,184,1,0,61,33,60,1,0,0,1,1,8,4,52,32,2.6,161.0
1650,089a17e450cc98aa,8a1f3b5c526cd6e6,ee9ebceabfd16fa7,2021-08-28,0,0,0,900,0,0,210,87,202,8,0,0,8,7,35,33,167,80,45.0,641.0
1651,089a17e450cc98aa,ee9ebceabfd16fa7,8a1f3b5c526cd6e6,2021-08-28,0,0,0,900,7,3,160,39,157,3,1,0,2,1,25,17,132,38,214.0,641.0
1652,f536ba47f006474a,13a0275fa13c4d26,8c0580d4fff106c1,2021-08-21,1,0,0,1500,0,0,207,51,207,0,0,0,0,0,45,30,162,51,0.0,1498.0
1653,f536ba47f006474a,8c0580d4fff106c1,13a0275fa13c4d26,2021-08-21,0,0,0,1500,8,0,246,48,246,0,0,0,0,0,59,41,187,48,0.0,1349.0
1654,e1897ff433134cb8,50a28b9f8314e008,ec23c1be628d8057,2021-08-21,0,4,1,879,7,2,65,21,65,0,0,0,0,0,17,15,48,21,0.0,542.5
1655,e1897ff433134cb8,ec23c1be628d8057,50a28b9f8314e008,2021-08-21,0,0,0,879,8,1,31,6,26,5,0,0,5,2,8,6,18,4,269.5,340.0
1656,bfacb44c24bfe0e9,4bf6b225ff6099c4,7be14eaed4c74856,2021-08-21,0,0,0,900,0,0,11,2,10,1,0,0,1,1,3,1,7,1,44.5,42.0
1657,bfacb44c24bfe0e9,7be14eaed4c74856,4bf6b225ff6099c4,2021-08-21,0,2,0,900,3,3,40,24,3,37,3,3,34,24,2,1,1,0,769.0,86.5
1658,92d39a17e34cf581,68d35296f566792b,b60c980f79b87ce8,2021-08-21,1,0,0,294,0,0,129,26,129,0,0,0,0,0,40,26,89,26,0.0,289.0
1659,92d39a17e34cf581,b60c980f79b87ce8,68d35296f566792b,2021-08-21,0,0,0,294,0,0,82,13,82,0,0,0,0,0,29,22,53,13,0.0,294.0
1660,8badcb2134c1cdaf,37c5366d18ed6c05,e4a47b07044ddd72,2021-08-21,0,0,0,895,12,0,168,47,168,0,0,0,0,0,14,8,154,47,0.0,766.5
1661,8badcb2134c1cdaf,e4a47b07044ddd72,37c5366d18ed6c05,2021-08-21,1,0,0,895,0,0,228,41,225,3,3,2,0,0,80,62,145,41,24.5,797.0
1662,755d84d5f4aa4dbf,c77a953488e5607d,d2cd7a69cc55e7ed,2021-08-21,0,0,0,900,4,0,160,28,157,3,1,1,2,1,51,42,106,27,29.8,731.9
1663,755d84d5f4aa4dbf,d2cd7a69cc55e7ed,c77a953488e5607d,2021-08-21,0,0,0,900,7,4,152,29,151,1,0,0,1,1,42,27,109,28,19.1,736.2
1664,5e2ce5aa3a92c2df,5da33b8fbfa5ee95,78a68f1dade6aaf7,2021-08-21,1,0,0,238,0,0,24,5,21,3,0,0,3,3,11,9,10,2,2.0,236.0
1665,5e2ce5aa3a92c2df,78a68f1dade6aaf7,5da33b8fbfa5ee95,2021-08-21,0,0,0,238,0,0,23,3,23,0,0,0,0,0,12,12,11,3,0.0,236.0
1666,47a157222b2c9092,3d074044a33825e7,a6c20202c701e5ca,2021-08-21,0,1,1,153,2,2,2,1,2,0,0,0,0,0,0,0,2,1,0.0,21.0
1667,47a157222b2c9092,a6c20202c701e5ca,3d074044a33825e7,2021-08-21,0,0,0,153,0,0,1,1,1,0,0,0,0,0,0,0,1,1,0.0,153.0
1668,47230f9b5d7ae037,01b352b6a9074d5c,ac40f7e3cbecdda4,2021-08-21,0,0,0,900,0,0,249,69,249,0,0,0,0,0,50,48,199,69,0.0,882.6
1669,47230f9b5d7ae037,ac40f7e3cbecdda4,01b352b6a9074d5c,2021-08-21,0,0,0,900,8,1,278,116,277,1,0,0,1,1,35,33,242,115,17.4,761.0
1670,3a9e0fed344fd07d,c47df9303d318c67,da0995f19b749cfa,2021-08-21,0,0,0,900,0,0,212,30,212,0,0,0,0,0,51,42,161,30,0.0,900.0
1671,3a9e0fed344fd07d,da0995f19b749cfa,c47df9303d318c67,2021-08-21,0,0,0,900,1,0,192,70,192,0,0,0,0,0,33,28,159,70,0.0,846.0
1672,12d2b282561b5e5f,12e0fdc606f7e274,305d73ede05e31ad,2021-08-21,0,0,0,900,5,0,160,34,160,0,0,0,0,0,49,43,111,34,0.0,881.0
1673,12d2b282561b5e5f,305d73ede05e31ad,12e0fdc606f7e274,2021-08-21,1,0,0,900,0,0,181,45,181,0,0,0,0,0,38,28,143,45,0.0,809.0
1674,0b47788da6de735e,6e15f63b6c2e2c15,a0f0004aadf10b71,2021-08-21,0,0,0,406,1,1,61,12,60,1,0,0,1,0,8,5,52,12,8.0,398.0
1675,0b47788da6de735e,a0f0004aadf10b71,6e15f63b6c2e2c15,2021-08-21,0,2,1,406,6,3,40,19,40,0,0,0,0,0,3,3,37,19,0.0,227.0
1676,f2336b7545f5f442,c742287ed86a09bc,d7c3816669784109,2021-08-07,0,1,1,272,1,1,19,9,10,9,0,0,9,8,3,3,7,1,193.0,53.0
1677,f2336b7545f5f442,d7c3816669784109,c742287ed86a09bc,2021-08-07,0,0,0,272,1,1,12,3,7,5,3,3,2,1,2,2,5,2,26.0,53.0
1678,efe985e626a0d8c0,6d4b63c767106d3a,c58f51dedb310998,2021-08-07,0,1,1,205,0,0,12,2,12,0,0,0,0,0,5,5,7,2,0.0,195.0
1679,efe985e626a0d8c0,c58f51dedb310998,6d4b63c767106d3a,2021-08-07,0,2,0,205,1,1,12,4,12,0,0,0,0,0,0,0,12,4,0.0,144.0
1680,dcd0793ff1a43b68,06f36cf4bd97ec77,a495f599e787614f,2021-08-07,0,0,0,900,0,0,126,31,126,0,0,0,0,0,11,10,115,31,0.0,881.5
1681,dcd0793ff1a43b68,a495f599e787614f,06f36cf4bd97ec77,2021-08-07,0,0,0,900,1,1,140,75,128,12,0,0,12,10,18,18,110,65,17.5,852.0
1682,cce232c1b1b2e4a0,9dedfdd91070ddd8,a4a80dd7336ffd59,2021-08-07,0,0,0,600,3,0,91,14,88,3,0,0,3,2,33,29,55,12,63.0,443.0
1683,cce232c1b1b2e4a0,a4a80dd7336ffd59,9dedfdd91070ddd8,2021-08-07,1,0,0,600,5,1,121,42,120,1,0,0,1,1,38,28,82,41,10.0,427.0
1684,bf732e22055e8634,787bb1f087ccff8a,d3df1add9d9a7efb,2021-08-07,1,0,0,851,1,0,122,50,106,16,0,0,16,15,53,48,53,35,39.3,770.0
1685,bf732e22055e8634,d3df1add9d9a7efb,787bb1f087ccff8a,2021-08-07,0,0,0,851,1,0,37,8,37,0,0,0,0,0,13,8,24,8,0.0,803.7
1686,af9927b5589e708b,f0fad0e9f3b65752,f6bcbd91b114ff58,2021-08-07,0,0,0,455,0,0,37,4,37,0,0,0,0,0,6,3,31,4,0.0,372.3
1687,af9927b5589e708b,f6bcbd91b114ff58,f0fad0e9f3b65752,2021-08-07,0,3,1,455,3,2,71,6,69,2,0,0,2,1,10,8,59,5,82.7,331.0
1688,9a678f346946b6a4,46e0d677f91bacc0,bbc9ab95fa766493,2021-08-07,1,0,0,676,0,0,118,54,118,0,0,0,0,0,28,26,90,54,0.0,676.0
1689,9a678f346946b6a4,bbc9ab95fa766493,46e0d677f91bacc0,2021-08-07,0,0,0,676,5,0,164,24,164,0,0,0,0,0,15,8,149,24,0.0,667.0
1690,980927e7dcc131c0,6bd02119599741a4,d0f3959b4a9747e6,2021-08-07,0,0,0,900,0,0,179,35,179,0,0,0,0,0,48,40,131,35,0.0,890.0
1691,980927e7dcc131c0,d0f3959b4a9747e6,6bd02119599741a4,2021-08-07,0,0,0,900,0,0,223,74,223,0,0,0,0,0,55,40,168,74,0.0,900.0
1692,962aab0abdd34173,e7bba7ce4d6c7b07,efb96bf3e9ada36f,2021-08-07,0,0,0,900,5,1,190,45,190,0,0,0,0,0,50,33,140,45,0.0,874.0
1693,962aab0abdd34173,efb96bf3e9ada36f,e7bba7ce4d6c7b07,2021-08-07,0,0,0,900,3,0,257,66,257,0,0,0,0,0,60,50,197,66,0.0,880.0
1694,903d2c361d005b70,31ef8b67e13495b3,f0feeb2192937424,2021-08-07,0,0,0,900,6,1,298,80,296,2,0,0,2,1,81,64,215,79,1.3,875.7
1695,903d2c361d005b70,f0feeb2192937424,31ef8b67e13495b3,2021-08-07,0,0,0,900,7,2,188,64,186,2,0,0,2,1,47,32,139,63,8.3,782.7
1696,85c5dd604d5b3634,5d1b7e3dd9e11074,6d68c1afe954f121,2021-08-07,1,0,0,284,0,0,29,14,25,4,0,0,4,3,6,5,19,11,2.0,282.0
1697,85c5dd604d5b3634,6d68c1afe954f121,5d1b7e3dd9e11074,2021-08-07,0,0,0,284,0,0,38,9,38,0,0,0,0,0,13,9,25,9,0.0,282.0
1698,76ece0ee2ef5d240,887961364be5ceb3,c814b4c899793af6,2021-08-07,0,0,0,900,2,0,263,93,263,0,0,0,0,0,66,50,197,93,0.0,900.0
1699,76ece0ee2ef5d240,c814b4c899793af6,887961364be5ceb3,2021-08-07,0,0,0,900,0,0,223,47,223,0,0,0,0,0,91,57,132,47,0.0,892.0
1700,3d75081ce43774ca,37098a6e6c27fb66,dc3b9cf7641b7ab6,2021-08-07,0,0,0,900,4,1,196,46,195,1,0,0,1,0,46,30,149,46,3.1,850.8
1701,3d75081ce43774ca,dc3b9cf7641b7ab6,37098a6e6c27fb66,2021-08-07,0,0,0,900,5,3,151,45,150,1,0,0,1,1,13,10,137,44,9.2,822.9
1702,fb9095887dca34c7,2c010b26a3306969,8e382b585a92affe,2021-07-31,0,0,0,561,6,2,52,17,49,3,0,0,3,3,7,5,42,14,147.8,167.0
1703,fb9095887dca34c7,8e382b585a92affe,2c010b26a3306969,2021-07-31,1,0,0,561,0,0,93,32,93,0,0,0,0,0,17,14,76,32,0.0,401.2
1704,e3ecb94228c2739f,62f7097c04311193,c730a0be691dc081,2021-07-31,0,0,0,68,0,0,13,4,13,0,0,0,0,0,3,3,10,4,0.0,47.0
1705,e3ecb94228c2739f,c730a0be691dc081,62f7097c04311193,2021-07-31,1,0,0,68,1,1,23,11,21,2,0,0,2,1,6,3,15,10,21.0,47.0
1706,b4622ca7cf0e8506,4959f10a62f3fec3,5dd180c8b3196786,2021-07-31,1,0,0,60,1,1,16,11,8,8,0,0,8,7,1,0,7,4,34.0,26.0
1707,b4622ca7cf0e8506,5dd180c8b3196786,4959f10a62f3fec3,2021-07-31,0,0,0,60,0,0,8,5,8,0,0,0,0,0,0,0,8,5,0.0,26.0
1708,9eef9b7967991296,5f3805dda9661cba,a331233f597090a5,2021-07-31,1,1,0,900,18,8,83,27,77,6,0,0,6,4,12,8,65,23,126.8,535.1
1709,9eef9b7967991296,a331233f597090a5,5f3805dda9661cba,2021-07-31,0,0,0,900,1,0,113,50,105,8,0,0,8,6,3,0,102,44,26.9,726.2
1710,96c51bc6316a4b47,b4c6c904a9ffc5e8,d05cb1e8d1b885d8,2021-07-31,0,0,0,900,8,0,236,59,236,0,0,0,0,0,48,32,188,59,0.0,858.8
1711,96c51bc6316a4b47,d05cb1e8d1b885d8,b4c6c904a9ffc5e8,2021-07-31,0,0,0,900,1,0,185,46,184,1,1,1,0,0,55,41,129,46,0.2,898.0
1712,8522bc62e8d942ab,0d8011111be000b2,65578a75fa7900e3,2021-07-31,0,0,0,1500,6,4,428,173,412,16,0,0,16,8,14,13,398,165,241.1,1078.0
1713,8522bc62e8d942ab,65578a75fa7900e3,0d8011111be000b2,2021-07-31,0,0,0,1500,0,0,258,56,258,0,0,0,0,0,85,51,173,56,0.0,1258.9
1714,69397bbebdfa41d9,0de720c0f1d4ab9c,eee0ef3e2b14816b,2021-07-31,0,0,0,900,5,1,110,25,107,3,0,0,3,3,29,16,78,22,5.5,865.0
1715,69397bbebdfa41d9,eee0ef3e2b14816b,0de720c0f1d4ab9c,2021-07-31,0,0,0,900,3,0,77,9,77,0,0,0,0,0,49,39,28,9,0.0,681.5
1716,6671b567c4eb9982,047a91d3d9c79b05,a52bc1e62cf0b7c6,2021-07-31,0,0,0,410,1,1,51,14,51,0,0,0,0,0,17,11,34,14,0.0,375.6
1717,6671b567c4eb9982,a52bc1e62cf0b7c6,047a91d3d9c79b05,2021-07-31,1,0,0,410,0,0,75,28,72,3,0,0,3,2,23,16,49,26,16.4,339.0
1718,1978b44503c3d9ff,20999e27ddd94bda,79cb2a690b9ba5e8,2021-07-31,1,0,0,900,1,0,129,32,125,4,1,1,3,3,10,4,115,29,79.0,791.0
1719,1978b44503c3d9ff,79cb2a690b9ba5e8,20999e27ddd94bda,2021-07-31,0,1,0,900,4,0,143,50,139,4,4,2,0,0,31,26,108,50,30.0,776.0
1720,12ceec9431fb0827,e132d47bd9efbbe0,feaf00f3373435d6,2021-07-31,0,1,0,900,12,5,146,58,141,5,1,1,4,2,16,13,125,56,87.7,514.0
1721,12ceec9431fb0827,feaf00f3373435d6,e132d47bd9efbbe0,2021-07-31,0,0,0,900,1,0,190,60,190,0,0,0,0,0,43,40,147,60,0.0,809.3
1722,dff1dbb8fe1f31cb,2e585c701f72fe55,881bf86d4cba8578,2021-07-24,0,0,0,489,3,0,52,4,52,0,0,0,0,0,27,20,25,4,0.0,372.8
1723,dff1dbb8fe1f31cb,881bf86d4cba8578,2e585c701f72fe55,2021-07-24,1,0,0,489,1,1,96,32,78,18,0,0,18,4,14,7,64,28,53.2,418.0
1724,cade0268dec56f3d,1291edf2d566a71a,5f6f049d54728e88,2021-07-24,1,0,0,525,0,0,113,27,113,0,0,0,0,0,25,15,88,27,0.0,501.0
1725,cade0268dec56f3d,5f6f049d54728e88,1291edf2d566a71a,2021-07-24,0,0,0,525,0,0,97,10,97,0,0,0,0,0,34,21,63,10,0.0,525.0
1726,c13474b85d3ced32,4234f0097c83fa62,ac7c765882f2c68c,2021-07-24,1,0,0,229,2,1,40,22,6,34,1,0,33,19,2,0,4,3,221.0,8.0
1727,c13474b85d3ced32,ac7c765882f2c68c,4234f0097c83fa62,2021-07-24,0,0,0,229,0,0,4,1,4,0,0,0,0,0,2,0,2,1,0.0,8.0
1728,7c3ad06a520b8716,6a740daf1b279661,f29a6350c69f4a33,2021-07-24,0,0,0,900,6,1,111,30,111,0,0,0,0,0,12,6,99,30,0.0,754.0
1729,7c3ad06a520b8716,f29a6350c69f4a33,6a740daf1b279661,2021-07-24,0,0,0,900,1,1,143,21,143,0,0,0,0,0,36,26,107,21,0.0,819.0
1730,4bb77b1d8efc53a9,60425d07ef4b91a7,82b4e942781b1046,2021-07-24,1,0,0,900,9,4,132,62,104,28,1,1,27,22,16,11,88,40,137.7,647.3
1731,4bb77b1d8efc53a9,82b4e942781b1046,60425d07ef4b91a7,2021-07-24,0,0,0,900,6,2,117,37,112,5,1,1,4,2,20,13,92,35,70.7,550.3
1732,4911094a4ee26868,2f181c0467965b98,64facb6cc564262d,2021-07-24,0,0,0,900,1,0,211,47,211,0,0,0,0,0,57,47,154,47,0.0,900.0
1733,4911094a4ee26868,64facb6cc564262d,2f181c0467965b98,2021-07-24,0,0,0,900,0,0,149,46,149,0,0,0,0,0,30,20,119,46,0.0,879.0
1734,43c391b251337c9b,0232cabbc30a2372,325ad0dd9126d3df,2021-07-24,1,0,0,431,0,0,184,41,172,12,0,0,12,6,38,23,134,35,4.0,427.0
1735,43c391b251337c9b,325ad0dd9126d3df,0232cabbc30a2372,2021-07-24,0,0,0,431,0,0,153,61,153,0,0,0,0,0,9,8,144,61,0.0,427.0
1736,40ce202eaa78860c,26e3f3928b1891d9,d7e40dca3ae125be,2021-07-24,0,0,0,900,6,2,182,56,163,19,0,0,19,16,45,36,118,40,144.3,580.1
1737,40ce202eaa78860c,d7e40dca3ae125be,26e3f3928b1891d9,2021-07-24,1,0,0,900,0,0,211,68,207,4,0,0,4,2,59,49,148,66,0.9,749.7
1738,214b268e4a92f950,65f09bacd3957381,c849740a3ff51931,2021-07-24,0,1,0,1500,1,0,281,110,280,1,0,0,1,0,23,18,257,110,0.0,1303.6
1739,214b268e4a92f950,c849740a3ff51931,65f09bacd3957381,2021-07-24,0,0,0,1500,19,2,268,59,259,9,0,0,9,4,60,51,199,55,196.4,998.0
1740,1be65a0d2c1383f6,9e50097a89442158,e26bd53b751d61d9,2021-07-24,0,2,1,177,2,1,20,9,20,0,0,0,0,0,3,2,17,9,0.0,119.0
1741,1be65a0d2c1383f6,e26bd53b751d61d9,9e50097a89442158,2021-07-24,0,0,0,177,1,1,35,7,35,0,0,0,0,0,6,6,29,7,0.0,173.0
1742,1bde9cb65d31cc76,34e516ab361afb1c,92a9aa9c93192871,2021-07-24,0,3,0,528,2,2,35,14,20,15,0,0,15,10,8,5,12,4,191.6,86.9
1743,1bde9cb65d31cc76,92a9aa9c93192871,34e516ab361afb1c,2021-07-24,1,0,0,528,2,1,30,18,7,23,0,0,23,16,2,2,5,2,160.1,155.4
1744,f0b83b05f3dd9580,b96619b3acd7d9da,c7d297714d9ab1a4,2021-07-17,1,0,0,713,6,3,120,44,82,38,6,6,32,19,21,15,61,25,290.8,361.0
1745,f0b83b05f3dd9580,c7d297714d9ab1a4,b96619b3acd7d9da,2021-07-17,0,0,0,713,0,0,64,16,58,6,0,0,6,3,10,9,48,13,0.0,422.2
1746,c5e71fbf22f669f7,1235b31de15d0c6e,3df5493bb279226f,2021-07-17,0,0,0,35,0,0,7,2,7,0,0,0,0,0,1,1,6,2,0.0,31.0
1747,c5e71fbf22f669f7,3df5493bb279226f,1235b31de15d0c6e,2021-07-17,1,0,0,35,0,0,13,6,12,1,0,0,1,1,2,1,10,5,4.0,31.0
1748,940701effe1d2b6c,436f970c9ea9169c,aa171d55d4b5208f,2021-07-17,1,1,0,820,0,0,110,38,98,12,0,0,12,7,21,19,77,31,28.6,377.3
1749,940701effe1d2b6c,aa171d55d4b5208f,436f970c9ea9169c,2021-07-17,1,1,0,820,7,3,156,73,119,37,3,3,34,25,27,24,92,48,392.7,271.4
1750,93d5452726f5f364,2f6a993c7f547c13,b4537562f88ac582,2021-07-17,0,0,0,900,16,6,103,45,88,15,1,1,14,10,8,4,80,35,350.5,386.0
1751,93d5452726f5f364,b4537562f88ac582,2f6a993c7f547c13,2021-07-17,0,0,0,900,1,0,123,9,122,1,0,0,1,0,41,24,81,9,0.0,549.5
1752,8151659b2bc16f0e,8a1f3b5c526cd6e6,9fe7af8b3fbe00a0,2021-07-17,1,0,0,227,0,0,83,36,71,12,0,0,12,6,11,9,60,30,7.7,218.0
1753,8151659b2bc16f0e,9fe7af8b3fbe00a0,8a1f3b5c526cd6e6,2021-07-17,0,0,0,227,4,0,43,14,43,0,0,0,0,0,10,9,33,14,0.0,204.3
1754,813444e109995c97,260e9e0d4954aea6,71505842fb6455c3,2021-07-17,0,1,1,714,4,3,88,42,88,0,0,0,0,0,7,7,81,42,0.0,580.4
1755,813444e109995c97,71505842fb6455c3,260e9e0d4954aea6,2021-07-17,0,0,0,714,3,0,192,53,190,2,0,0,2,1,22,14,168,52,3.6,705.0
1756,7d4c160dab6eae73,275aca31f61ba28c,d945aae53e3e54e6,2021-07-17,0,1,1,1058,6,3,92,28,72,20,0,0,20,12,36,33,36,16,192.5,485.4
1757,7d4c160dab6eae73,d945aae53e3e54e6,275aca31f61ba28c,2021-07-17,0,1,0,1058,2,1,44,6,42,2,0,0,2,1,14,7,28,5,81.6,661.5
1758,7d0874323bd1f768,c9a94278df042f46,d31a5546c0e9b213,2021-07-17,0,0,0,389,0,0,91,45,84,7,0,0,7,5,18,15,66,40,9.9,351.0
1759,7d0874323bd1f768,d31a5546c0e9b213,c9a94278df042f46,2021-07-17,1,0,0,389,3,0,83,41,83,0,0,0,0,0,8,8,75,41,0.0,220.1
1760,72105dd82d964e7a,18968f97ad34f15c,72db2a14ffa73ece,2021-07-17,0,0,0,65,0,0,0,0,0,0,0,0,0,0,0,0,0,0,0.0,62.0
1761,72105dd82d964e7a,72db2a14ffa73ece,18968f97ad34f15c,2021-07-17,0,1,1,65,2,1,1,1,1,0,0,0,0,0,0,0,1,1,0.0,19.0
1762,49876b12d440af40,cdadae5363b66eef,dee294e9717012c2,2021-07-17,0,0,0,900,2,2,45,16,37,8,1,1,7,5,14,11,23,11,156.9,368.2
1763,49876b12d440af40,dee294e9717012c2,cdadae5363b66eef,2021-07-17,0,0,0,900,11,2,84,40,61,23,2,2,21,17,4,4,57,23,276.8,382.1
1764,dbcc5b5d568efa8b,9c27f3217891f3f0,b50a426a33da0012,2021-07-10,0,0,0,873,0,0,218,39,218,0,0,0,0,0,50,31,168,39,0.0,863.0
1765,dbcc5b5d568efa8b,b50a426a33da0012,9c27f3217891f3f0,2021-07-10,1,0,0,873,0,0,318,177,317,1,0,0,1,0,63,53,254,177,1.0,869.0
1766,ac0a1d87e9ff4085,55fa6ce3e522c8bb,c9587d81e1d33925,2021-07-10,0,1,1,122,0,0,24,4,24,0,0,0,0,0,9,6,15,4,0.0,110.0
1767,ac0a1d87e9ff4085,c9587d81e1d33925,55fa6ce3e522c8bb,2021-07-10,0,0,0,122,1,0,40,2,40,0,0,0,0,0,13,9,27,2,0.0,122.0
1768,96bbb6c573dac27a,595db60957de51d3,d8da10db80131bec,2021-07-10,0,2,0,900,6,3,154,52,136,18,1,1,17,9,47,39,89,43,79.1,709.7
1769,96bbb6c573dac27a,d8da10db80131bec,595db60957de51d3,2021-07-10,0,1,0,900,2,0,180,40,177,3,1,0,2,2,49,36,128,38,23.3,688.9
1770,858feabaf429a963,0d7b51c9d2649a6e,b27a1fcb56a3035a,2021-07-10,1,0,0,401,4,2,48,7,43,5,0,0,5,3,25,18,18,4,94.0,307.0
1771,858feabaf429a963,b27a1fcb56a3035a,0d7b51c9d2649a6e,2021-07-10,0,0,0,401,0,0,32,6,32,0,0,0,0,0,6,4,26,6,0.0,295.0
1772,8245791a3d3403c6,23024fdfc966410a,4a28cb716c19157a,2021-07-10,0,0,0,900,6,3,43,17,30,13,1,1,12,12,13,11,17,5,433.0,467.0
1773,8245791a3d3403c6,4a28cb716c19157a,23024fdfc966410a,2021-07-10,0,0,0,900,0,0,53,14,53,0,0,0,0,0,9,5,44,14,0.0,467.0
1774,7d0ce28ce8a77eb1,029eaff01e6bb8f0,f4c49976c75c5ab2,2021-07-10,1,0,0,300,2,1,66,35,20,46,0,0,46,28,4,1,16,7,198.0,102.0
1775,7d0ce28ce8a77eb1,f4c49976c75c5ab2,029eaff01e6bb8f0,2021-07-10,0,1,0,300,0,0,38,13,27,11,0,0,11,9,17,14,10,4,0.0,102.0
1776,7070abfa26c079b8,b0d6a1d8ac3d563d,f9f07bb5a43535ed,2021-07-10,1,0,0,900,1,1,171,59,155,16,0,0,16,10,42,34,113,49,63.1,829.0
1777,7070abfa26c079b8,f9f07bb5a43535ed,b0d6a1d8ac3d563d,2021-07-10,0,0,0,900,4,0,176,35,176,0,0,0,0,0,42,28,134,35,0.0,836.9
1778,5d5bf07dbfada0e3,8e1f36476ef02a6a,f72465a784c1b084,2021-07-10,0,0,0,900,0,0,265,71,265,0,0,0,0,0,33,27,232,71,0.0,858.7
1779,5d5bf07dbfada0e3,f72465a784c1b084,8e1f36476ef02a6a,2021-07-10,0,0,0,900,3,2,276,56,274,2,1,1,1,1,51,43,223,55,37.3,844.0
1780,53b480b44b0b51f1,85073dbd1be65ed9,c62fbc117d57b943,2021-07-10,0,0,0,67,0,0,15,5,15,0,0,0,0,0,1,1,14,5,0.0,61.0
1781,53b480b44b0b51f1,c62fbc117d57b943,85073dbd1be65ed9,2021-07-10,1,0,0,67,0,0,23,5,20,3,0,0,3,2,8,6,12,3,6.0,61.0
1782,3740c8033e31c90d,3143bf892608139a,578ef12674df1e6a,2021-07-10,0,0,0,275,0,0,49,8,49,0,0,0,0,0,21,16,28,8,0.0,189.1
1783,3740c8033e31c90d,578ef12674df1e6a,3143bf892608139a,2021-07-10,1,0,0,275,0,0,66,28,33,33,1,1,32,20,12,8,21,8,74.9,191.0
1784,1aba46988c9b58f9,0c6d9ea8306c029e,16690d100f995f8f,2021-07-10,1,0,0,900,0,0,150,48,149,1,1,1,0,0,46,35,103,48,1.5,891.0
1785,1aba46988c9b58f9,16690d100f995f8f,0c6d9ea8306c029e,2021-07-10,0,0,0,900,9,2,166,37,166,0,0,0,0,0,15,11,151,37,0.0,796.5
1786,07468b6347ac5e3d,54f64b5e283b0ce7,8866c6f509c19089,2021-07-10,1,0,0,287,0,0,32,11,8,24,6,5,18,10,2,2,6,1,80.0,207.0
1787,07468b6347ac5e3d,8866c6f509c19089,54f64b5e283b0ce7,2021-07-10,0,0,0,287,3,0,17,2,16,1,1,1,0,0,9,7,7,2,0.0,207.0
1788,d988760df61f027c,6370c1c1e12723d5,f9d0cae37dabfafc,2021-06-26,1,0,0,356,0,0,92,23,92,0,0,0,0,0,40,36,52,23,0.0,353.8
1789,d988760df61f027c,f9d0cae37dabfafc,6370c1c1e12723d5,2021-06-26,0,0,0,356,1,1,79,29,72,7,0,0,7,3,6,5,66,26,2.2,351.0
1790,d40eae4425092219,04c8b08b16a5b99e,50db8711c70196cd,2021-06-26,1,0,0,451,0,0,72,10,70,2,0,0,2,1,28,23,42,9,10.7,435.0
1791,d40eae4425092219,50db8711c70196cd,04c8b08b16a5b99e,2021-06-26,0,0,0,451,5,1,21,2,21,0,0,0,0,0,8,7,13,2,0.0,368.3
1792,ce0fda34122f3d48,45e738622ea2c02c,b9f28e7045fdfce7,2021-06-26,0,0,0,900,6,0,190,38,190,0,0,0,0,0,53,39,137,38,0.0,779.4
1793,ce0fda34122f3d48,b9f28e7045fdfce7,45e738622ea2c02c,2021-06-26,2,0,0,900,0,0,131,50,113,18,0,0,18,15,21,19,92,35,78.6,817.0
1794,c9283da5f4d7aaf4,4b47e71384a9522f,9d19d9e4aa2662e8,2021-06-26,0,0,0,900,4,1,93,20,89,4,3,3,1,1,35,30,54,19,84.0,417.0
1795,c9283da5f4d7aaf4,9d19d9e4aa2662e8,4b47e71384a9522f,2021-06-26,0,0,0,900,4,0,116,37,116,0,0,0,0,0,23,17,93,37,0.0,725.0
1796,85099c6378ff87c5,687c15b2eddfaa63,8667caa0451d245b,2021-06-26,0,0,0,620,12,2,18,6,18,0,0,0,0,0,5,4,13,6,0.0,158.0
1797,85099c6378ff87c5,8667caa0451d245b,687c15b2eddfaa63,2021-06-26,1,0,0,620,0,0,80,28,80,0,0,0,0,0,4,3,76,28,0.0,620.0
1798,81de3929330076d2,d317a5e2b3f88c5f,d66a46de8d705353,2021-06-26,0,1,0,330,1,0,17,1,14,3,3,3,0,0,12,11,2,1,13.2,96.0
1799,81de3929330076d2,d66a46de8d705353,d317a5e2b3f88c5f,2021-06-26,1,0,0,330,3,0,52,17,36,16,0,0,16,9,4,4,32,8,212.0,104.8
1800,78afed76d0e9a639,279566840aa55bf2,787bb1f087ccff8a,2021-06-26,0,0,0,1500,0,0,241,41,241,0,0,0,0,0,93,74,148,41,0.0,1500.0
1801,78afed76d0e9a639,787bb1f087ccff8a,279566840aa55bf2,2021-06-26,0,0,0,1500,4,0,255,60,255,0,0,0,0,0,97,75,158,60,0.0,1481.0
1802,5357dab4d331eb18,304a21d0595e1a08,40093d1d2d78394e,2021-06-26,0,2,0,900,2,2,92,32,91,1,0,0,1,0,13,12,78,32,57.7,510.0
1803,5357dab4d331eb18,40093d1d2d78394e,304a21d0595e1a08,2021-06-26,0,2,0,900,2,2,182,33,173,9,0,0,9,4,26,18,147,29,217.0,625.3
1804,4622ec182e7fed6b,361d49960a196976,8fd808923cffff82,2021-06-26,0,0,0,346,7,0,34,7,34,0,0,0,0,0,9,8,25,7,0.0,214.2
1805,4622ec182e7fed6b,8fd808923cffff82,361d49960a196976,2021-06-26,0,0,0,346,1,1,67,29,61,6,0,0,6,4,6,5,55,25,33.8,301.0
1806,4341ebb5a56e6943,4c88a1db5a46c6a4,b6452706b373eea1,2021-06-26,0,0,0,574,0,0,25,4,25,0,0,0,0,0,4,3,21,4,0.0,111.0
1807,4341ebb5a56e6943,b6452706b373eea1,4c88a1db5a46c6a4,2021-06-26,0,1,1,574,7,5,41,24,7,34,1,1,33,22,1,1,6,2,455.0,119.0
1808,23c7c6ceee34585f,38c626ca912c7bac,813550bc53b15fb0,2021-06-26,0,0,0,900,3,2,237,101,237,0,0,0,0,0,22,20,215,101,0.0,702.6
1809,23c7c6ceee34585f,813550bc53b15fb0,38c626ca912c7bac,2021-06-26,0,2,0,900,2,2,219,68,211,8,1,1,7,6,48,34,163,62,83.4,681.0
1810,0eac7075bf3d7ab7,86d9dbe1bfcbade7,a78a87d8c2bbb1cb,2021-06-26,0,1,1,859,4,1,91,31,87,4,3,3,1,1,16,14,71,30,120.6,612.7
1811,0eac7075bf3d7ab7,a78a87d8c2bbb1cb,86d9dbe1bfcbade7,2021-06-26,0,0,0,859,3,1,94,27,93,1,0,0,1,0,21,13,72,27,35.3,526.4
1812,086c2a0cae0835c4,01afe0916a40c7c5,e51fcd9cd84c0b93,2021-06-26,0,1,1,430,1,1,35,15,24,11,1,1,10,6,8,5,16,9,150.3,225.0
1813,086c2a0cae0835c4,e51fcd9cd84c0b93,01afe0916a40c7c5,2021-06-26,0,0,0,430,3,0,14,1,14,0,0,0,0,0,8,5,6,1,0.0,221.7
1814,e8fd128286788a6d,2c5a0b8317f8f27a,b5da8f7d05e85a55,2021-06-19,0,1,0,900,0,0,114,48,114,0,0,0,0,0,16,16,98,48,0.0,641.0
1815,e8fd128286788a6d,b5da8f7d05e85a55,2c5a0b8317f8f27a,2021-06-19,0,0,0,900,7,1,160,43,160,0,0,0,0,0,42,36,118,43,0.0,637.0
1816,d684d8b02ab53031,04835018f90b118c,e99821959a840bb8,2021-06-19,0,2,1,774,2,1,129,41,106,23,4,4,19,15,28,26,78,26,224.7,421.4
1817,d684d8b02ab53031,e99821959a840bb8,04835018f90b118c,2021-06-19,0,0,0,774,5,2,65,17,64,1,1,1,0,0,24,23,40,17,10.6,379.3
1818,d3c0dfa57950aefd,902ec2cc48c8ae8a,a68575214ecad140,2021-06-19,0,0,0,97,0,0,20,5,20,0,0,0,0,0,6,5,14,5,0.0,94.0
1819,d3c0dfa57950aefd,a68575214ecad140,902ec2cc48c8ae8a,2021-06-19,1,0,0,97,0,0,29,10,22,7,1,1,6,5,3,2,19,5,3.0,94.0
1820,bb1ac382e0277b3f,12ebd7d157e91701,4dcfb28c011c11b2,2021-06-19,1,0,0,285,2,0,26,18,2,24,1,1,23,18,1,0,1,0,94.1,187.0
1821,bb1ac382e0277b3f,4dcfb28c011c11b2,12ebd7d157e91701,2021-06-19,0,0,0,285,10,0,1,0,1,0,0,0,0,0,1,1,0,0,0.0,18.900000000000006
1822,a83ebbf013905949,113df4fde64735c6,7c7332319c14094c,2021-06-19,0,0,0,900,2,1,168,39,161,7,0,0,7,6,54,44,107,33,66.5,595.8
1823,a83ebbf013905949,7c7332319c14094c,113df4fde64735c6,2021-06-19,0,3,0,900,2,2,162,62,130,32,5,5,27,20,44,38,86,42,190.2,518.5
1824,87c8e086c29ae543,2558ae2e5671e318,4aa58269d0664b5b,2021-06-19,0,0,0,900,0,0,260,44,260,0,0,0,0,0,65,47,195,44,0.0,787.0
1825,87c8e086c29ae543,4aa58269d0664b5b,2558ae2e5671e318,2021-06-19,0,0,0,900,0,0,141,42,141,0,0,0,0,0,25,22,116,42,0.0,898.0
1826,744627aec853874e,8c57c7b8c3bab0eb,c2a670b22d2e196f,2021-06-19,0,0,0,900,5,1,193,65,193,0,0,0,0,0,11,6,182,65,0.0,608.0
1827,744627aec853874e,c2a670b22d2e196f,8c57c7b8c3bab0eb,2021-06-19,0,0,0,900,2,0,148,68,148,0,0,0,0,0,38,34,110,68,0.0,900.0
1828,6fd9a013cea5a403,98c23cb6da5b3352,e2f6b2769aaedd6c,2021-06-19,0,1,0,900,2,1,121,33,116,5,0,0,5,3,29,26,87,30,95.9,495.0
1829,6fd9a013cea5a403,e2f6b2769aaedd6c,98c23cb6da5b3352,2021-06-19,0,0,0,900,0,0,136,67,120,16,0,0,16,12,4,4,116,55,194.0,513.1
1830,53ed3f8f653b37b2,7dda2cf308f24a02,e0b0cf71e0d69dd0,2021-06-19,1,1,0,600,0,0,80,32,80,0,0,0,0,0,7,4,73,32,0.0,438.5
1831,53ed3f8f653b37b2,e0b0cf71e0d69dd0,7dda2cf308f24a02,2021-06-19,0,0,0,600,1,0,44,15,35,9,0,0,9,8,11,8,24,7,115.5,446.0
1832,50cae63d530ede7c,82a5152216251682,c451d67c09c55418,2021-06-19,0,0,0,1500,4,0,168,46,164,4,0,0,4,2,38,34,126,44,30.1,929.5
1833,50cae63d530ede7c,c451d67c09c55418,82a5152216251682,2021-06-19,0,3,0,1500,5,3,166,78,154,12,1,1,11,8,14,13,140,70,457.5,859.9
1834,2bdf774dc8b17504,31123249b0bbf52e,e9213f53ddeca978,2021-06-19,1,0,0,482,0,0,49,12,49,0,0,0,0,0,22,15,27,12,0.0,482.0
1835,2bdf774dc8b17504,e9213f53ddeca978,31123249b0bbf52e,2021-06-19,0,0,0,482,4,0,54,8,54,0,0,0,0,0,16,15,38,8,0.0,430.0
1836,1e9f081a84e7ec18,814ff3018127e8fc,ae7fe94f117f98cf,2021-06-19,2,0,0,37,0,0,17,9,7,10,0,0,10,6,1,1,6,3,6.2,29.0
1837,1e9f081a84e7ec18,ae7fe94f117f98cf,814ff3018127e8fc,2021-06-19,0,0,0,37,0,0,2,1,2,0,0,0,0,0,0,0,2,1,0.0,30.8
1838,dedb74ee9d84deab,1e4f273069fb9e85,2f1a257d6777096d,2021-06-12,0,0,0,900,0,0,121,24,121,0,0,0,0,0,15,15,106,24,0.0,758.2
1839,dedb74ee9d84deab,2f1a257d6777096d,1e4f273069fb9e85,2021-06-12,0,0,0,900,6,1,95,19,86,9,0,0,9,5,22,15,64,14,141.8,711.0
1840,d66164d2c770da68,2c9d00968f818270,76e2870ffafbe38f,2021-06-12,0,0,0,900,1,0,92,26,92,0,0,0,0,0,22,13,70,26,0.0,527.3
1841,d66164d2c770da68,76e2870ffafbe38f,2c9d00968f818270,2021-06-12,0,2,0,900,13,9,90,37,72,18,0,0,18,16,7,5,65,21,356.7,365.0
1842,d4ad90ac58429b64,809bd1a871491508,dccb63727f2f5f74,2021-06-12,1,0,0,7,0,0,5,4,2,3,0,0,3,2,0,0,2,2,0.0,7.0
1843,d4ad90ac58429b64,dccb63727f2f5f74,809bd1a871491508,2021-06-12,0,0,0,7,0,0,0,0,0,0,0,0,0,0,0,0,0,0,0.0,7.0
1844,b070b8c2c489d838,8355922d564b152c,f1fac969a1d70b08,2021-06-12,0,0,0,1500,0,0,162,52,162,0,0,0,0,0,33,24,129,52,0.0,1216.1
1845,b070b8c2c489d838,f1fac969a1d70b08,8355922d564b152c,2021-06-12,0,0,0,1500,5,4,132,48,124,8,0,0,8,5,35,29,89,43,170.9,1201.0
1846,9127a6430e46292c,a17ad5a5048e8c3f,cad24459b28592ca,2021-06-12,0,0,0,900,4,2,58,8,57,1,0,0,1,0,30,25,27,8,9.6,504.7
1847,9127a6430e46292c,cad24459b28592ca,a17ad5a5048e8c3f,2021-06-12,0,0,0,900,4,0,74,36,50,24,0,0,24,18,13,8,37,18,260.3,391.4
1848,84cde29aebf6c00c,971246648e162f0d,b93c06d09d1c4ac0,2021-06-12,0,2,0,900,8,3,61,21,55,6,0,0,6,3,10,10,45,18,175.0,324.9
1849,84cde29aebf6c00c,b93c06d09d1c4ac0,971246648e162f0d,2021-06-12,0,2,0,900,1,1,68,38,42,26,0,0,26,25,12,11,30,13,400.1,248.0
1850,7d2051c6bae907cb,37ed1ab2f8b819f4,519e4fe37ce9ff75,2021-06-12,0,0,0,900,11,5,137,66,130,7,0,0,7,6,37,23,93,60,87.5,703.6
1851,7d2051c6bae907cb,519e4fe37ce9ff75,37ed1ab2f8b819f4,2021-06-12,0,0,0,900,5,1,168,52,163,5,1,1,4,3,23,20,140,49,46.4,747.5
1852,6cd44e1b2d093ea4,1338e2c7480bdf9e,7acbb0972e75281a,2021-06-12,0,0,0,1500,0,0,181,44,179,2,0,0,2,1,63,52,116,43,5.5,1464.0
1853,6cd44e1b2d093ea4,7acbb0972e75281a,1338e2c7480bdf9e,2021-06-12,0,0,0,1500,14,4,176,42,176,0,0,0,0,0,18,16,158,42,0.0,1079.5
1854,4560734220b96851,5444c5a201d3ee5a,eabf206b162b3b83,2021-06-12,0,0,0,119,0,0,8,0,8,0,0,0,0,0,4,1,4,0,0.0,63.0
1855,4560734220b96851,eabf206b162b3b83,5444c5a201d3ee5a,2021-06-12,1,3,0,119,1,0,25,18,7,18,0,0,18,17,5,5,2,1,3.0,116.0
1856,43dfb2c1e5fecac9,427b5953ac8e3a27,b1b0729d27936f2f,2021-06-12,0,0,0,900,21,1,53,21,53,0,0,0,0,0,0,0,53,21,0.0,646.0
1857,43dfb2c1e5fecac9,b1b0729d27936f2f,427b5953ac8e3a27,2021-06-12,0,0,0,900,0,0,127,38,127,0,0,0,0,0,8,7,119,38,0.0,900.0
1858,34d38d77c1d3f00e,4c2d90e335e6df19,91dac5e69e28d5b5,2021-06-12,0,0,0,900,1,1,251,95,248,3,0,0,3,0,40,37,208,95,1.5,894.0
1859,34d38d77c1d3f00e,91dac5e69e28d5b5,4c2d90e335e6df19,2021-06-12,0,0,0,900,0,0,249,99,249,0,0,0,0,0,39,25,210,99,0.0,893.5
1860,34cb6e9952cd30a4,12f91bfa8f1f723b,729d4bd5a6cd0a97,2021-06-12,0,0,0,900,0,0,228,62,226,2,0,0,2,1,91,61,135,61,0.4,731.8
1861,34cb6e9952cd30a4,729d4bd5a6cd0a97,12f91bfa8f1f723b,2021-06-12,0,0,0,900,6,1,148,66,132,16,2,2,14,13,15,12,117,53,162.2,605.6
1862,1b4d5dbf5f663a97,92fa1401b7927da3,a2ea77e974c5889f,2021-06-12,0,0,0,900,1,0,281,86,281,0,0,0,0,0,52,44,229,86,0.0,900.0
1863,1b4d5dbf5f663a97,a2ea77e974c5889f,92fa1401b7927da3,2021-06-12,0,0,0,900,0,0,192,64,192,0,0,0,0,0,39,30,153,64,0.0,898.0
1864,0f51869f98afa6c0,792be9a24df82ed6,aa72b0f831d0bfe5,2021-06-12,1,2,1,746,2,2,85,29,77,8,1,1,7,5,18,17,59,24,165.1,375.2
1865,0f51869f98afa6c0,aa72b0f831d0bfe5,792be9a24df82ed6,2021-06-12,0,0,0,746,1,1,36,9,26,10,4,4,6,5,12,11,14,4,81.8,490.9
1866,f187c7ec92f43828,03f982ca3735070c,c9cf753cfdf77fc2,2021-06-05,0,0,0,246,0,0,40,17,40,0,0,0,0,0,7,6,33,17,0.0,240.0
1867,f187c7ec92f43828,c9cf753cfdf77fc2,03f982ca3735070c,2021-06-05,1,0,0,246,2,1,10,2,10,0,0,0,0,0,4,2,6,2,0.0,108.0
1868,bb6438338bb8aebf,327d5f279895110d,a12a8314adc1c1c9,2021-06-05,0,0,0,900,9,5,39,9,39,0,0,0,0,0,9,5,30,9,0.0,298.0
1869,bb6438338bb8aebf,a12a8314adc1c1c9,327d5f279895110d,2021-06-05,0,0,0,900,5,3,38,3,36,2,0,0,2,1,7,6,29,2,25.0,850.0
1870,9cdfcd164b48f55e,cd7763bcadb5d4c8,f6ad6a1e4d600e0d,2021-06-05,0,0,0,434,4,0,32,5,32,0,0,0,0,0,7,5,25,5,0.0,270.9
1871,9cdfcd164b48f55e,f6ad6a1e4d600e0d,cd7763bcadb5d4c8,2021-06-05,0,0,0,434,3,2,85,32,50,35,6,5,29,21,12,9,38,11,161.1,213.0
1872,9252ad2304fd9a26,866fd7b1a6c90e7f,d1c65d2cf2925ddd,2021-06-05,0,0,0,900,4,0,120,23,120,0,0,0,0,0,17,14,103,23,0.0,814.0
1873,9252ad2304fd9a26,d1c65d2cf2925ddd,866fd7b1a6c90e7f,2021-06-05,0,0,0,900,5,3,150,49,150,0,0,0,0,0,30,22,120,49,0.0,815.0
1874,827aacd14f80e8f3,87a1dc546b1c5caf,c7d7fda69ec410d3,2021-06-05,0,0,0,900,9,5,49,14,42,7,3,3,4,2,6,3,36,12,410.0,396.0
1875,827aacd14f80e8f3,c7d7fda69ec410d3,87a1dc546b1c5caf,2021-06-05,0,3,0,900,0,0,63,8,62,1,0,0,1,1,29,20,33,7,94.0,396.0
1876,73a83b2595416f0a,4682bc59d5f55145,52c2ae6d2f2d2613,2021-06-05,0,2,0,900,0,0,116,23,116,0,0,0,0,0,28,17,88,23,0.0,837.0
1877,73a83b2595416f0a,52c2ae6d2f2d2613,4682bc59d5f55145,2021-06-05,0,0,0,900,17,2,89,18,89,0,0,0,0,0,27,24,62,18,0.0,519.0
1878,5c0e5d850d8e661f,6d1bffff14897645,82d4c957649faf9b,2021-06-05,0,0,0,900,2,0,270,98,270,0,0,0,0,0,25,23,245,98,0.0,900.0
1879,5c0e5d850d8e661f,82d4c957649faf9b,6d1bffff14897645,2021-06-05,0,0,0,900,0,0,249,36,249,0,0,0,0,0,83,68,166,36,0.0,900.0
1880,58c5d506181812fa,ac026518a9b4dc0f,d747eb273a40a920,2021-06-05,0,0,0,900,7,2,34,4,33,1,0,0,1,0,20,17,13,4,31.5,173.0
1881,58c5d506181812fa,d747eb273a40a920,ac026518a9b4dc0f,2021-06-05,0,0,0,900,4,4,33,6,15,18,8,7,10,6,11,7,4,0,601.0,267.5
1882,419d1e29668b57fb,34ff304266360297,d25240135aee03e5,2021-06-05,1,0,0,480,1,1,172,68,164,8,0,0,8,6,18,16,146,62,10.0,440.0
1883,419d1e29668b57fb,d25240135aee03e5,34ff304266360297,2021-06-05,0,0,0,480,1,0,90,6,90,0,0,0,0,0,21,11,69,6,0.0,470.0
1884,2c0cddd12deb7450,2cd428e9606856fd,441eacbe20e0e80b,2021-06-05,1,0,0,299,0,0,29,6,26,3,0,0,3,1,12,10,14,5,2.0,297.0
1885,2c0cddd12deb7450,441eacbe20e0e80b,2cd428e9606856fd,2021-06-05,0,0,0,299,0,0,14,0,14,0,0,0,0,0,9,3,5,0,0.0,297.0
1886,23b943e9ce495f0b,447f9858ae78f921,a8283a4f415e1eb9,2021-06-05,1,0,0,900,3,2,118,29,99,19,5,5,14,8,29,28,70,21,120.6,773.0
1887,23b943e9ce495f0b,a8283a4f415e1eb9,447f9858ae78f921,2021-06-05,0,0,0,900,1,0,128,22,128,0,0,0,0,0,27,17,101,22,0.0,739.4
1888,1a50d5c7e1e5c058,6551c64fbcd1a467,80d8aed0ca9b00f3,2021-06-05,0,0,0,567,0,0,24,5,24,0,0,0,0,0,9,6,15,5,0.0,155.0
1889,1a50d5c7e1e5c058,80d8aed0ca9b00f3,6551c64fbcd1a467,2021-06-05,1,0,0,567,3,2,55,28,22,33,0,0,33,27,2,1,20,1,412.0,155.0
1890,0716a38768a34789,04c8b08b16a5b99e,e9a3aeb207578eea,2021-06-05,0,0,0,900,0,0,105,32,88,17,0,0,17,13,21,13,67,19,27.5,858.0
1891,0716a38768a34789,e9a3aeb207578eea,04c8b08b16a5b99e,2021-06-05,0,0,0,900,3,2,38,8,38,0,0,0,0,0,5,2,33,8,0.0,474.5
1892,e624d85a0d718578,523fa774700d7d3f,6f7c616b98e18c29,2021-05-22,0,1,0,900,5,3,74,22,61,13,0,0,13,12,21,15,40,10,392.4,417.0
1893,e624d85a0d718578,6f7c616b98e18c29,523fa774700d7d3f,2021-05-22,0,0,0,900,10,1,56,8,56,0,0,0,0,0,20,13,36,8,0.0,399.6
1894,d44a814b106b94ff,4a043165cf47cab2,9ada30894bf04e19,2021-05-22,0,0,0,138,2,0,32,5,32,0,0,0,0,0,7,6,25,5,0.0,138.0
1895,d44a814b106b94ff,9ada30894bf04e19,4a043165cf47cab2,2021-05-22,0,1,1,138,0,0,28,4,28,0,0,0,0,0,9,5,19,4,0.0,115.0
1896,d16f7ab4e28171ea,05339613bf8e9808,d8c7c61b176e3994,2021-05-22,0,0,0,1500,3,2,365,145,362,3,1,1,2,1,38,30,324,144,24.3,1370.1
1897,d16f7ab4e28171ea,d8c7c61b176e3994,05339613bf8e9808,2021-05-22,0,0,0,1500,10,3,142,45,137,5,0,0,5,4,22,18,115,41,56.9,1293.7
1898,c7cf2194fe5c751f,0a73acff6325c1e2,6751eacd16bd59bc,2021-05-22,0,0,0,900,14,2,63,13,63,0,0,0,0,0,8,4,55,13,0.0,534.0
1899,c7cf2194fe5c751f,6751eacd16bd59bc,0a73acff6325c1e2,2021-05-22,0,1,0,900,1,0,104,34,104,0,0,0,0,0,22,19,82,34,0.0,896.0
1900,b381dc272b32ce03,294aa73dbf37d281,f6e5972c9d16c40e,2021-05-22,1,0,0,60,0,0,12,4,7,5,0,0,5,2,2,2,5,2,1.7,58.0
1901,b381dc272b32ce03,f6e5972c9d16c40e,294aa73dbf37d281,2021-05-22,0,0,0,60,0,0,3,0,3,0,0,0,0,0,0,0,3,0,0.0,58.3
1902,ae0afbff5ba07a34,1ae8f3c723aacff4,9abc648e76c4493a,2021-05-22,0,1,0,900,13,8,102,30,102,0,0,0,0,0,30,23,72,30,0.0,684.9
1903,ae0afbff5ba07a34,9abc648e76c4493a,1ae8f3c723aacff4,2021-05-22,0,0,0,900,1,0,170,35,168,2,0,0,2,1,59,41,109,34,9.1,859.0
1904,82d48296fd06c27f,029afd138865d20a,135d124172a0bea3,2021-05-22,1,1,0,900,1,0,63,20,61,2,1,0,1,0,12,10,49,20,8.0,424.0
1905,82d48296fd06c27f,135d124172a0bea3,029afd138865d20a,2021-05-22,0,0,0,900,3,2,126,30,104,22,15,14,7,5,20,12,84,25,460.0,432.0
1906,7f8340dfe4220c3e,0a1942069c9ad6b6,4144798612ef96e5,2021-05-22,0,0,0,900,6,3,100,44,56,44,0,0,44,35,18,11,38,9,431.0,387.6
1907,7f8340dfe4220c3e,4144798612ef96e5,0a1942069c9ad6b6,2021-05-22,0,1,0,900,0,0,92,34,81,11,0,0,11,7,8,6,73,27,81.4,358.0
1908,559c0c3d752f327a,2b68d9f125d07b42,e13abac8089a801a,2021-05-22,0,0,0,900,0,0,248,64,248,0,0,0,0,0,67,57,181,64,0.0,876.0
1909,559c0c3d752f327a,e13abac8089a801a,2b68d9f125d07b42,2021-05-22,0,0,0,900,0,0,147,35,147,0,0,0,0,0,45,39,102,35,0.0,889.0
1910,3627f5133ce55902,7a5e8c94a86f9895,bd58d34e39b7b12a,2021-05-22,0,0,0,427,1,0,85,20,85,0,0,0,0,0,16,13,69,20,0.0,425.0
1911,3627f5133ce55902,bd58d34e39b7b12a,7a5e8c94a86f9895,2021-05-22,0,2,1,427,1,1,101,47,101,0,0,0,0,0,13,13,88,47,0.0,304.0
1912,16369fa06392f6a0,c41d426cc7326d1b,d910665038efc639,2021-05-22,0,0,0,478,0,0,11,4,7,4,0,0,4,3,1,1,6,1,0.0,40.0
1913,16369fa06392f6a0,d910665038efc639,c41d426cc7326d1b,2021-05-22,1,0,0,478,3,3,33,27,2,31,0,0,31,26,0,0,2,1,438.0,40.0
1914,138f719d370e8ba0,39d91e95949de3d9,d3f5d33d61cd00c9,2021-05-22,0,0,0,900,0,0,114,27,114,0,0,0,0,0,38,20,76,27,0.0,722.0
1915,138f719d370e8ba0,d3f5d33d61cd00c9,39d91e95949de3d9,2021-05-22,0,0,0,900,3,1,135,40,135,0,0,0,0,0,35,28,100,40,0.0,819.0
1916,fef29aa73bd5b907,07225ba28ae309b6,4b93a88f3b1de35b,2021-05-15,2,0,0,319,2,1,32,20,23,9,0,0,9,8,6,4,17,12,76.5,70.0
1917,fef29aa73bd5b907,4b93a88f3b1de35b,07225ba28ae309b6,2021-05-15,0,1,0,319,0,0,55,22,26,29,5,3,24,14,8,5,18,8,147.0,95.5
1918,de332779baa1b103,bd5403efbaa445c0,de45aaae23dfa392,2021-05-15,0,0,0,359,0,0,53,16,53,0,0,0,0,0,18,17,35,16,0.0,344.2
1919,de332779baa1b103,de45aaae23dfa392,bd5403efbaa445c0,2021-05-15,0,1,1,359,5,3,54,15,53,1,1,1,0,0,10,6,43,15,14.8,300.0
1920,cfbaeb80b5ff7c00,08af939f41b5a57b,22a92d7f62195791,2021-05-15,0,1,0,900,6,3,55,16,45,10,0,0,10,7,7,7,38,9,668.2,160.5
1921,cfbaeb80b5ff7c00,22a92d7f62195791,08af939f41b5a57b,2021-05-15,0,1,0,900,0,0,34,10,24,10,0,0,10,8,5,5,19,2,4.5,226.79999999999995
1922,ca22bafab913aae7,7a703c565ccaa18f,886264a0c9f4ea5e,2021-05-15,0,0,0,239,2,1,19,5,13,6,1,1,5,3,5,5,8,2,53.0,186.0
1923,ca22bafab913aae7,886264a0c9f4ea5e,7a703c565ccaa18f,2021-05-15,0,1,1,239,3,2,12,3,12,0,0,0,0,0,4,4,8,3,0.0,116.0
1924,bfd672cac0726a9a,016a8d958883167c,b1e5bcaad32a3cac,2021-05-15,0,0,0,591,9,4,48,21,39,9,1,1,8,8,13,11,26,13,227.2,184.2
1925,bfd672cac0726a9a,b1e5bcaad32a3cac,016a8d958883167c,2021-05-15,1,0,0,591,0,0,57,31,55,2,0,0,2,2,5,5,50,29,2.8,346.8
1926,be2e28ba3bdeb400,56fcb2c4d99f9d1b,f9b200db02b488d9,2021-05-15,0,0,0,900,20,3,63,19,63,0,0,0,0,0,19,13,44,19,0.0,743.0
1927,be2e28ba3bdeb400,f9b200db02b488d9,56fcb2c4d99f9d1b,2021-05-15,0,0,0,900,1,1,168,40,168,0,0,0,0,0,50,40,118,40,0.0,877.0
1928,969aa613824c5dfe,07a2bdaa0afdd831,67c1d46f4ed16f9e,2021-05-15,0,0,0,900,1,1,124,57,112,12,1,1,11,11,20,14,92,46,97.4,762.0
1929,969aa613824c5dfe,67c1d46f4ed16f9e,07a2bdaa0afdd831,2021-05-15,0,0,0,900,0,0,135,38,135,0,0,0,0,0,31,27,104,38,0.0,802.6
1930,8cb4e3f056a84b0d,36541f1e6c5d4955,e872e9a9a902c045,2021-05-15,0,1,0,900,3,1,196,60,196,0,0,0,0,0,34,29,162,60,0.0,716.0
1931,8cb4e3f056a84b0d,e872e9a9a902c045,36541f1e6c5d4955,2021-05-15,0,0,0,900,0,0,292,87,292,0,0,0,0,0,56,40,236,87,0.0,899.0
1932,6655a8da2655f2d0,64a50dad704d1d49,98d961097baaf308,2021-05-15,1,0,0,676,0,0,191,51,189,2,0,0,2,2,57,47,132,49,0.0,676.0
1933,6655a8da2655f2d0,98d961097baaf308,64a50dad704d1d49,2021-05-15,0,0,0,676,0,0,180,41,180,0,0,0,0,0,49,39,131,41,0.0,673.0
1934,5573d46130d6b967,830f60497fab345a,c878270af633eb11,2021-05-15,0,0,0,64,0,0,5,2,5,0,0,0,0,0,2,2,3,2,0.0,46.1
1935,5573d46130d6b967,c878270af633eb11,830f60497fab345a,2021-05-15,1,0,0,64,0,0,32,21,18,14,0,0,14,9,5,5,13,12,5.9,53.0
1936,2b894d87ad9aae05,05fa626cb33d15b8,d7338bcb141abd2c,2021-05-15,0,3,1,592,3,3,62,32,41,21,0,0,21,20,19,13,22,12,101.9,461.0
1937,2b894d87ad9aae05,d7338bcb141abd2c,05fa626cb33d15b8,2021-05-15,0,0,0,592,0,0,41,13,41,0,0,0,0,0,11,10,30,13,0.0,252.1
1938,1f2f27b36e79da74,7832f2f62f04178f,cf946e03ba2e7666,2021-05-15,0,0,0,900,4,3,177,59,173,4,0,0,4,3,46,40,127,56,74.0,715.0
1939,1f2f27b36e79da74,cf946e03ba2e7666,7832f2f62f04178f,2021-05-15,0,0,0,900,2,0,144,45,144,0,0,0,0,0,46,36,98,45,0.0,774.0
1940,db2c805201a3116e,1d00756835ca67c9,cdb96af67d096b1e,2021-05-08,0,0,0,280,2,0,35,5,35,0,0,0,0,0,12,12,23,5,0.0,278.0
1941,db2c805201a3116e,cdb96af67d096b1e,1d00756835ca67c9,2021-05-08,1,0,0,280,2,0,84,28,84,0,0,0,0,0,10,7,74,28,0.0,233.0
1942,b948102c6205af63,cd2c4d30c6e13b47,eb04b9d31e938edb,2021-05-08,0,0,0,1500,0,0,282,60,282,0,0,0,0,0,94,65,188,60,0.0,1337.1
1943,b948102c6205af63,eb04b9d31e938edb,cd2c4d30c6e13b47,2021-05-08,0,0,0,1500,5,1,205,43,194,11,0,0,11,7,76,45,118,36,111.9,1266.0
1944,8a95f0e3f9111f0c,285ae0b4a68221f4,6aae253467e8f9ce,2021-05-08,0,2,0,900,5,2,145,61,120,25,0,0,25,20,11,10,109,41,204.5,671.0
1945,8a95f0e3f9111f0c,6aae253467e8f9ce,285ae0b4a68221f4,2021-05-08,0,0,0,900,2,1,136,20,136,0,0,0,0,0,53,38,83,20,0.0,661.5
1946,4ffbadfb86284af5,5b86d491d63890c5,5bf31a46becc1204,2021-05-08,0,0,0,900,7,4,86,23,86,0,0,0,0,0,29,22,57,23,0.0,692.0
1947,4ffbadfb86284af5,5bf31a46becc1204,5b86d491d63890c5,2021-05-08,0,1,0,900,0,0,104,34,104,0,0,0,0,0,32,22,72,34,0.0,900.0
1948,3f71ac21472f994c,068f8a189a47fea6,ab943cd2c3c17825,2021-05-08,0,0,0,900,0,0,8,3,8,0,0,0,0,0,2,2,6,3,0.0,106.89999999999998
1949,3f71ac21472f994c,ab943cd2c3c17825,068f8a189a47fea6,2021-05-08,0,0,0,900,4,3,26,11,11,15,1,1,14,9,2,2,9,2,793.1,54.0
1950,37fda56a435a9b24,a53d30163304aa6e,ae071698e1a3ccd4,2021-05-08,0,1,1,172,3,0,13,3,13,0,0,0,0,0,4,2,9,3,0.0,120.0
1951,37fda56a435a9b24,ae071698e1a3ccd4,a53d30163304aa6e,2021-05-08,0,0,0,172,1,0,10,1,10,0,0,0,0,0,1,0,9,1,0.0,140.0
1952,295a0bf12a7373c0,84ff027394f7e470,f53d4f21d1b5f2dc,2021-05-08,1,0,0,591,8,4,62,37,25,37,0,0,37,30,10,8,15,7,254.9,224.4
1953,295a0bf12a7373c0,f53d4f21d1b5f2dc,84ff027394f7e470,2021-05-08,0,0,0,591,2,0,60,31,42,18,0,0,18,18,0,0,42,13,56.6,270.1
1954,178c4926223dca0c,84b3e7d38f2d2ec5,b997be68943010fc,2021-05-08,0,0,0,900,10,2,174,34,171,3,3,3,0,0,27,18,144,34,23.8,755.2
1955,178c4926223dca0c,b997be68943010fc,84b3e7d38f2d2ec5,2021-05-08,0,0,0,900,2,1,73,30,71,2,0,0,2,1,6,5,65,29,41.8,646.2
1956,00fbeda449926c13,547afe1017e72dbe,d6c0cdd7e467c440,2021-05-08,0,1,0,900,4,2,101,42,76,25,2,2,23,13,24,22,52,29,189.8,502.8
1957,00fbeda449926c13,d6c0cdd7e467c440,547afe1017e72dbe,2021-05-08,0,0,0,900,7,0,82,20,81,1,0,0,1,0,14,8,67,20,63.2,457.2
1958,ffd8e8575a551875,0d8011111be000b2,4e06913c91da5200,2021-05-01,0,0,0,900,0,0,182,46,182,0,0,0,0,0,52,38,130,46,0.0,900.0
1959,ffd8e8575a551875,4e06913c91da5200,0d8011111be000b2,2021-05-01,0,0,0,900,1,0,196,17,196,0,0,0,0,0,33,20,163,17,0.0,900.0
1960,ec8d93ae99a7799d,cd13728ae1151f46,e4277e87a789d687,2021-05-01,0,0,0,900,19,9,152,62,131,21,0,0,21,19,13,9,118,43,193.3,617.7
1961,ec8d93ae99a7799d,e4277e87a789d687,cd13728ae1151f46,2021-05-01,0,0,0,900,3,1,148,67,147,1,0,0,1,1,18,17,129,66,15.3,614.7
1962,d72f9b3ac742a9e3,d31cbcdd7d69536d,eee0ef3e2b14816b,2021-05-01,0,1,0,900,4,2,211,54,209,2,0,0,2,2,37,28,172,52,10.3,552.0
1963,d72f9b3ac742a9e3,eee0ef3e2b14816b,d31cbcdd7d69536d,2021-05-01,1,0,0,900,1,1,128,38,116,12,1,1,11,8,27,22,89,30,312.0,551.7
1964,d6b5a6ad27a730ae,4e30e4250cb08b61,e94085e821bd81de,2021-05-01,0,0,0,900,8,4,124,23,117,7,1,1,6,6,70,60,47,17,12.1,772.5
1965,d6b5a6ad27a730ae,e94085e821bd81de,4e30e4250cb08b61,2021-05-01,0,0,0,900,2,0,73,32,71,2,0,0,2,2,26,17,45,30,37.5,493.9
1966,c9c79de21823d941,4a57ebb14315b251,a3a542074109b347,2021-05-01,0,0,0,256,0,0,40,12,39,1,0,0,1,1,8,6,31,11,4.8,198.2
1967,c9c79de21823d941,a3a542074109b347,4a57ebb14315b251,2021-05-01,0,0,0,256,6,5,53,22,45,8,1,1,7,1,8,6,37,21,28.8,197.2
1968,78dc032441394331,79325a3c1a5c3bf4,9cd047a828dd7515,2021-05-01,0,0,0,900,1,1,137,46,133,4,0,0,4,3,30,27,103,43,59.5,781.0
1969,78dc032441394331,9cd047a828dd7515,79325a3c1a5c3bf4,2021-05-01,0,0,0,900,0,0,131,5,131,0,0,0,0,0,87,65,44,5,0.0,828.5
1970,3d790112d2e6d851,96428b9e9bd048ea,dbac0a413af64bbe,2021-05-01,1,0,0,900,5,2,211,93,201,10,1,1,9,8,28,24,173,85,72.9,594.5
1971,3d790112d2e6d851,dbac0a413af64bbe,96428b9e9bd048ea,2021-05-01,0,0,0,900,10,2,131,51,122,9,2,1,7,4,28,26,94,47,130.5,653.1
1972,394802bb096b403e,009341ed974bad72,2e19380f34871c6a,2021-05-01,1,0,0,569,1,1,136,61,124,12,0,0,12,6,17,16,107,55,81.4,448.6
1973,394802bb096b403e,2e19380f34871c6a,009341ed974bad72,2021-05-01,0,1,0,569,1,1,108,39,101,7,0,0,7,5,27,24,74,34,25.4,458.6
1974,2f82e8079ba354f4,9560ff14eb3129f7,d247691a6c0e9034,2021-05-01,1,0,0,63,0,0,18,9,11,7,0,0,7,5,4,3,7,4,5.0,58.0
1975,2f82e8079ba354f4,d247691a6c0e9034,9560ff14eb3129f7,2021-05-01,0,0,0,63,0,0,6,1,6,0,0,0,0,0,5,3,1,1,0.0,58.0
1976,2ef09c8fe29251ac,528b071cf3da7c56,5c126c6aac3ef364,2021-05-01,0,0,0,900,0,0,46,6,44,2,1,0,1,1,23,19,21,5,43.7,443.2
1977,2ef09c8fe29251ac,5c126c6aac3ef364,528b071cf3da7c56,2021-05-01,0,0,0,900,4,1,57,12,51,6,3,3,3,3,27,19,24,9,128.8,577.3
1978,26202a4bd36d3fd2,bf7ad5628363eec9,c03520b5c88ed6b4,2021-05-01,0,0,0,900,4,1,134,27,133,1,0,0,1,1,32,21,101,26,22.1,689.0
1979,26202a4bd36d3fd2,c03520b5c88ed6b4,bf7ad5628363eec9,2021-05-01,0,1,0,900,11,5,192,49,189,3,2,2,1,1,32,20,157,48,34.0,775.9
1980,f5dd0a24a7dba53c,2f181c0467965b98,37d5b176d438d2a5,2021-04-24,0,1,1,295,2,2,16,4,16,0,0,0,0,0,5,5,11,4,0.0,99.0
1981,f5dd0a24a7dba53c,37d5b176d438d2a5,2f181c0467965b98,2021-04-24,0,0,0,295,0,0,14,5,14,0,0,0,0,0,3,1,11,5,0.0,295.0
1982,eb5d62bda1581c62,0c258d1d8e16e5f1,3b0a516d2921e0d6,2021-04-24,0,0,0,50,0,0,8,1,8,0,0,0,0,0,3,2,5,1,0.0,46.0
1983,eb5d62bda1581c62,3b0a516d2921e0d6,0c258d1d8e16e5f1,2021-04-24,1,0,0,50,0,0,15,7,8,7,0,0,7,4,0,0,8,3,4.0,46.0
1984,c5dfce1eaa2dc169,348dff4e03bd18c6,8be158ca1e5ea6a0,2021-04-24,0,1,0,900,7,3,52,14,50,2,0,0,2,2,21,19,29,12,124.0,763.5
1985,c5dfce1eaa2dc169,8be158ca1e5ea6a0,348dff4e03bd18c6,2021-04-24,0,0,0,900,1,1,156,28,154,2,0,0,2,2,30,21,124,26,12.5,751.0
1986,c3b8d8e7d256c307,a13d755965a4ec9f,ec18eb918121787c,2021-04-24,0,0,0,900,4,3,105,40,100,5,0,0,5,2,4,2,96,38,164.0,701.0
1987,c3b8d8e7d256c307,ec18eb918121787c,a13d755965a4ec9f,2021-04-24,0,1,0,900,1,0,176,50,175,1,0,0,1,1,55,46,120,49,35.0,666.0
1988,b5a8323de18f7e95,008ea710276c9606,7d420039bbfe7c1a,2021-04-24,2,0,0,900,1,0,356,167,355,1,0,0,1,1,28,22,327,166,3.9,857.0
1989,b5a8323de18f7e95,7d420039bbfe7c1a,008ea710276c9606,2021-04-24,0,0,0,900,4,3,258,77,258,0,0,0,0,0,44,39,214,77,0.0,776.1
1990,a3cde349c8e018fb,c0d5c0c95c59050b,ec0dcceace7d25a3,2021-04-24,1,0,0,388,0,0,32,23,16,16,0,0,16,13,1,1,15,10,118.9,181.6
1991,a3cde349c8e018fb,ec0dcceace7d25a3,c0d5c0c95c59050b,2021-04-24,0,1,0,388,4,3,27,13,24,3,0,0,3,2,6,6,18,11,50.4,101.1
1992,6d8da45352344964,1ebe20ebbfa15e29,47b63240018d5d86,2021-04-24,0,0,0,78,0,0,11,1,11,0,0,0,0,0,7,6,4,1,0.0,75.0
1993,6d8da45352344964,47b63240018d5d86,1ebe20ebbfa15e29,2021-04-24,1,0,0,78,0,0,10,5,7,3,0,0,3,3,0,0,7,2,3.0,75.0
1994,6a7347d1da8a2b87,2ebfbe72ed703925,b8bbdeff718dbb7d,2021-04-24,0,0,0,900,1,1,50,10,48,2,0,0,2,1,9,9,39,9,20.0,421.3
1995,6a7347d1da8a2b87,b8bbdeff718dbb7d,2ebfbe72ed703925,2021-04-24,1,1,0,900,5,1,45,18,33,12,0,0,12,11,9,8,24,7,398.7,282.0
1996,6a5eb525331fa1fc,47b9e0e7703a4868,f1b2aa7853d1ed6e,2021-04-24,0,0,0,362,0,0,52,13,47,5,0,0,5,4,19,18,28,9,0.0,260.0
1997,6a5eb525331fa1fc,f1b2aa7853d1ed6e,47b9e0e7703a4868,2021-04-24,1,0,0,362,2,2,40,15,30,10,0,0,10,9,8,6,22,6,102.0,260.0
1998,512af32553d9bd70,57b10fca4f9c9a7a,c6aee362c7a7d482,2021-04-24,0,0,0,170,0,0,12,1,12,0,0,0,0,0,6,6,6,1,0.0,87.0
1999,512af32553d9bd70,c6aee362c7a7d482,57b10fca4f9c9a7a,2021-04-24,1,1,1,170,0,0,32,10,21,11,0,0,11,8,8,6,13,2,83.0,87.0
2000,34d2632fd26e7078,132deb59abae64b1,6a1901c62ab3870f,2021-04-24,1,1,0,499,7,7,39,27,21,18,0,0,18,18,5,5,16,9,233.2,188.0
2001,34d2632fd26e7078,6a1901c62ab3870f,132deb59abae64b1,2021-04-24,0,0,0,499,2,0,15,2,15,0,0,0,0,0,9,8,6,2,0.0,208.8
2002,1820fed0fbcf6294,3a8176e15b9887c1,65578a75fa7900e3,2021-04-24,0,0,0,17,0,0,2,0,2,0,0,0,0,0,1,1,1,0,0.0,17.0
2003,1820fed0fbcf6294,65578a75fa7900e3,3a8176e15b9887c1,2021-04-24,1,0,0,17,0,0,0,0,0,0,0,0,0,0,0,0,0,0,0.0,17.0
2004,00bbcd4a6d647fdf,70e1f8a821b72c8b,d4c9dcd330403612,2021-04-24,0,0,0,300,3,3,35,7,33,2,0,0,2,1,14,11,19,6,57.0,243.0
2005,00bbcd4a6d647fdf,d4c9dcd330403612,70e1f8a821b72c8b,2021-04-24,1,0,0,300,0,0,39,20,39,0,0,0,0,0,7,6,32,20,0.0,241.0
2006,fdfe4e7cb2d0b665,c0badf3243907e59,ccf5dc41417e9daf,2021-04-17,0,0,0,665,4,2,53,23,26,27,0,0,27,18,9,9,17,5,279.0,289.0
2007,fdfe4e7cb2d0b665,ccf5dc41417e9daf,c0badf3243907e59,2021-04-17,0,0,0,665,5,4,22,8,21,1,0,0,1,1,5,4,16,7,35.0,211.0
2008,f67aa0b16e16a9ea,8c0580d4fff106c1,e1147d3d2dabe1ce,2021-04-17,0,0,0,1500,5,1,209,42,209,0,0,0,0,0,24,20,185,42,0.0,1310.4
2009,f67aa0b16e16a9ea,e1147d3d2dabe1ce,8c0580d4fff106c1,2021-04-17,0,0,0,1500,7,4,284,115,272,12,0,0,12,7,43,35,229,108,163.6,1241.0
2010,f2c82f027201ba21,01b352b6a9074d5c,3738e68d2261e60f,2021-04-17,0,0,0,900,0,0,192,55,192,0,0,0,0,0,38,33,154,55,0.0,900.0
2011,f2c82f027201ba21,3738e68d2261e60f,01b352b6a9074d5c,2021-04-17,0,0,0,900,0,0,222,54,222,0,0,0,0,0,68,51,154,54,0.0,861.0
2012,a850ba762f3c5334,d4270315cbcf2569,eae431e70064e046,2021-04-17,0,2,0,900,24,8,55,24,46,9,0,0,9,6,4,3,42,18,350.5,198.3
2013,a850ba762f3c5334,eae431e70064e046,d4270315cbcf2569,2021-04-17,0,0,0,900,0,0,47,11,44,3,0,0,3,2,14,10,30,9,0.7,547.5
2014,a33ecd2c88154890,2844b047183a1adb,f8f1ec513bcfef43,2021-04-17,0,0,0,900,0,0,195,74,195,0,0,0,0,0,24,16,171,74,0.0,897.0
2015,a33ecd2c88154890,f8f1ec513bcfef43,2844b047183a1adb,2021-04-17,0,0,0,900,9,4,169,40,169,0,0,0,0,0,59,40,110,40,0.0,759.0
2016,8d634c9240f161dd,3033c1c080672475,d2cd7a69cc55e7ed,2021-04-17,0,0,0,900,6,1,104,17,104,0,0,0,0,0,45,24,59,17,0.0,457.2
2017,8d634c9240f161dd,d2cd7a69cc55e7ed,3033c1c080672475,2021-04-17,0,0,0,900,1,1,115,32,94,21,4,3,17,13,35,32,59,19,351.8,498.0
2018,627c0a50cff30405,6ac9bc2953c47345,e17ac6410c8377f4,2021-04-17,0,1,1,120,0,0,10,7,10,0,0,0,0,0,1,1,9,7,0.0,34.0
2019,627c0a50cff30405,e17ac6410c8377f4,6ac9bc2953c47345,2021-04-17,0,0,0,120,1,1,13,2,13,0,0,0,0,0,4,4,9,2,0.0,107.0
2020,25d4376e00b16510,8e5d953bdb9ae5e7,c742287ed86a09bc,2021-04-17,0,0,0,900,9,3,74,31,72,2,1,0,1,0,10,9,62,31,83.3,650.0
2021,25d4376e00b16510,c742287ed86a09bc,8e5d953bdb9ae5e7,2021-04-17,0,0,0,900,7,1,87,19,87,0,0,0,0,0,24,12,63,19,0.0,546.7
2022,24ff385ca78c80d3,601964f9654f911a,c5a126ace82a6025,2021-04-17,2,0,0,391,6,4,75,31,38,37,0,0,37,21,10,8,28,10,241.4,105.0
2023,24ff385ca78c80d3,c5a126ace82a6025,601964f9654f911a,2021-04-17,0,1,0,391,1,0,45,11,41,4,0,0,4,4,11,7,30,7,12.0,122.6
2024,0b2c3c4306620d6d,68d4a891e5cf2029,928ae2e5b5f7a9ec,2021-04-17,0,1,0,900,5,3,112,40,80,32,0,0,32,20,34,26,46,20,316.7,504.5
2025,0b2c3c4306620d6d,928ae2e5b5f7a9ec,68d4a891e5cf2029,2021-04-17,1,0,0,900,1,0,119,30,117,2,0,0,2,1,33,25,84,29,9.5,545.3
2026,e27c28928ed4390f,af65aa688d13eedf,d1941565abf50b16,2021-04-10,0,0,0,900,4,1,42,12,42,0,0,0,0,0,9,7,33,12,0.0,296.0
2027,e27c28928ed4390f,d1941565abf50b16,af65aa688d13eedf,2021-04-10,0,0,0,900,0,0,34,7,33,1,0,0,1,0,8,4,25,7,41.0,777.0
2028,ddd63237f1b857a6,3a46b268013afede,7acbb0972e75281a,2021-04-10,0,0,0,1500,0,0,103,24,103,0,0,0,0,0,22,13,81,24,0.0,582.0
2029,ddd63237f1b857a6,7acbb0972e75281a,3a46b268013afede,2021-04-10,0,1,0,1500,17,11,64,22,48,16,0,0,16,7,3,2,45,15,915.0,299.0
2030,cd5d9828b278181a,5da33b8fbfa5ee95,74f9448b97bf8bec,2021-04-10,0,0,0,900,3,0,29,5,29,0,0,0,0,0,16,12,13,5,0.0,167.0
2031,cd5d9828b278181a,74f9448b97bf8bec,5da33b8fbfa5ee95,2021-04-10,0,0,0,900,9,8,46,20,23,23,0,0,23,17,9,8,14,3,724.0,176.0
2032,ac9a8b73e58f3d71,8a1f3b5c526cd6e6,f2b6fdb20675b11c,2021-04-10,0,0,0,900,1,0,235,90,235,0,0,0,0,0,44,39,191,90,0.0,900.0
2033,ac9a8b73e58f3d71,f2b6fdb20675b11c,8a1f3b5c526cd6e6,2021-04-10,0,0,0,900,4,2,132,27,132,0,0,0,0,0,47,34,85,27,0.0,731.0
2034,998296216e7171ed,72db2a14ffa73ece,df1eb4354d18a906,2021-04-10,1,0,0,382,5,2,63,17,58,5,1,1,4,2,24,21,34,15,22.7,332.0
2035,998296216e7171ed,df1eb4354d18a906,72db2a14ffa73ece,2021-04-10,0,0,0,382,1,0,48,5,48,0,0,0,0,0,14,5,34,5,0.0,359.3
2036,93a1cd50374397c0,12e0fdc606f7e274,ebef46976554f975,2021-04-10,0,1,0,900,0,0,88,19,88,0,0,0,0,0,21,17,67,19,0.0,636.0
2037,93a1cd50374397c0,ebef46976554f975,12e0fdc606f7e274,2021-04-10,0,2,0,900,7,4,69,22,66,3,0,0,3,2,14,11,52,20,126.0,522.0
2038,7aebf01b5afc0109,c21a036b4e012f1c,e4a47b07044ddd72,2021-04-10,0,0,0,900,0,0,232,72,232,0,0,0,0,0,67,52,165,72,0.0,887.0
2039,7aebf01b5afc0109,e4a47b07044ddd72,c21a036b4e012f1c,2021-04-10,0,0,0,900,4,0,312,75,312,0,0,0,0,0,44,37,268,75,0.0,826.0
2040,71b81d8199a0fa19,040a74bb0a465c54,94426bb170c88115,2021-04-10,1,0,0,900,5,2,61,15,58,3,1,1,2,0,7,5,51,15,103.0,591.0
2041,71b81d8199a0fa19,94426bb170c88115,040a74bb0a465c54,2021-04-10,0,1,0,900,1,0,113,24,113,0,0,0,0,0,28,23,85,24,0.0,644.0
2042,646eeca9447c6965,d0e1b42d41dab603,d156513a19acf856,2021-04-10,1,1,1,427,0,0,100,46,76,24,2,2,22,17,20,13,56,29,15.4,411.0
2043,646eeca9447c6965,d156513a19acf856,d0e1b42d41dab603,2021-04-10,0,0,0,427,0,0,78,21,78,0,0,0,0,0,14,8,64,21,0.0,406.6
2044,444f0a732695dc81,1eff7bc0f815b270,8614b7134913f5d5,2021-04-10,0,0,0,182,0,0,11,2,11,0,0,0,0,0,0,0,11,2,0.0,154.0
2045,444f0a732695dc81,8614b7134913f5d5,1eff7bc0f815b270,2021-04-10,1,0,0,182,1,0,12,3,11,1,0,0,1,1,8,7,3,2,20.0,142.0
2046,3209bcfaf95de90b,257b0c8d6f199895,a6c20202c701e5ca,2021-04-10,0,1,1,326,6,2,29,11,29,0,0,0,0,0,3,2,26,11,0.0,152.0
2047,3209bcfaf95de90b,a6c20202c701e5ca,257b0c8d6f199895,2021-04-10,0,0,0,326,0,0,24,6,24,0,0,0,0,0,8,7,16,6,0.0,270.0
2048,1fee9eca658d9808,2af2f2e26c4c0402,b8a85389d115e35a,2021-04-10,0,1,0,900,6,0,80,12,75,5,3,2,2,2,40,31,35,10,75.6,567.4
2049,1fee9eca658d9808,b8a85389d115e35a,2af2f2e26c4c0402,2021-04-10,0,0,0,900,13,6,57,24,53,4,0,0,4,3,15,12,38,21,90.6,507.4
2050,0992795fd0fa06d0,7447e9f28508106a,d343df8ba11f4c4e,2021-04-10,0,1,1,288,2,1,22,10,16,6,0,0,6,4,2,2,14,6,205.7,48.0
2051,0992795fd0fa06d0,d343df8ba11f4c4e,7447e9f28508106a,2021-04-10,0,0,0,288,0,0,7,2,7,0,0,0,0,0,2,2,5,2,0.0,82.30000000000001
2052,b1eff235241e719b,8d03ce87ca14e778,d28dee5c705991df,2021-03-27,2,0,0,352,2,1,56,28,44,12,0,0,12,11,10,8,34,17,13.2,330.0
2053,b1eff235241e719b,d28dee5c705991df,8d03ce87ca14e778,2021-03-27,0,0,0,352,1,0,13,3,13,0,0,0,0,0,9,9,4,3,0.0,334.8
2054,8317208cfb030ed3,38c7f72747f4f712,f29a6350c69f4a33,2021-03-27,0,1,0,900,4,2,68,16,68,0,0,0,0,0,16,11,52,16,0.0,455.8
2055,8317208cfb030ed3,f29a6350c69f4a33,38c7f72747f4f712,2021-03-27,0,0,0,900,4,3,150,54,129,21,5,5,16,14,20,12,109,40,235.2,620.0
2056,6002c24f0b7f8cc7,0d65c432720accb9,476fe566d2df676e,2021-03-27,0,0,0,900,2,0,122,30,122,0,0,0,0,0,29,26,93,30,0.0,831.0
2057,6002c24f0b7f8cc7,476fe566d2df676e,0d65c432720accb9,2021-03-27,0,0,0,900,1,0,167,44,167,0,0,0,0,0,21,14,146,44,0.0,896.0
2058,4b3af85b0df51d09,029e1293e609fd74,c730a0be691dc081,2021-03-27,0,0,0,900,5,1,120,45,120,0,0,0,0,0,15,15,105,45,0.0,642.0
2059,4b3af85b0df51d09,c730a0be691dc081,029e1293e609fd74,2021-03-27,0,0,0,900,0,0,136,30,130,6,0,0,6,5,26,13,104,25,0.0,900.0
2060,48292a027df02443,78a68f1dade6aaf7,a495f599e787614f,2021-03-27,0,0,0,71,0,0,1,0,1,0,0,0,0,0,0,0,1,0,0.0,71.0
2061,48292a027df02443,a495f599e787614f,78a68f1dade6aaf7,2021-03-27,0,1,1,71,1,1,3,3,3,0,0,0,0,0,0,0,3,3,0.0,4.0
2062,41622791b276ad9e,46d0a888d87d91ac,8e9eb3fc86db0f7d,2021-03-27,0,0,0,896,3,0,219,45,219,0,0,0,0,0,81,63,138,45,0.0,508.4
2063,41622791b276ad9e,8e9eb3fc86db0f7d,46d0a888d87d91ac,2021-03-27,1,0,0,896,1,0,275,126,214,61,0,0,61,43,18,15,196,83,264.6,536.0
2064,39d188fa9b95d550,6d4b63c767106d3a,effd9de9937996f8,2021-03-27,0,1,1,236,0,0,33,15,33,0,0,0,0,0,11,10,22,15,0.0,113.0
2065,39d188fa9b95d550,effd9de9937996f8,6d4b63c767106d3a,2021-03-27,0,0,0,236,1,0,40,7,40,0,0,0,0,0,13,11,27,7,0.0,214.0
2066,390694c179f05c7f,78e501478a36a018,af9f42e6894047fc,2021-03-27,0,0,0,46,0,0,10,3,10,0,0,0,0,0,2,2,8,3,0.0,42.0
2067,390694c179f05c7f,af9f42e6894047fc,78e501478a36a018,2021-03-27,1,0,0,46,0,0,13,5,9,4,0,0,4,3,2,1,7,2,4.0,42.0
2068,2220b73ece1730c3,4cd8b03aee1d0138,a0e6753c42698f13,2021-03-27,0,0,0,900,5,1,105,17,105,0,0,0,0,0,40,29,65,17,0.0,686.1
2069,2220b73ece1730c3,a0e6753c42698f13,4cd8b03aee1d0138,2021-03-27,0,0,0,900,2,2,144,48,143,1,0,0,1,1,24,21,119,47,7.9,813.0
2070,0aa335dbc4cb3473,2b074403b7c6cdb4,b50a426a33da0012,2021-03-27,0,0,0,832,2,1,71,9,66,5,1,1,4,1,27,15,39,8,22.0,808.3
2071,0aa335dbc4cb3473,b50a426a33da0012,2b074403b7c6cdb4,2021-03-27,2,0,0,832,0,0,149,41,148,1,0,0,1,1,50,45,98,40,1.7,805.0
2072,edac9fd482177a64,32490e80ddab1e5a,b0d6a1d8ac3d563d,2021-03-20,0,0,0,140,0,0,24,5,24,0,0,0,0,0,14,9,10,5,0.0,112.0
2073,edac9fd482177a64,b0d6a1d8ac3d563d,32490e80ddab1e5a,2021-03-20,1,0,0,140,1,0,28,11,27,1,0,0,1,1,11,6,16,10,28.0,112.0
2074,dd7f3f91ea6067d4,1235b31de15d0c6e,4959f10a62f3fec3,2021-03-20,0,2,0,900,5,4,41,10,41,0,0,0,0,0,6,5,35,10,0.0,257.2
2075,dd7f3f91ea6067d4,4959f10a62f3fec3,1235b31de15d0c6e,2021-03-20,0,0,0,900,0,0,65,26,58,7,0,0,7,3,5,5,53,23,49.8,836.0
2076,dcfbbebc0aee6ded,9cdd2da1a9104a0b,c7d297714d9ab1a4,2021-03-20,0,0,0,900,1,1,138,29,134,4,0,0,4,2,28,22,106,27,48.0,672.0
2077,dcfbbebc0aee6ded,c7d297714d9ab1a4,9cdd2da1a9104a0b,2021-03-20,0,0,0,900,4,2,63,14,63,0,0,0,0,0,23,16,40,14,0.0,717.0
2078,b8a0047c927faa75,8c39367b53eadf8a,cc1a8b4b38b92c6d,2021-03-20,0,0,0,118,0,0,25,3,23,2,0,0,2,2,18,11,5,1,0.7,105.6
2079,b8a0047c927faa75,cc1a8b4b38b92c6d,8c39367b53eadf8a,2021-03-20,2,0,0,118,0,0,26,11,16,10,0,0,10,7,4,4,12,4,11.4,101.3
2080,afc86d1076c4c3a9,0232cabbc30a2372,93b62c5f2ba18e51,2021-03-20,2,0,0,627,0,0,103,32,102,1,0,0,1,0,20,9,82,32,3.0,624.0
2081,afc86d1076c4c3a9,93b62c5f2ba18e51,0232cabbc30a2372,2021-03-20,0,0,0,627,1,0,51,14,51,0,0,0,0,0,11,9,40,14,0.0,624.0
2082,a043e279434d5c8c,99bd51917728c25d,9c65736747ca92ec,2021-03-20,1,0,0,899,13,1,84,16,79,5,0,0,5,4,36,30,43,12,155.6,401.0
2083,a043e279434d5c8c,9c65736747ca92ec,99bd51917728c25d,2021-03-20,0,0,0,899,2,1,67,14,67,0,0,0,0,0,22,16,45,14,0.0,662.4
2084,9e45cc594a5a2506,c62fbc117d57b943,f703250471acaf96,2021-03-20,1,0,0,49,0,0,18,10,10,8,0,0,8,5,4,4,6,5,10.0,39.0
2085,9e45cc594a5a2506,f703250471acaf96,c62fbc117d57b943,2021-03-20,0,0,0,49,0,0,6,1,6,0,0,0,0,0,1,1,5,1,0.0,39.0
2086,68cf99b6551dc3b3,327d5f279895110d,b27a1fcb56a3035a,2021-03-20,0,2,0,900,3,1,67,10,65,2,0,0,2,1,30,22,35,9,63.8,595.0
2087,68cf99b6551dc3b3,b27a1fcb56a3035a,327d5f279895110d,2021-03-20,0,1,0,900,2,1,57,22,47,10,0,0,10,8,6,5,41,14,50.0,761.2
2088,55bf7f19a132e0fc,0b362247806341e5,294aa73dbf37d281,2021-03-20,0,1,0,476,1,0,56,8,56,0,0,0,0,0,14,9,42,8,0.0,208.7
2089,55bf7f19a132e0fc,294aa73dbf37d281,0b362247806341e5,2021-03-20,3,0,0,476,2,1,61,29,45,16,0,0,16,10,10,8,35,19,205.3,245.0
2090,2efbcd870f1f7bc7,3a46b268013afede,b1a3e0aca758b322,2021-03-20,0,0,0,1500,1,1,74,28,71,3,0,0,3,2,10,8,61,26,32.1,581.0
2091,2efbcd870f1f7bc7,b1a3e0aca758b322,3a46b268013afede,2021-03-20,0,1,0,1500,12,6,93,28,53,40,2,2,38,17,17,13,36,11,812.0,452.9
2092,e8adfbbe0053c321,5f179af5fffeb9f6,6fd953151d981979,2021-03-13,0,0,0,900,1,0,131,35,131,0,0,0,0,0,24,20,107,35,0.0,704.5
2093,e8adfbbe0053c321,6fd953151d981979,5f179af5fffeb9f6,2021-03-13,0,0,0,900,7,4,80,41,71,9,1,0,8,5,5,4,66,36,193.5,556.0
2094,dc48627a5f2daba9,a17ad5a5048e8c3f,cad24459b28592ca,2021-03-13,0,0,0,277,0,0,42,7,42,0,0,0,0,0,10,8,32,7,0.0,192.0
2095,dc48627a5f2daba9,cad24459b28592ca,a17ad5a5048e8c3f,2021-03-13,1,0,0,277,7,3,63,38,46,17,0,0,17,15,6,5,40,23,85.0,122.0
2096,d15a87087b6f1452,82a5152216251682,da816417a579a0bd,2021-03-13,1,0,0,22,0,0,4,1,4,0,0,0,0,0,0,0,4,1,0.0,21.0
2097,d15a87087b6f1452,da816417a579a0bd,82a5152216251682,2021-03-13,0,0,0,22,0,0,1,0,1,0,0,0,0,0,1,1,0,0,0.0,22.0
2098,d0ebb0551377a1c1,4aa58269d0664b5b,5f3805dda9661cba,2021-03-13,1,0,0,16,0,0,5,2,2,3,0,0,3,1,1,1,1,1,2.0,14.0
2099,d0ebb0551377a1c1,5f3805dda9661cba,4aa58269d0664b5b,2021-03-13,0,0,0,16,0,0,4,2,4,0,0,0,0,0,2,2,2,2,0.0,14.0
2100,bb7ce8a6ba7f7cc5,2804ce8dadab5770,f1d64ae34e088832,2021-03-13,0,0,0,871,2,1,204,25,204,0,0,0,0,0,58,49,146,25,0.0,721.9
2101,bb7ce8a6ba7f7cc5,f1d64ae34e088832,2804ce8dadab5770,2021-03-13,2,0,0,871,1,0,220,68,181,39,0,0,39,19,53,38,128,49,121.1,694.0
2102,a6828a6dfb21d33c,b7b84ccd221be298,e132d47bd9efbbe0,2021-03-13,0,0,0,900,2,0,217,60,217,0,0,0,0,0,47,39,170,60,0.0,900.0
2103,a6828a6dfb21d33c,e132d47bd9efbbe0,b7b84ccd221be298,2021-03-13,0,0,0,900,3,0,217,32,217,0,0,0,0,0,31,20,186,32,0.0,879.0
2104,8a7b0cd5ad9ca4fe,5dd180c8b3196786,d05cb1e8d1b885d8,2021-03-13,0,0,0,900,0,0,63,18,63,0,0,0,0,0,15,13,48,18,0.0,385.7
2105,8a7b0cd5ad9ca4fe,d05cb1e8d1b885d8,5dd180c8b3196786,2021-03-13,0,2,0,900,3,2,79,10,71,8,3,3,5,3,14,11,57,7,509.3,327.0
2106,70aa6b8f863e6861,113df4fde64735c6,f2477cf43c4975cc,2021-03-13,1,0,0,483,1,0,110,14,108,2,0,0,2,2,46,34,62,12,3.0,455.0
2107,70aa6b8f863e6861,f2477cf43c4975cc,113df4fde64735c6,2021-03-13,1,0,0,483,0,0,71,16,66,5,0,0,5,3,14,13,52,13,25.0,455.0
2108,4944437e73071671,67f272324a030d00,a67f5afa8d6a1b80,2021-03-13,0,0,0,71,0,0,18,5,18,0,0,0,0,0,0,0,18,5,0.0,58.0
2109,4944437e73071671,a67f5afa8d6a1b80,67f272324a030d00,2021-03-13,1,0,0,71,0,0,29,14,13,16,2,2,14,10,0,0,13,4,13.0,58.0
2110,2c13b938e0f8190b,b1b0729d27936f2f,f1fac969a1d70b08,2021-03-13,0,0,0,318,0,0,26,7,26,0,0,0,0,0,3,1,23,7,0.0,285.0
2111,2c13b938e0f8190b,f1fac969a1d70b08,b1b0729d27936f2f,2021-03-13,0,0,0,318,1,0,39,10,39,0,0,0,0,0,10,9,29,10,0.0,299.0
2112,18c67631b76c18e5,b4c6c904a9ffc5e8,f0feeb2192937424,2021-03-13,0,0,0,900,6,2,116,17,116,0,0,0,0,0,31,17,85,17,0.0,715.9
2113,18c67631b76c18e5,f0feeb2192937424,b4c6c904a9ffc5e8,2021-03-13,0,0,0,900,3,1,135,26,131,4,0,0,4,1,72,51,59,25,25.1,668.0
2114,03bdbf2d18f3025d,90e0985df05e51bc,94527830000ab715,2021-03-13,0,0,0,489,0,0,18,2,18,0,0,0,0,0,2,1,16,2,0.0,489.0
2115,03bdbf2d18f3025d,94527830000ab715,90e0985df05e51bc,2021-03-13,0,1,1,489,4,2,13,0,13,0,0,0,0,0,10,8,3,0,0.0,69.0
2116,01f262b68a6a2223,1a31ef98efce7a79,5d1b7e3dd9e11074,2021-03-13,0,1,0,900,9,2,102,27,98,4,0,0,4,3,36,28,62,24,100.7,726.2
2117,01f262b68a6a2223,5d1b7e3dd9e11074,1a31ef98efce7a79,2021-03-13,0,0,0,900,0,0,150,37,147,3,2,2,1,0,28,22,119,37,22.8,761.3
2118,fd92fe0c494d0959,80fa8218c99f9c58,a0e75f4a13eb73f1,2021-03-06,0,2,1,123,0,0,25,15,16,9,0,0,9,8,3,3,13,7,42.0,81.0
2119,fd92fe0c494d0959,a0e75f4a13eb73f1,80fa8218c99f9c58,2021-03-06,0,0,0,123,1,0,5,0,5,0,0,0,0,0,2,2,3,0,0.0,81.0
2120,f4363f1317b47213,10f3ba6cd2f44a97,e7bba7ce4d6c7b07,2021-03-06,0,0,0,900,9,2,202,51,201,1,0,0,1,0,51,38,150,51,25.4,773.0
2121,f4363f1317b47213,e7bba7ce4d6c7b07,10f3ba6cd2f44a97,2021-03-06,0,0,0,900,2,0,193,41,193,0,0,0,0,0,45,33,148,41,0.0,848.6
2122,e2abba69c3371618,003d82fa384ca1d0,681399317dbf4701,2021-03-06,0,0,0,100,2,0,3,0,3,0,0,0,0,0,1,0,2,0,0.0,36.1
2123,e2abba69c3371618,681399317dbf4701,003d82fa384ca1d0,2021-03-06,1,0,0,100,0,0,63,43,11,52,0,0,52,35,2,2,9,8,52.9,44.0
2124,d170f6580e1c244f,8667caa0451d245b,9014c02eff8b3d62,2021-03-06,1,0,0,499,1,0,148,81,140,8,0,0,8,7,4,1,136,74,2.5,494.0
2125,d170f6580e1c244f,9014c02eff8b3d62,8667caa0451d245b,2021-03-06,0,0,0,499,0,0,227,101,227,0,0,0,0,0,52,45,175,101,0.0,491.5
2126,c096342c57a6f2c4,bc711b6dd95c1af6,ec23c1be628d8057,2021-03-06,0,0,0,347,0,0,42,11,42,0,0,0,0,0,15,10,27,11,0.0,273.5
2127,c096342c57a6f2c4,ec23c1be628d8057,bc711b6dd95c1af6,2021-03-06,1,0,0,347,3,0,30,11,24,6,0,0,6,4,12,12,12,7,64.5,261.0
2128,c06d7bb29bc24d00,275aca31f61ba28c,519e4fe37ce9ff75,2021-03-06,0,2,1,697,4,3,25,12,15,10,0,0,10,9,3,3,12,3,514.5,121.0
2129,c06d7bb29bc24d00,519e4fe37ce9ff75,275aca31f61ba28c,2021-03-06,0,0,0,697,0,0,20,5,15,5,0,0,5,3,5,5,10,2,10.0,170.5
2130,ae5d14a9fc1ad19c,80eacd4da0617c57,b1d19449397541dc,2021-03-06,0,0,0,900,0,0,114,13,113,1,0,0,1,1,57,33,56,12,0.0,736.4
2131,ae5d14a9fc1ad19c,b1d19449397541dc,80eacd4da0617c57,2021-03-06,0,0,0,900,6,5,88,39,82,6,1,1,5,3,22,18,60,36,163.6,600.0
2132,873306ad79b62f5e,07a2bdaa0afdd831,853eb0dd5c0e2149,2021-03-06,0,2,0,295,1,1,17,5,16,1,0,0,1,1,1,1,15,4,195.0,100.0
2133,873306ad79b62f5e,853eb0dd5c0e2149,07a2bdaa0afdd831,2021-03-06,1,0,0,295,0,0,22,8,22,0,0,0,0,0,5,5,17,8,0.0,99.0
2134,7de9867b7cc2b1b1,1338e2c7480bdf9e,99df7d0a2a08a8a8,2021-03-06,0,0,0,1500,0,0,161,32,159,2,0,0,2,1,59,46,100,31,0.7,1179.5
2135,7de9867b7cc2b1b1,99df7d0a2a08a8a8,1338e2c7480bdf9e,2021-03-06,0,0,0,1500,5,3,193,67,175,18,0,0,18,16,47,40,128,51,319.5,1073.3
2136,7ad09f889d2cdb6f,45f7cb591c3ab00b,a845f0735bc67405,2021-03-06,0,1,1,808,1,1,68,23,49,19,1,1,18,15,15,13,34,8,488.0,316.0
2137,7ad09f889d2cdb6f,a845f0735bc67405,45f7cb591c3ab00b,2021-03-06,0,0,0,808,0,0,84,17,82,2,0,0,2,2,8,4,74,15,4.0,316.0
2138,5980ab31e4718a83,60425d07ef4b91a7,efb96bf3e9ada36f,2021-03-06,0,0,0,900,5,3,142,38,139,3,0,0,3,3,30,21,109,35,57.6,760.0
2139,5980ab31e4718a83,efb96bf3e9ada36f,60425d07ef4b91a7,2021-03-06,0,0,0,900,0,0,161,39,159,2,0,0,2,0,41,28,118,39,44.0,776.4
2140,50ef636148fa6fac,3df5493bb279226f,dab8cfbb6b1db10a,2021-03-06,2,0,0,219,0,0,46,22,22,24,2,2,22,15,7,5,15,7,73.0,146.0
2141,50ef636148fa6fac,dab8cfbb6b1db10a,3df5493bb279226f,2021-03-06,0,0,0,219,0,0,7,0,7,0,0,0,0,0,3,1,4,0,0.0,146.0
2142,2704d31de2c2f43b,215a70f073a7b726,c96d9178c9ed9e62,2021-03-06,0,0,0,900,0,0,25,7,20,5,0,0,5,3,7,6,13,4,0.0,367.29999999999995
2143,2704d31de2c2f43b,c96d9178c9ed9e62,215a70f073a7b726,2021-03-06,0,0,0,900,7,4,44,14,26,18,3,3,15,12,14,8,12,2,532.7,101.0
2144,15c9cb5f9320c555,cb696ebfb6598724,d661ce4da776fc20,2021-03-06,0,0,0,1169,17,1,230,40,221,9,5,3,4,2,71,54,150,38,80.2,858.3
2145,15c9cb5f9320c555,d661ce4da776fc20,cb696ebfb6598724,2021-03-06,1,0,0,1169,7,7,137,48,124,13,8,7,5,3,33,31,91,45,105.7,836.8
2146,04a788abbbd1f256,333b9e5c723ac873,dea070ed4a2a8281,2021-03-06,0,0,0,900,2,0,89,8,89,0,0,0,0,0,42,28,47,8,0.0,748.0
2147,04a788abbbd1f256,dea070ed4a2a8281,333b9e5c723ac873,2021-03-06,0,0,0,900,1,0,97,10,97,0,0,0,0,0,56,39,41,10,0.0,900.0
2148,f3ad8ad8d242678e,80d8aed0ca9b00f3,cc8c623cca88f54f,2021-02-27,0,0,0,900,12,3,72,19,69,3,1,1,2,1,15,10,54,18,184.0,341.6
2149,f3ad8ad8d242678e,cc8c623cca88f54f,80d8aed0ca9b00f3,2021-02-27,0,1,0,900,0,0,80,28,76,4,0,0,4,3,27,24,49,25,6.4,652.0
2150,c2ee423d1f0b4f6f,6bd02119599741a4,9c907996820d2d69,2021-02-27,0,0,0,900,0,0,194,35,194,0,0,0,0,0,79,59,115,35,0.0,897.0
2151,c2ee423d1f0b4f6f,9c907996820d2d69,6bd02119599741a4,2021-02-27,0,0,0,900,5,1,193,48,193,0,0,0,0,0,25,17,168,48,0.0,896.0
2152,bc86601cf781a89c,950d0ef5c17157c5,e4277e87a789d687,2021-02-27,2,0,0,900,2,0,156,31,149,7,0,0,7,5,46,35,103,26,44.3,824.0
2153,bc86601cf781a89c,e4277e87a789d687,950d0ef5c17157c5,2021-02-27,0,0,0,900,0,0,137,25,137,0,0,0,0,0,49,32,88,25,0.0,807.7
2154,a7315147a7022a93,4c2d90e335e6df19,70d2329a92864fdb,2021-02-27,0,0,0,900,3,3,83,8,78,5,2,1,3,2,44,40,34,6,530.0,370.0
2155,a7315147a7022a93,70d2329a92864fdb,4c2d90e335e6df19,2021-02-27,0,0,0,900,1,0,165,50,165,0,0,0,0,0,16,14,149,50,0.0,370.0
2156,6a0341234ecc4e87,35b3772629e27a49,7aa3d6964eff4877,2021-02-27,0,0,0,900,16,1,51,10,51,0,0,0,0,0,7,6,44,10,0.0,366.5
2157,6a0341234ecc4e87,7aa3d6964eff4877,35b3772629e27a49,2021-02-27,0,1,0,900,1,1,68,33,60,8,0,0,8,6,19,15,41,27,81.5,676.0
2158,4a704dae3091adaf,2cd428e9606856fd,787bb1f087ccff8a,2021-02-27,0,0,0,1500,0,0,104,14,104,0,0,0,0,0,35,28,69,14,0.0,1432.8
2159,4a704dae3091adaf,787bb1f087ccff8a,2cd428e9606856fd,2021-02-27,0,0,0,1500,14,2,176,33,175,1,1,1,0,0,92,68,83,33,67.2,1231.0
2160,3eac2d47ac252f4b,262a7d06203657e6,d945aae53e3e54e6,2021-02-27,0,0,0,900,0,0,205,15,205,0,0,0,0,0,53,35,152,15,0.0,900.0
2161,3eac2d47ac252f4b,d945aae53e3e54e6,262a7d06203657e6,2021-02-27,0,0,0,900,1,0,183,36,183,0,0,0,0,0,28,17,155,36,0.0,900.0
2162,3a4e2dffcdd1c838,1091d4d957141094,d802174b0c0c1f4e,2021-02-27,0,0,0,900,6,1,120,18,120,0,0,0,0,0,42,29,78,18,0.0,481.9
2163,3a4e2dffcdd1c838,d802174b0c0c1f4e,1091d4d957141094,2021-02-27,0,0,0,900,9,3,92,37,78,14,1,1,13,11,8,5,70,26,314.1,541.0
2164,11a83369d49ad138,e7e01e266a9d4342,ed2a8cc402173781,2021-02-27,1,0,0,758,9,8,121,53,53,68,1,1,67,49,31,23,22,4,425.2,284.5
2165,11a83369d49ad138,ed2a8cc402173781,e7e01e266a9d4342,2021-02-27,0,1,0,758,2,0,46,8,45,1,0,0,1,0,10,7,35,8,4.5,296.8
2166,e175c1a0bff30187,583ee11abddfc581,902ec2cc48c8ae8a,2021-02-20,0,0,0,56,0,0,14,5,14,0,0,0,0,0,5,4,9,5,0.0,55.8
2167,e175c1a0bff30187,902ec2cc48c8ae8a,583ee11abddfc581,2021-02-20,1,0,0,56,0,0,23,11,22,1,0,0,1,1,5,4,17,10,0.2,55.0
2168,c3b6aa47e7532a7b,2b68d9f125d07b42,e2f6b2769aaedd6c,2021-02-20,0,0,0,572,0,0,24,8,24,0,0,0,0,0,5,5,19,8,0.0,63.0
2169,c3b6aa47e7532a7b,e2f6b2769aaedd6c,2b68d9f125d07b42,2021-02-20,1,0,0,572,3,3,72,51,17,55,0,0,55,44,0,0,17,7,509.0,63.0
2170,b9cd4910f0ecff45,24656ef4d605c96f,dc3b9cf7641b7ab6,2021-02-20,1,0,0,185,0,0,11,8,9,2,0,0,2,2,1,1,8,6,5.0,175.0
2171,b9cd4910f0ecff45,dc3b9cf7641b7ab6,24656ef4d605c96f,2021-02-20,0,0,0,185,0,0,33,6,33,0,0,0,0,0,6,5,27,6,0.0,180.0
2172,b12bc15f384ecc42,d3df1add9d9a7efb,fa6796c55d6c5440,2021-02-20,1,0,0,386,0,0,23,6,21,2,0,0,2,2,2,1,19,4,0.0,386.0
2173,b12bc15f384ecc42,fa6796c55d6c5440,d3df1add9d9a7efb,2021-02-20,0,0,0,386,3,0,52,18,52,0,0,0,0,0,10,10,42,18,0.0,371.0
2174,a4814d682954e8ab,3143bf892608139a,b9706f80d005036c,2021-02-20,0,0,0,900,0,0,60,7,35,25,13,12,12,6,32,28,3,1,157.7,591.0
2175,a4814d682954e8ab,b9706f80d005036c,3143bf892608139a,2021-02-20,0,0,0,900,8,3,16,3,16,0,0,0,0,0,6,4,10,3,0.0,224.3
2176,990c2378caec68d4,5fa2974cbd18e05c,fc9a9559a05f2704,2021-02-20,1,0,0,284,0,0,57,23,51,6,1,1,5,5,22,18,29,18,3.0,268.0
2177,990c2378caec68d4,fc9a9559a05f2704,5fa2974cbd18e05c,2021-02-20,0,0,0,284,1,1,66,10,63,3,1,1,2,0,15,6,48,10,12.0,269.0
2178,931fd51ab69fb443,0de720c0f1d4ab9c,7026eca45f65377b,2021-02-20,0,0,0,900,1,1,113,23,113,0,0,0,0,0,22,16,91,23,0.0,662.8
2179,931fd51ab69fb443,7026eca45f65377b,0de720c0f1d4ab9c,2021-02-20,0,0,0,900,7,2,131,41,118,13,1,1,12,8,41,40,77,33,227.2,533.0
2180,8f7328fe18806fb0,98c23cb6da5b3352,d0aaedcf7ccd0b45,2021-02-20,0,0,0,115,1,0,10,3,10,0,0,0,0,0,2,2,8,3,0.0,80.1
2181,8f7328fe18806fb0,d0aaedcf7ccd0b45,98c23cb6da5b3352,2021-02-20,1,0,0,115,0,0,56,32,52,4,0,0,4,4,2,2,50,28,10.9,96.0
2182,82243207b4dfce87,34e516ab361afb1c,40093d1d2d78394e,2021-02-20,1,3,0,900,5,4,60,35,38,22,1,1,21,18,10,9,28,17,572.0,146.0
2183,82243207b4dfce87,40093d1d2d78394e,34e516ab361afb1c,2021-02-20,0,2,0,900,1,0,25,9,17,8,0,0,8,7,8,6,9,2,0.0,328.0
2184,1d892fec31dc7ad7,04835018f90b118c,122ac9b816d8b71c,2021-02-20,1,1,0,521,6,4,68,44,25,43,1,1,42,30,5,4,20,14,435.9,68.5
2185,1d892fec31dc7ad7,122ac9b816d8b71c,04835018f90b118c,2021-02-20,0,0,0,521,0,0,28,9,24,4,0,0,4,2,7,7,17,7,6.5,72.10000000000002
2186,15b1c7ddc4415fdd,3738e68d2261e60f,399afbabc02376b5,2021-02-20,0,0,0,369,0,0,55,8,55,0,0,0,0,0,15,12,40,8,0.0,369.0
2187,15b1c7ddc4415fdd,399afbabc02376b5,3738e68d2261e60f,2021-02-20,0,1,1,369,1,1,60,22,60,0,0,0,0,0,16,15,44,22,0.0,232.0
2188,05ceb8b2f93993a6,547afe1017e72dbe,881bf86d4cba8578,2021-02-20,0,0,0,900,7,4,54,13,53,1,0,0,1,1,23,18,30,12,55.5,233.8
2189,05ceb8b2f93993a6,881bf86d4cba8578,547afe1017e72dbe,2021-02-20,0,0,0,900,0,0,93,39,92,1,0,0,1,1,22,18,70,38,0.2,837.5
2190,be94e5b7a35ce5f2,23024fdfc966410a,f1b2aa7853d1ed6e,2021-02-13,0,0,0,634,3,0,108,18,108,0,0,0,0,0,33,27,75,18,0.0,522.9
2191,be94e5b7a35ce5f2,f1b2aa7853d1ed6e,23024fdfc966410a,2021-02-13,2,0,0,634,0,0,136,56,104,32,16,15,16,11,15,12,89,45,111.1,509.0
2192,96b1430379c0694a,093e1f5bb73850be,260e9e0d4954aea6,2021-02-13,0,2,1,413,0,0,50,28,50,0,0,0,0,0,5,4,45,28,0.0,184.0
2193,96b1430379c0694a,260e9e0d4954aea6,093e1f5bb73850be,2021-02-13,0,0,0,413,10,4,26,9,23,3,0,0,3,0,0,0,23,9,144.0,173.0
2194,9201312dd860fa5a,c549573c0df4d676,d0e1b42d41dab603,2021-02-13,0,1,0,857,11,5,65,16,60,5,1,1,4,2,18,15,42,14,210.4,261.1
2195,9201312dd860fa5a,d0e1b42d41dab603,c549573c0df4d676,2021-02-13,0,4,1,857,1,0,100,37,88,12,0,0,12,8,6,4,82,29,48.9,532.6
2196,8cf076524cad5a55,b1b0729d27936f2f,e9213f53ddeca978,2021-02-13,0,0,0,900,10,1,264,109,264,0,0,0,0,0,32,20,232,109,0.0,738.0
2197,8cf076524cad5a55,e9213f53ddeca978,b1b0729d27936f2f,2021-02-13,0,0,0,900,1,0,203,26,203,0,0,0,0,0,47,43,156,26,0.0,900.0
2198,54e2490959f66dc2,5987b2458f4b5290,7be14eaed4c74856,2021-02-13,0,1,0,900,9,6,98,25,83,15,7,5,8,5,18,15,65,20,308.8,406.0
2199,54e2490959f66dc2,7be14eaed4c74856,5987b2458f4b5290,2021-02-13,0,0,0,900,0,0,73,7,73,0,0,0,0,0,17,12,56,7,0.0,579.2
2200,357c5b86ec83b826,5eb50529a8418b77,8e382b585a92affe,2021-02-13,2,1,0,900,2,2,152,36,133,19,7,6,12,9,33,28,100,27,141.0,535.5
2201,357c5b86ec83b826,8e382b585a92affe,5eb50529a8418b77,2021-02-13,0,0,0,900,6,2,86,25,85,1,0,0,1,1,19,17,66,24,171.5,416.0
2202,26fbf026beb8e9f8,2e585c701f72fe55,8c0580d4fff106c1,2021-02-13,0,2,0,900,6,1,67,10,64,3,0,0,3,1,25,17,39,9,71.0,719.7
2203,26fbf026beb8e9f8,8c0580d4fff106c1,2e585c701f72fe55,2021-02-13,0,0,0,900,14,6,84,20,80,4,0,0,4,2,22,18,58,18,109.3,419.0
2204,25b8c932da5e91f4,6a740daf1b279661,e8b731feff72294b,2021-02-13,0,0,0,900,5,3,152,23,150,2,0,0,2,2,22,17,128,21,11.8,706.0
2205,25b8c932da5e91f4,e8b731feff72294b,6a740daf1b279661,2021-02-13,0,1,0,900,0,0,81,24,81,0,0,0,0,0,24,14,57,24,0.0,578.2
2206,17616514e8fdacb9,19b7738321cfae42,9673a497a9da119a,2021-02-13,0,0,0,198,1,1,7,1,7,0,0,0,0,0,4,4,3,1,0.0,53.0
2207,17616514e8fdacb9,9673a497a9da119a,19b7738321cfae42,2021-02-13,0,5,1,198,0,0,16,0,16,0,0,0,0,0,4,4,12,0,0.0,180.0
2208,f4fbb11055301e75,511e82663651438d,c47df9303d318c67,2021-02-06,0,0,0,900,0,0,126,52,121,5,0,0,5,5,13,6,108,47,83.2,644.1
2209,f4fbb11055301e75,c47df9303d318c67,511e82663651438d,2021-02-06,0,1,0,900,7,3,89,31,86,3,1,1,2,2,17,17,69,29,72.9,403.8
2210,eb4e9ec015533ab4,45e738622ea2c02c,ea3dcc417c322064,2021-02-06,0,0,0,900,6,4,76,37,33,43,1,1,42,32,22,17,11,5,648.8,209.0
2211,eb4e9ec015533ab4,ea3dcc417c322064,45e738622ea2c02c,2021-02-06,0,0,0,900,0,0,28,7,24,4,0,0,4,2,5,1,19,5,12.0,236.20000000000005
2212,d65da3a3bc675449,51018a31ddf31eb2,e99821959a840bb8,2021-02-06,0,1,0,900,0,0,47,17,40,7,0,0,7,5,22,20,18,12,18.4,554.0
2213,d65da3a3bc675449,e99821959a840bb8,51018a31ddf31eb2,2021-02-06,0,1,0,900,9,7,58,20,50,8,1,1,7,7,18,15,32,13,296.0,178.6
2214,bbade63ca780668f,08af939f41b5a57b,f53d4f21d1b5f2dc,2021-02-06,0,0,0,900,15,5,116,46,98,18,1,0,17,8,17,16,81,38,346.7,423.2
2215,bbade63ca780668f,f53d4f21d1b5f2dc,08af939f41b5a57b,2021-02-06,0,0,0,900,1,0,121,43,114,7,1,1,6,3,16,10,98,40,33.8,495.3
2216,af8ea6db042674ef,18b602842a24f7c5,687c15b2eddfaa63,2021-02-06,0,0,0,592,0,0,24,3,24,0,0,0,0,0,17,13,7,3,0.0,129.0
2217,af8ea6db042674ef,687c15b2eddfaa63,18b602842a24f7c5,2021-02-06,0,2,1,592,7,4,29,27,2,27,1,1,26,26,1,1,1,1,459.0,133.0
2218,9ef858837dfc65eb,65f09bacd3957381,f2688492b9a525a3,2021-02-06,1,0,0,28,0,0,5,1,5,0,0,0,0,0,2,1,3,1,0.0,28.0
2219,9ef858837dfc65eb,f2688492b9a525a3,65f09bacd3957381,2021-02-06,0,0,0,28,0,0,3,1,3,0,0,0,0,0,1,1,2,1,0.0,28.0
2220,8c34e1e0d842618d,351c4ec637380ad5,f9ab66e67240db7b,2021-02-06,0,0,0,900,6,4,84,33,60,24,0,0,24,19,29,24,31,14,425.1,225.8
2221,8c34e1e0d842618d,f9ab66e67240db7b,351c4ec637380ad5,2021-02-06,0,0,0,900,3,1,59,22,54,5,0,0,5,4,23,16,31,18,1.2,472.9
2222,8b9bdacca749ec90,279566840aa55bf2,b4ad3a06ee4d660c,2021-02-06,1,0,0,426,0,0,88,47,83,5,0,0,5,3,7,7,76,44,2.4,415.0
2223,8b9bdacca749ec90,b4ad3a06ee4d660c,279566840aa55bf2,2021-02-06,0,0,0,426,1,0,20,3,20,0,0,0,0,0,7,7,13,3,0.0,408.6
2224,86d6e09932c5b551,52c2ae6d2f2d2613,a68575214ecad140,2021-02-06,0,1,0,900,9,3,47,12,46,1,0,0,1,1,13,11,33,11,89.7,589.9
2225,86d6e09932c5b551,a68575214ecad140,52c2ae6d2f2d2613,2021-02-06,0,0,0,900,3,2,109,25,106,3,1,1,2,2,24,15,82,23,41.1,591.3
2226,3ac61bcb406e1a0c,6d68c1afe954f121,c9587d81e1d33925,2021-02-06,1,0,0,26,0,0,6,5,1,5,0,0,5,4,0,0,1,1,2.0,24.0
2227,3ac61bcb406e1a0c,c9587d81e1d33925,6d68c1afe954f121,2021-02-06,0,0,0,26,0,0,3,0,3,0,0,0,0,0,2,2,1,0,0.0,24.0
2228,2c81668d1459991f,5d1b7e3dd9e11074,a0f0004aadf10b71,2021-02-06,0,0,0,900,7,2,91,36,91,0,0,0,0,0,15,13,76,36,0.0,859.0
2229,2c81668d1459991f,a0f0004aadf10b71,5d1b7e3dd9e11074,2021-02-06,0,0,0,900,1,0,149,27,147,2,0,0,2,1,66,47,81,26,16.0,876.0
2230,cd08b68f0bafafbf,beecb672a279223e,cd2c4d30c6e13b47,2021-01-23,0,0,0,354,1,1,23,4,17,6,0,0,6,3,4,3,13,1,187.7,129.9
2231,cd08b68f0bafafbf,cd2c4d30c6e13b47,beecb672a279223e,2021-01-23,1,0,0,354,0,0,36,14,28,8,0,0,8,7,3,1,25,7,5.1,159.3
2232,c597fd8bb66d54d8,6370c1c1e12723d5,749f572d1d3161fb,2021-01-23,0,0,0,900,2,0,216,33,216,0,0,0,0,0,85,69,131,33,0.0,895.0
2233,c597fd8bb66d54d8,749f572d1d3161fb,6370c1c1e12723d5,2021-01-23,0,0,0,900,0,0,148,29,148,0,0,0,0,0,28,20,120,29,0.0,900.0
2234,c4ea3f6fae702459,12f91bfa8f1f723b,f72465a784c1b084,2021-01-23,0,0,0,900,3,1,240,52,240,0,0,0,0,0,118,96,122,52,0.0,873.6
2235,c4ea3f6fae702459,f72465a784c1b084,12f91bfa8f1f723b,2021-01-23,0,0,0,900,4,1,173,39,172,1,0,0,1,1,46,38,126,38,7.4,597.0
2236,aaf45b095452be23,55fa6ce3e522c8bb,6d35bf94f7d30241,2021-01-23,0,0,0,900,3,1,132,22,130,2,0,0,2,0,48,37,82,22,13.5,764.0
2237,aaf45b095452be23,6d35bf94f7d30241,55fa6ce3e522c8bb,2021-01-23,0,0,0,900,3,2,169,40,166,3,0,0,3,2,41,28,125,38,109.0,668.5
2238,a5075f4eaee6036f,193b9d1858bc4df3,4b93a88f3b1de35b,2021-01-23,0,0,0,150,0,0,19,0,19,0,0,0,0,0,13,8,6,0,0.0,141.0
2239,a5075f4eaee6036f,4b93a88f3b1de35b,193b9d1858bc4df3,2021-01-23,1,0,0,150,0,0,24,12,11,13,0,0,13,10,7,5,4,2,9.0,141.0
2240,99dbe9669f31ed91,dccb63727f2f5f74,eae48ff31db420c2,2021-01-23,0,0,0,900,2,0,57,8,57,0,0,0,0,0,11,8,46,8,0.0,631.2
2241,99dbe9669f31ed91,eae48ff31db420c2,dccb63727f2f5f74,2021-01-23,0,0,0,900,12,10,103,32,94,9,2,2,7,4,19,16,75,28,266.8,396.0
2242,92f569a6d9374b86,0c6d9ea8306c029e,52e76bb4b3e852f3,2021-01-23,0,0,0,900,0,0,108,28,108,0,0,0,0,0,32,26,76,28,0.0,895.0
2243,92f569a6d9374b86,52e76bb4b3e852f3,0c6d9ea8306c029e,2021-01-23,0,0,0,900,12,1,103,24,103,0,0,0,0,0,10,10,93,24,0.0,512.0
2244,83da743f6dda7dcc,3253b16d38ae087d,7be74a12d7352df2,2021-01-23,0,1,1,819,1,1,76,27,67,9,0,0,9,8,11,11,56,19,82.9,443.5
2245,83da743f6dda7dcc,7be74a12d7352df2,3253b16d38ae087d,2021-01-23,0,0,0,819,3,3,54,10,49,5,0,0,5,3,15,11,34,7,200.5,295.1
2246,65352221c0bfe52d,ea7e5bc78d9de658,fccf811c1e8b01c7,2021-01-23,1,0,0,779,2,0,174,52,172,2,0,0,2,2,35,27,137,50,3.6,763.0
2247,65352221c0bfe52d,fccf811c1e8b01c7,ea7e5bc78d9de658,2021-01-23,0,0,0,779,2,0,141,34,141,0,0,0,0,0,23,14,118,34,0.0,753.4
2248,3d3e7dc7b4bf2bc4,029eaff01e6bb8f0,f4c49976c75c5ab2,2021-01-23,1,0,0,452,1,1,91,30,89,2,0,0,2,2,22,18,67,28,102.0,350.0
2249,3d3e7dc7b4bf2bc4,f4c49976c75c5ab2,029eaff01e6bb8f0,2021-01-23,0,0,0,452,1,0,66,23,66,0,0,0,0,0,6,6,60,23,0.0,283.0
2250,ddbe6fd66d7f9e35,3cf18e01cb6cbde3,79cb2a690b9ba5e8,2021-01-20,0,0,0,900,0,0,127,22,127,0,0,0,0,0,40,28,87,22,0.0,900.0
2251,ddbe6fd66d7f9e35,79cb2a690b9ba5e8,3cf18e01cb6cbde3,2021-01-20,0,0,0,900,1,0,123,20,123,0,0,0,0,0,21,8,102,20,0.0,898.0
2252,dd34dd337e637767,49ee5024966efc0d,d317a5e2b3f88c5f,2021-01-20,0,0,0,155,0,0,2,1,2,0,0,0,0,0,1,1,1,1,0.0,65.0
2253,dd34dd337e637767,d317a5e2b3f88c5f,49ee5024966efc0d,2021-01-20,1,0,0,155,1,1,21,9,15,6,0,0,6,6,9,8,6,3,48.0,59.0
2254,d27ac1bc677b89cf,396fe87b84ac2e1c,3a314d9fa7c6825d,2021-01-20,0,0,0,900,4,1,115,29,105,10,0,0,10,5,23,19,82,24,61.7,789.0
2255,d27ac1bc677b89cf,3a314d9fa7c6825d,396fe87b84ac2e1c,2021-01-20,0,0,0,900,2,1,108,16,108,0,0,0,0,0,34,23,74,16,0.0,757.3
2256,ae38fb2a6b6a0cc1,34ff304266360297,9dedfdd91070ddd8,2021-01-20,1,0,0,548,1,1,100,31,97,3,0,0,3,1,28,22,69,30,14.2,463.0
2257,ae38fb2a6b6a0cc1,9dedfdd91070ddd8,34ff304266360297,2021-01-20,0,0,0,548,1,0,81,7,81,0,0,0,0,0,22,10,59,7,0.0,531.8
2258,ac475de5a3d0d7e2,1588b787bda7b540,16690d100f995f8f,2021-01-20,0,3,0,401,1,0,4,0,4,0,0,0,0,0,2,1,2,0,0.0,67.0
2259,ac475de5a3d0d7e2,16690d100f995f8f,1588b787bda7b540,2021-01-20,0,1,1,401,5,2,38,23,7,31,0,0,31,21,4,2,3,2,274.0,127.0
2260,a003e8305d4dbdc8,36541f1e6c5d4955,4498b382c65a7faa,2021-01-20,0,1,0,900,4,4,198,79,194,4,0,0,4,0,11,7,183,79,124.0,714.0
2261,a003e8305d4dbdc8,4498b382c65a7faa,36541f1e6c5d4955,2021-01-20,0,0,0,900,5,0,184,40,184,0,0,0,0,0,7,6,177,40,0.0,737.0
2262,76b61ff4c9760f79,2ac4628c08ec5125,ce632027bf2a871b,2021-01-20,0,1,0,900,1,0,49,7,49,0,0,0,0,0,23,18,26,7,0.0,337.8
2263,76b61ff4c9760f79,ce632027bf2a871b,2ac4628c08ec5125,2021-01-20,0,0,0,900,2,1,65,17,42,23,7,7,16,12,11,5,31,5,301.2,494.0
2264,61bedad39b15db7a,84b3e7d38f2d2ec5,c58f51dedb310998,2021-01-20,0,1,0,1500,3,1,50,7,50,0,0,0,0,0,8,5,42,7,0.0,524.1
2265,61bedad39b15db7a,c58f51dedb310998,84b3e7d38f2d2ec5,2021-01-20,0,0,0,1500,6,4,52,19,31,21,0,0,21,13,9,5,22,6,840.9,579.0
2266,57e784028ef2c17d,67c1d46f4ed16f9e,6e00cfffd54653c4,2021-01-20,0,0,0,900,0,0,214,69,214,0,0,0,0,0,19,16,195,69,0.0,900.0
2267,57e784028ef2c17d,6e00cfffd54653c4,67c1d46f4ed16f9e,2021-01-20,0,0,0,900,0,0,193,36,193,0,0,0,0,0,29,22,164,36,0.0,900.0
2268,4f6d3cdf2c77fb57,acb36c908d415c4a,f9d0cae37dabfafc,2021-01-20,0,0,0,339,0,0,42,4,42,0,0,0,0,0,32,20,10,4,0.0,339.0
2269,4f6d3cdf2c77fb57,f9d0cae37dabfafc,acb36c908d415c4a,2021-01-20,1,0,0,339,0,0,56,18,56,0,0,0,0,0,9,6,47,18,0.0,339.0
2270,4e451881e0e47b05,c9587d81e1d33925,cdadae5363b66eef,2021-01-20,0,0,0,900,5,0,134,12,134,0,0,0,0,0,44,19,90,12,0.0,537.4
2271,4e451881e0e47b05,cdadae5363b66eef,c9587d81e1d33925,2021-01-20,0,0,0,900,6,4,53,11,44,9,2,1,7,4,23,17,21,7,295.6,473.0
2272,4abcf14faa7f92f2,5987b2458f4b5290,8765559b6a29a421,2021-01-20,0,1,1,540,10,7,32,14,19,13,0,0,13,10,4,3,15,4,286.7,121.0
2273,4abcf14faa7f92f2,8765559b6a29a421,5987b2458f4b5290,2021-01-20,0,0,0,540,0,0,14,4,14,0,0,0,0,0,3,2,11,4,0.0,253.3
2274,11558384f80f6506,2b6fc1c02736833d,2f6a993c7f547c13,2021-01-20,0,1,1,519,11,5,41,14,40,1,0,0,1,1,16,11,24,13,25.3,342.0
2275,11558384f80f6506,2f6a993c7f547c13,2b6fc1c02736833d,2021-01-20,0,0,0,519,0,0,30,2,30,0,0,0,0,0,10,5,20,2,0.0,485.7
2276,031e6624f96aceb8,f6ad6a1e4d600e0d,fb3e61720be4690c,2021-01-20,0,0,0,900,4,1,313,83,306,7,0,0,7,2,48,34,258,81,12.8,837.9
2277,031e6624f96aceb8,fb3e61720be4690c,f6ad6a1e4d600e0d,2021-01-20,0,0,0,900,9,3,207,54,203,4,0,0,4,3,76,54,127,51,11.1,837.2
2278,aeb7ff8ce6e1beac,6d1bffff14897645,e64b96c07d7ce999,2021-01-16,0,0,0,265,0,0,18,7,18,0,0,0,0,0,4,4,14,7,0.0,263.0
2279,aeb7ff8ce6e1beac,e64b96c07d7ce999,6d1bffff14897645,2021-01-16,1,0,0,265,0,0,50,6,49,1,0,0,1,1,20,15,29,5,2.0,263.0
2280,a4817b7e46028b4a,150ff4cc642270b9,751de04455cfaac0,2021-01-16,0,0,0,1500,1,0,744,274,744,0,0,0,0,0,191,171,553,274,0.0,1473.0
2281,a4817b7e46028b4a,751de04455cfaac0,150ff4cc642270b9,2021-01-16,0,0,0,1500,2,0,283,99,283,0,0,0,0,0,46,34,237,99,0.0,1495.0
2282,97c80f69ac312030,539ed332b3078821,9b7dfb3b7d99926a,2021-01-16,0,0,0,900,1,0,200,12,200,0,0,0,0,0,38,32,162,12,0.0,900.0
2283,97c80f69ac312030,9b7dfb3b7d99926a,539ed332b3078821,2021-01-16,0,0,0,900,0,0,169,43,169,0,0,0,0,0,18,13,151,43,0.0,896.0
2284,97ad63e644757cf4,f9ab66e67240db7b,fdbefee0827e1567,2021-01-16,0,1,0,900,3,0,178,44,165,13,1,1,12,10,72,43,93,34,44.8,768.5
2285,97ad63e644757cf4,fdbefee0827e1567,f9ab66e67240db7b,2021-01-16,0,0,0,900,2,1,129,34,126,3,3,2,0,0,35,22,91,34,62.5,626.2
2286,775c1f401815bbd8,77d7295d1b22c694,b9437600497350f3,2021-01-16,1,0,0,132,0,0,23,6,20,3,1,1,2,2,5,5,15,4,1.0,131.0
2287,775c1f401815bbd8,b9437600497350f3,77d7295d1b22c694,2021-01-16,0,0,0,132,0,0,22,2,22,0,0,0,0,0,3,1,19,2,0.0,131.0
2288,6b0da0b1cda7799f,31123249b0bbf52e,f9f07bb5a43535ed,2021-01-16,0,0,0,900,6,1,37,13,26,11,2,2,9,7,13,13,13,6,211.9,315.0
2289,6b0da0b1cda7799f,f9f07bb5a43535ed,31123249b0bbf52e,2021-01-16,0,0,0,900,4,2,88,30,73,15,0,0,15,12,15,9,58,18,219.0,396.1
2290,3fcd53eb27945231,3bb2dc8e87b10a46,abd5fb12437eda21,2021-01-16,0,0,0,900,1,1,114,24,113,1,0,0,1,1,26,20,87,23,5.2,703.5
2291,3fcd53eb27945231,abd5fb12437eda21,3bb2dc8e87b10a46,2021-01-16,0,0,0,900,9,4,101,36,96,5,0,0,5,5,20,17,76,31,70.5,626.8
2292,3d903bc35023f50a,305d73ede05e31ad,637bd06c32219f0b,2021-01-16,1,0,0,900,2,1,182,81,181,1,0,0,1,0,16,14,165,81,45.6,653.2
2293,3d903bc35023f50a,637bd06c32219f0b,305d73ede05e31ad,2021-01-16,0,1,0,900,18,1,201,47,198,3,0,0,3,1,29,17,169,46,18.8,785.4
2294,358f816aff469270,64facb6cc564262d,866fd7b1a6c90e7f,2021-01-16,2,0,0,288,1,0,66,25,56,10,1,1,9,4,5,4,51,21,25.3,250.0
2295,358f816aff469270,866fd7b1a6c90e7f,64facb6cc564262d,2021-01-16,0,0,0,288,0,0,57,15,57,0,0,0,0,0,8,7,49,15,0.0,258.7
2296,0165bd3c26f0c076,a2ea77e974c5889f,e13abac8089a801a,2021-01-16,0,0,0,900,1,0,142,46,142,0,0,0,0,0,39,31,103,46,0.0,859.0
2297,0165bd3c26f0c076,e13abac8089a801a,a2ea77e974c5889f,2021-01-16,0,0,0,900,2,0,148,50,148,0,0,0,0,0,41,36,107,50,0.0,787.0
2298,f2fb049980631302,38c7f72747f4f712,f7467152fd9f18a2,2020-12-19,0,1,0,900,2,0,14,7,9,5,0,0,5,5,2,2,7,2,61.0,104.0
2299,f2fb049980631302,f7467152fd9f18a2,38c7f72747f4f712,2020-12-19,0,1,0,900,1,1,37,21,14,23,5,4,18,18,2,2,12,3,735.0,72.0
2300,cd150cd28738a7c5,85073dbd1be65ed9,c9cf753cfdf77fc2,2020-12-19,0,0,0,571,0,0,91,29,91,0,0,0,0,0,26,21,65,29,0.0,482.0
2301,cd150cd28738a7c5,c9cf753cfdf77fc2,85073dbd1be65ed9,2020-12-19,1,0,0,571,4,1,101,34,74,27,1,1,26,17,18,16,56,17,87.0,484.0
2302,c7375d5db21cbaae,4a28cb716c19157a,b997be68943010fc,2020-12-19,0,0,0,1500,0,0,406,124,406,0,0,0,0,0,52,47,354,124,0.0,1500.0
2303,c7375d5db21cbaae,b997be68943010fc,4a28cb716c19157a,2020-12-19,0,0,0,1500,0,0,179,71,179,0,0,0,0,0,18,14,161,71,0.0,1274.0
2304,8955ea3c7c332e6c,05339613bf8e9808,fea79f9bc8c68769,2020-12-19,1,0,0,227,0,0,37,27,19,18,1,1,17,15,2,2,17,12,36.0,38.0
2305,8955ea3c7c332e6c,fea79f9bc8c68769,05339613bf8e9808,2020-12-19,0,0,0,227,3,2,12,8,9,3,0,0,3,1,2,1,7,7,151.0,40.0
2306,62e6eadbb2805760,09e62c450e754913,7f6ed67d3ed3c036,2020-12-19,0,1,1,198,1,0,14,4,14,0,0,0,0,0,7,2,7,4,0.0,157.5
2307,62e6eadbb2805760,7f6ed67d3ed3c036,09e62c450e754913,2020-12-19,0,0,0,198,2,2,32,17,30,2,0,0,2,2,4,4,26,15,40.5,117.0
2308,4cb249714ff56656,4234f0097c83fa62,91dac5e69e28d5b5,2020-12-19,0,0,0,900,4,2,104,43,97,7,1,1,6,6,9,5,88,37,196.5,502.4
2309,4cb249714ff56656,91dac5e69e28d5b5,4234f0097c83fa62,2020-12-19,0,0,0,900,2,0,143,57,142,1,0,0,1,1,38,35,104,56,4.6,569.5
2310,3d35eb2d46bf74de,2558ae2e5671e318,595db60957de51d3,2020-12-19,0,0,0,900,0,0,127,23,127,0,0,0,0,0,53,32,74,23,0.0,850.5
2311,3d35eb2d46bf74de,595db60957de51d3,2558ae2e5671e318,2020-12-19,0,1,0,900,2,2,79,24,77,2,0,0,2,2,26,20,51,22,13.5,819.0
2312,1c4602efe5587902,cbb682f5fcc44bfc,cdb96af67d096b1e,2020-12-19,0,0,0,900,1,0,80,26,78,2,0,0,2,1,29,24,49,25,108.8,496.8
2313,1c4602efe5587902,cdb96af67d096b1e,cbb682f5fcc44bfc,2020-12-19,0,0,0,900,5,1,78,22,71,7,0,0,7,5,17,9,54,17,131.2,641.2
2314,0fe4906754b2d0f9,6aae253467e8f9ce,830f60497fab345a,2020-12-19,1,0,0,900,2,0,187,70,181,6,0,0,6,4,54,50,127,66,14.9,729.0
2315,0fe4906754b2d0f9,830f60497fab345a,6aae253467e8f9ce,2020-12-19,0,0,0,900,4,1,81,28,81,0,0,0,0,0,13,12,68,28,0.0,851.1
2316,014f1da2083ca174,7c7332319c14094c,d0f3959b4a9747e6,2020-12-19,0,0,0,900,3,0,82,8,82,0,0,0,0,0,49,38,33,8,0.0,729.0
2317,014f1da2083ca174,d0f3959b4a9747e6,7c7332319c14094c,2020-12-19,0,0,0,900,2,0,70,17,70,0,0,0,0,0,32,27,38,17,0.0,603.0
2318,fe3ff5b1d9135add,63def5a5662a6917,787bb1f087ccff8a,2020-12-12,0,0,0,454,1,0,35,6,35,0,0,0,0,0,9,4,26,6,0.0,445.7
2319,fe3ff5b1d9135add,787bb1f087ccff8a,63def5a5662a6917,2020-12-12,1,0,0,454,0,0,80,13,78,2,0,0,2,2,52,46,26,11,8.3,429.0
2320,cb7616f92a9a4e5b,b6452706b373eea1,c814b4c899793af6,2020-12-12,0,0,0,245,1,0,37,10,37,0,0,0,0,0,5,5,32,10,0.0,241.0
2321,cb7616f92a9a4e5b,c814b4c899793af6,b6452706b373eea1,2020-12-12,1,0,0,245,1,0,35,7,34,1,1,1,0,0,16,13,18,7,4.0,241.0
2322,c258996570faeec9,792be9a24df82ed6,aa72b0f831d0bfe5,2020-12-12,0,0,0,1500,8,4,248,118,245,3,0,0,3,2,21,14,224,116,74.6,1267.4
2323,c258996570faeec9,aa72b0f831d0bfe5,792be9a24df82ed6,2020-12-12,0,0,0,1500,4,2,238,93,227,11,0,0,11,8,57,44,170,85,33.6,1370.4
2324,b7b867eb3c3cf163,07225ba28ae309b6,22a92d7f62195791,2020-12-12,0,3,0,900,3,3,63,26,34,29,7,7,22,17,13,8,21,9,699.0,197.2
2325,b7b867eb3c3cf163,22a92d7f62195791,07225ba28ae309b6,2020-12-12,0,0,0,900,0,0,42,14,39,3,0,0,3,3,13,5,26,11,3.8,196.0
2326,87d0b767742d3239,aa171d55d4b5208f,da816417a579a0bd,2020-12-12,0,0,0,900,3,0,178,45,173,5,0,0,5,0,51,39,122,45,3.1,853.6
2327,87d0b767742d3239,da816417a579a0bd,aa171d55d4b5208f,2020-12-12,0,0,0,900,13,7,166,68,163,3,0,0,3,3,44,38,119,65,21.4,582.9
2328,5ddf45e816a50fac,31ef8b67e13495b3,e94085e821bd81de,2020-12-12,1,0,0,300,1,1,103,27,103,0,0,0,0,0,32,25,71,27,0.0,285.0
2329,5ddf45e816a50fac,e94085e821bd81de,31ef8b67e13495b3,2020-12-12,0,0,0,300,1,0,53,9,53,0,0,0,0,0,20,11,33,9,0.0,249.0
2330,4a172a5191cb8e60,3a46b268013afede,7a703c565ccaa18f,2020-12-12,1,0,0,105,0,0,18,14,4,14,0,0,14,12,1,1,3,2,1.8,16.0
2331,4a172a5191cb8e60,7a703c565ccaa18f,3a46b268013afede,2020-12-12,0,0,0,105,3,2,2,2,0,2,0,0,2,2,0,0,0,0,87.0,16.2
2332,33d52ac2d70b8415,971246648e162f0d,d21113c9ff3788ae,2020-12-12,0,2,1,782,6,0,117,18,115,2,0,0,2,2,51,39,64,16,44.0,738.0
2333,33d52ac2d70b8415,d21113c9ff3788ae,971246648e162f0d,2020-12-12,0,0,0,782,0,0,87,17,87,0,0,0,0,0,35,31,52,17,0.0,673.0
2334,27200d53ba9020b8,7447e9f28508106a,7dda2cf308f24a02,2020-12-12,0,0,0,900,5,0,174,57,171,3,0,0,3,3,31,25,140,54,19.2,732.9
2335,27200d53ba9020b8,7dda2cf308f24a02,7447e9f28508106a,2020-12-12,0,0,0,900,1,1,134,46,132,2,0,0,2,2,21,17,111,44,13.1,716.8
2336,022bdd58cc6e571d,361d49960a196976,d247691a6c0e9034,2020-12-12,0,1,0,412,2,1,45,9,45,0,0,0,0,0,17,12,28,9,0.0,306.5
2337,022bdd58cc6e571d,d247691a6c0e9034,361d49960a196976,2020-12-12,2,0,0,412,1,1,66,35,57,9,0,0,9,6,15,11,42,29,70.5,318.0
2338,c4d1c4b82cf34afb,92fa1401b7927da3,fcd448a2fe1a23cc,2020-12-05,0,0,0,900,0,0,272,88,272,0,0,0,0,0,47,35,225,88,0.0,898.0
2339,c4d1c4b82cf34afb,fcd448a2fe1a23cc,92fa1401b7927da3,2020-12-05,0,0,0,900,0,0,197,58,197,0,0,0,0,0,29,22,168,58,0.0,900.0
2340,b1be8b41b1a4fd85,29af297d9f1de0f8,54f64b5e283b0ce7,2020-12-05,0,0,0,158,0,0,52,10,52,0,0,0,0,0,12,6,40,10,0.0,144.0
2341,b1be8b41b1a4fd85,54f64b5e283b0ce7,29af297d9f1de0f8,2020-12-05,1,0,0,158,0,0,63,12,62,1,0,0,1,1,29,19,33,11,1.0,155.0
2342,8d4a475e48722fea,50db8711c70196cd,5444c5a201d3ee5a,2020-12-05,0,0,0,517,0,0,72,7,72,0,0,0,0,0,36,29,36,7,0.0,517.0
2343,8d4a475e48722fea,5444c5a201d3ee5a,50db8711c70196cd,2020-12-05,1,0,0,517,0,0,128,39,128,0,0,0,0,0,36,29,92,39,0.0,502.0
2344,856fab879c68ded7,ac026518a9b4dc0f,eb29176b03dfa888,2020-12-05,1,0,0,22,2,1,1,0,1,0,0,0,0,0,1,1,0,0,0.0,22.0
2345,856fab879c68ded7,eb29176b03dfa888,ac026518a9b4dc0f,2020-12-05,0,0,0,22,0,0,2,0,2,0,0,0,0,0,1,0,1,0,0.0,22.0
2346,771d8ce136a12a13,36549928f90f1d36,d2bc285ead803db0,2020-12-05,0,0,0,435,3,2,107,13,105,2,0,0,2,2,41,30,64,11,6.2,364.1
2347,771d8ce136a12a13,d2bc285ead803db0,36549928f90f1d36,2020-12-05,1,0,0,435,4,3,116,35,94,22,0,0,22,12,28,24,66,23,39.9,359.8
2348,46860358da8b8d82,304a21d0595e1a08,436f970c9ea9169c,2020-12-05,0,0,0,246,0,0,52,16,52,0,0,0,0,0,8,6,44,16,0.0,246.0
2349,46860358da8b8d82,436f970c9ea9169c,304a21d0595e1a08,2020-12-05,1,0,0,246,0,0,104,20,99,5,0,0,5,4,21,18,78,16,0.0,246.0
2350,4478ee77a647ae9d,327d5f279895110d,6ebe96a116e79e52,2020-12-05,0,3,0,900,5,3,109,31,101,8,0,0,8,3,28,20,73,28,387.6,456.5
2351,4478ee77a647ae9d,6ebe96a116e79e52,327d5f279895110d,2020-12-05,0,0,0,900,1,1,86,15,85,1,0,0,1,0,22,14,63,15,7.5,497.4
2352,2723f4d275d3f619,0a1942069c9ad6b6,7acbb0972e75281a,2020-12-05,0,0,0,1500,7,2,346,86,346,0,0,0,0,0,40,36,306,86,0.0,1149.8
2353,2723f4d275d3f619,7acbb0972e75281a,0a1942069c9ad6b6,2020-12-05,1,1,0,1500,1,0,334,143,321,13,5,5,8,3,17,16,304,140,322.2,1153.0
2354,8868957c1735bcf0,3cf18e01cb6cbde3,dee294e9717012c2,2020-11-28,1,0,0,44,0,0,18,6,17,1,0,0,1,0,3,3,14,6,2.0,42.0
2355,8868957c1735bcf0,dee294e9717012c2,3cf18e01cb6cbde3,2020-11-28,0,0,0,44,0,0,6,0,6,0,0,0,0,0,0,0,6,0,0.0,42.0
2356,711f00d287344c77,016a8d958883167c,01784fbc27c68b14,2020-11-28,1,1,0,850,12,7,162,53,132,30,5,3,25,15,21,16,111,38,258.1,437.0
2357,711f00d287344c77,01784fbc27c68b14,016a8d958883167c,2020-11-28,0,0,0,850,1,0,95,25,95,0,0,0,0,0,22,16,73,25,0.0,580.9
2358,4d56bcd82438e632,87c0b1c696ddfb43,eee0ef3e2b14816b,2020-11-28,1,1,0,568,7,5,100,34,80,20,1,1,19,17,23,16,57,17,142.1,353.8
2359,4d56bcd82438e632,eee0ef3e2b14816b,87c0b1c696ddfb43,2020-11-28,0,1,0,568,3,1,83,20,82,1,0,0,1,1,32,27,50,19,8.2,392.9
2360,32a7da2f34ae3803,ac40f7e3cbecdda4,b5da8f7d05e85a55,2020-11-28,0,1,0,900,4,2,228,90,225,3,0,0,3,1,38,36,187,89,26.7,633.0
2361,32a7da2f34ae3803,b5da8f7d05e85a55,ac40f7e3cbecdda4,2020-11-28,0,0,0,900,0,0,226,71,226,0,0,0,0,0,53,43,173,71,0.0,845.3
2362,2a7909acde26a240,d3f5d33d61cd00c9,fc6e681bf6658faf,2020-11-28,1,0,0,900,4,2,161,78,143,18,0,0,18,14,19,16,124,64,139.9,659.0
2363,2a7909acde26a240,fc6e681bf6658faf,d3f5d33d61cd00c9,2020-11-28,0,0,0,900,2,0,164,12,164,0,0,0,0,0,56,30,108,12,0.0,750.1
2364,28b6ee9c3eb8b753,82d4c957649faf9b,8abac218746e04ca,2020-11-28,0,1,1,568,2,1,73,16,68,5,0,0,5,5,33,24,35,11,43.1,498.0
2365,28b6ee9c3eb8b753,8abac218746e04ca,82d4c957649faf9b,2020-11-28,0,0,0,568,0,0,58,10,57,1,0,0,1,0,9,5,48,10,1.0,522.9
2366,181c3312f14de5a8,9abc648e76c4493a,be68b375707dcb85,2020-11-28,0,0,0,900,3,1,95,44,79,16,7,7,9,7,25,19,54,37,132.1,482.8
2367,181c3312f14de5a8,be68b375707dcb85,9abc648e76c4493a,2020-11-28,0,1,0,900,13,4,53,14,48,5,0,0,5,3,16,9,32,11,161.2,509.9
2368,0c27552ea7bc8c8a,bbc9ab95fa766493,ea3dcc417c322064,2020-11-28,0,1,1,275,6,1,20,5,16,4,1,1,3,2,6,5,10,3,141.6,98.0
2369,0c27552ea7bc8c8a,ea3dcc417c322064,bbc9ab95fa766493,2020-11-28,0,0,0,275,1,1,12,3,12,0,0,0,0,0,8,6,4,3,0.0,118.4
2370,09a29fb09fe07559,cc7040fe76f0ef91,d4c9dcd330403612,2020-11-28,0,0,0,154,0,0,3,1,3,0,0,0,0,0,0,0,3,1,0.0,9.0
2371,09a29fb09fe07559,d4c9dcd330403612,cc7040fe76f0ef91,2020-11-28,0,1,1,154,1,1,4,1,2,2,0,0,2,1,0,0,2,0,78.0,76.0
2372,e22d5aab3d099c7c,8a1f3b5c526cd6e6,9d19d9e4aa2662e8,2020-11-21,0,0,0,900,2,0,199,44,199,0,0,0,0,0,54,39,145,44,0.0,859.0
2373,e22d5aab3d099c7c,9d19d9e4aa2662e8,8a1f3b5c526cd6e6,2020-11-21,0,0,0,900,7,0,147,24,147,0,0,0,0,0,50,26,97,24,0.0,812.0
2374,c93eebe24aa0299d,132deb59abae64b1,8e1f36476ef02a6a,2020-11-21,0,0,0,1500,6,5,119,46,117,2,0,0,2,2,19,16,98,44,71.8,831.8
2375,c93eebe24aa0299d,8e1f36476ef02a6a,132deb59abae64b1,2020-11-21,0,0,0,1500,2,1,88,22,85,3,0,0,3,2,16,14,69,20,94.2,957.2
2376,a485281be8e9d2e2,6551c64fbcd1a467,d7338bcb141abd2c,2020-11-21,0,0,0,573,3,0,26,7,26,0,0,0,0,0,11,8,15,7,0.0,147.2
2377,a485281be8e9d2e2,d7338bcb141abd2c,6551c64fbcd1a467,2020-11-21,1,0,0,573,3,1,57,32,18,39,0,0,39,26,7,7,11,6,397.8,114.0
2378,a02764f92a84dd36,c730a0be691dc081,cf65d56b0755ed3b,2020-11-21,0,0,0,900,1,1,210,79,209,1,0,0,1,0,28,21,181,79,4.4,834.0
2379,a02764f92a84dd36,cf65d56b0755ed3b,c730a0be691dc081,2020-11-21,0,2,0,900,1,0,331,116,331,0,0,0,0,0,69,52,262,116,0.0,885.6
2380,91afc389191d41fb,a6c20202c701e5ca,afe8d5b39ff7fca2,2020-11-21,1,0,0,767,1,1,237,100,213,24,4,3,20,15,31,22,182,85,82.5,538.8
2381,91afc389191d41fb,afe8d5b39ff7fca2,a6c20202c701e5ca,2020-11-21,1,0,0,767,9,1,206,76,172,34,0,0,34,25,34,23,138,51,32.2,631.5
2382,90eb22b9eb6ed2a8,71505842fb6455c3,d6c0cdd7e467c440,2020-11-21,0,0,0,900,7,0,63,14,62,1,1,1,0,0,21,17,41,14,7.6,497.9
2383,90eb22b9eb6ed2a8,d6c0cdd7e467c440,71505842fb6455c3,2020-11-21,0,1,0,900,7,2,122,56,102,20,0,0,20,12,11,8,91,44,281.1,372.4
2384,8d5ea3bf3be7cb91,6e15f63b6c2e2c15,792be9a24df82ed6,2020-11-21,0,0,0,299,0,0,52,7,50,2,1,1,1,1,13,9,37,6,0.0,118.0
2385,8d5ea3bf3be7cb91,792be9a24df82ed6,6e15f63b6c2e2c15,2020-11-21,1,2,0,299,2,2,34,10,28,6,0,0,6,4,7,6,21,6,181.0,118.0
2386,6c1b38dd918793ff,b9437600497350f3,c878270af633eb11,2020-11-21,2,0,0,318,2,0,80,31,70,10,3,3,7,4,14,9,56,27,83.8,209.0
2387,6c1b38dd918793ff,c878270af633eb11,b9437600497350f3,2020-11-21,0,0,0,318,1,0,47,5,47,0,0,0,0,0,15,13,32,5,0.0,232.2
2388,3c098e2946b4c824,aa72b0f831d0bfe5,ab2b4ff41d6ebe0f,2020-11-21,0,1,1,117,0,0,8,2,8,0,0,0,0,0,4,3,4,2,0.0,80.0
2389,3c098e2946b4c824,ab2b4ff41d6ebe0f,aa72b0f831d0bfe5,2020-11-21,0,0,0,117,2,0,14,3,13,1,0,0,1,1,5,3,8,2,37.0,80.0
2390,2b13651b97f57b6c,4b47e71384a9522f,f2b6fdb20675b11c,2020-11-21,0,0,0,900,1,0,192,86,191,1,0,0,1,1,45,42,146,85,4.9,861.0
2391,2b13651b97f57b6c,f2b6fdb20675b11c,4b47e71384a9522f,2020-11-21,0,2,0,900,5,1,161,44,161,0,0,0,0,0,27,20,134,44,0.0,707.1
2392,1671723154d8e324,140745cbbcb023ac,eabf206b162b3b83,2020-11-21,0,0,0,516,0,0,28,6,26,2,0,0,2,1,6,4,20,5,104.0,299.0
2393,1671723154d8e324,eabf206b162b3b83,140745cbbcb023ac,2020-11-21,1,0,0,516,8,4,57,17,46,11,0,0,11,9,19,12,27,8,113.0,186.0
2394,08ef2ed7393efd24,98215d037be5bcb7,e872e9a9a902c045,2020-11-21,0,0,0,900,4,1,197,31,197,0,0,0,0,0,63,29,134,31,0.0,900.0
2395,08ef2ed7393efd24,e872e9a9a902c045,98215d037be5bcb7,2020-11-21,0,0,0,900,1,0,230,45,230,0,0,0,0,0,40,24,190,45,0.0,898.0
2396,f6472ca263a863d1,1a9480fc288e55d7,2c5a0b8317f8f27a,2020-11-14,0,0,0,900,2,1,135,34,132,3,0,0,3,0,35,25,97,34,49.0,753.0
2397,f6472ca263a863d1,2c5a0b8317f8f27a,1a9480fc288e55d7,2020-11-14,0,0,0,900,2,1,111,30,111,0,0,0,0,0,35,28,76,30,0.0,679.0
2398,d80fd2ec736f7df2,cdb96af67d096b1e,f748267c4ab6c127,2020-11-14,0,0,0,900,3,3,321,146,309,12,0,0,12,9,35,30,274,137,45.1,744.8
2399,d80fd2ec736f7df2,f748267c4ab6c127,cdb96af67d096b1e,2020-11-14,0,0,0,900,3,0,230,81,229,1,0,0,1,1,51,43,178,80,1.2,842.9
2400,9e4dcac049327529,601964f9654f911a,9cfbfae5fa1fdd93,2020-11-14,0,0,0,900,17,7,101,37,78,23,3,3,20,14,11,9,67,23,471.9,304.1
2401,9e4dcac049327529,9cfbfae5fa1fdd93,601964f9654f911a,2020-11-14,0,0,0,900,4,1,128,61,123,5,0,0,5,3,17,15,106,58,0.9,426.1
2402,80cb3cf9134b677c,6a2f7c151031653d,e5010b1b94ca5755,2020-11-14,0,0,0,1500,22,6,162,53,154,8,2,2,6,3,47,37,107,50,184.9,641.6
2403,80cb3cf9134b677c,e5010b1b94ca5755,6a2f7c151031653d,2020-11-14,0,0,0,1500,2,1,190,64,189,1,0,0,1,1,43,34,146,63,3.4,1215.1
2404,742dc4196d329db0,3351aa64aa83c4d9,4100c7a09497ad41,2020-11-14,0,0,0,900,1,0,137,56,134,3,0,0,3,3,1,1,133,53,55.5,672.1
2405,742dc4196d329db0,4100c7a09497ad41,3351aa64aa83c4d9,2020-11-14,0,2,0,900,5,2,110,47,108,2,0,0,2,2,21,20,87,45,42.9,522.5
2406,470391c4067bf49b,4a57ebb14315b251,e0b0cf71e0d69dd0,2020-11-14,0,0,0,900,0,0,61,12,60,1,0,0,1,1,25,17,35,11,0.0,419.1
2407,470391c4067bf49b,e0b0cf71e0d69dd0,4a57ebb14315b251,2020-11-14,0,2,0,900,9,4,43,24,25,18,1,1,17,16,6,4,19,8,480.9,339.0
2408,34db1e0e2499e7ae,7559395ad833c074,b4c6c904a9ffc5e8,2020-11-14,0,0,0,900,0,0,51,19,47,4,1,1,3,3,14,13,33,16,41.3,293.1
2409,34db1e0e2499e7ae,b4c6c904a9ffc5e8,7559395ad833c074,2020-11-14,0,3,0,900,4,2,42,14,28,14,1,1,13,10,12,11,16,4,410.9,359.7
2410,30eb24f7904c2128,2558ae2e5671e318,eae431e70064e046,2020-11-14,1,0,0,30,0,0,10,2,9,1,0,0,1,1,3,3,6,1,0.0,30.0
2411,30eb24f7904c2128,eae431e70064e046,2558ae2e5671e318,2020-11-14,0,0,0,30,0,0,2,0,2,0,0,0,0,0,2,2,0,0,0.0,30.0
2412,fea7dd5904ab4c91,899923ff6ab13917,b27a1fcb56a3035a,2020-11-07,0,0,0,686,6,0,75,15,75,0,0,0,0,0,16,11,59,15,0.0,565.5
2413,fea7dd5904ab4c91,b27a1fcb56a3035a,899923ff6ab13917,2020-11-07,2,0,0,686,2,1,59,34,58,1,0,0,1,1,5,4,53,33,25.5,533.0
2414,f0cf92b063735164,04c8b08b16a5b99e,3738e68d2261e60f,2020-11-07,0,0,0,900,0,0,119,16,119,0,0,0,0,0,61,52,58,16,0.0,900.0
2415,f0cf92b063735164,3738e68d2261e60f,04c8b08b16a5b99e,2020-11-07,0,0,0,900,0,0,82,16,82,0,0,0,0,0,29,18,53,16,0.0,900.0
2416,cb720b01fd6f9785,93b62c5f2ba18e51,c5a126ace82a6025,2020-11-07,0,1,1,163,3,2,43,17,34,9,0,0,9,6,10,9,24,11,37.1,97.0
2417,cb720b01fd6f9785,c5a126ace82a6025,93b62c5f2ba18e51,2020-11-07,0,0,0,163,0,0,40,8,38,2,0,0,2,2,13,9,25,6,0.0,125.9
2418,b76590c02f86e705,c41d426cc7326d1b,ec34349e7dffcde7,2020-11-07,0,0,0,900,0,0,170,54,167,3,0,0,3,2,27,20,140,52,2.7,627.2
2419,b76590c02f86e705,ec34349e7dffcde7,c41d426cc7326d1b,2020-11-07,0,0,0,900,10,2,96,29,91,5,0,0,5,5,12,7,79,24,253.8,491.3
2420,923e151bd990961b,7ff97850e8c32bda,dea070ed4a2a8281,2020-11-07,0,2,1,709,7,4,63,46,5,58,0,0,58,44,0,0,5,2,543.0,88.0
2421,923e151bd990961b,dea070ed4a2a8281,7ff97850e8c32bda,2020-11-07,1,0,0,709,0,0,64,38,24,40,1,1,39,28,5,1,19,10,78.0,88.0
2422,6ac3d588f9630f0a,b4537562f88ac582,b9f28e7045fdfce7,2020-11-07,0,0,0,900,1,0,202,40,199,3,0,0,3,0,16,9,183,40,29.0,731.8
2423,6ac3d588f9630f0a,b9f28e7045fdfce7,b4537562f88ac582,2020-11-07,0,1,0,900,4,2,207,85,202,5,0,0,5,5,41,35,161,80,81.2,676.0
2424,69fa167ba5d0fd82,7bde387d50829adf,92a9aa9c93192871,2020-11-07,0,0,0,742,0,0,78,28,73,5,0,0,5,3,9,8,64,25,5.6,678.6
2425,69fa167ba5d0fd82,92a9aa9c93192871,7bde387d50829adf,2020-11-07,0,1,1,742,21,7,72,21,70,2,0,0,2,2,14,11,56,19,53.4,282.4
2426,55019da3a4bd5d54,3d074044a33825e7,b0d6a1d8ac3d563d,2020-11-07,0,0,0,723,0,0,123,40,123,0,0,0,0,0,11,5,112,40,0.0,710.0
2427,55019da3a4bd5d54,b0d6a1d8ac3d563d,3d074044a33825e7,2020-11-07,1,0,0,723,1,0,167,50,167,0,0,0,0,0,32,24,135,50,0.0,691.0
2428,2267d967d1daf08a,ab943cd2c3c17825,c0badf3243907e59,2020-11-07,0,0,0,288,0,0,29,7,28,1,0,0,1,1,12,11,16,6,0.0,189.0
2429,2267d967d1daf08a,c0badf3243907e59,ab943cd2c3c17825,2020-11-07,0,1,1,288,5,2,7,3,4,3,0,0,3,3,4,3,0,0,99.0,57.0
2430,0fed97329b78b887,9560ff14eb3129f7,f0fad0e9f3b65752,2020-11-07,1,0,0,231,1,0,16,6,10,6,0,0,6,4,3,2,7,2,9.0,222.0
2431,0fed97329b78b887,f0fad0e9f3b65752,9560ff14eb3129f7,2020-11-07,0,0,0,231,3,0,4,2,4,0,0,0,0,0,0,0,4,2,0.0,178.0
2432,d763ad79532b27ff,068f8a189a47fea6,85073dbd1be65ed9,2020-10-31,0,0,0,372,0,0,37,6,36,1,0,0,1,1,16,11,20,5,0.0,220.0
2433,d763ad79532b27ff,85073dbd1be65ed9,068f8a189a47fea6,2020-10-31,1,0,0,372,1,1,74,32,36,38,0,0,38,27,19,14,17,5,152.0,220.0
2434,997dcf5fd2eb0f2f,318572f6f74b760d,3a46b268013afede,2020-10-31,0,0,0,159,0,0,2,2,2,0,0,0,0,0,0,0,2,2,0.0,26.0
2435,997dcf5fd2eb0f2f,3a46b268013afede,318572f6f74b760d,2020-10-31,0,0,1,159,2,2,12,10,3,9,0,0,9,9,1,1,2,1,133.0,26.0
2436,95beb5ec32718faf,262a7d06203657e6,feaf00f3373435d6,2020-10-31,1,0,0,106,0,0,52,16,52,0,0,0,0,0,18,13,34,16,0.0,106.0
2437,95beb5ec32718faf,feaf00f3373435d6,262a7d06203657e6,2020-10-31,0,0,0,106,0,0,27,4,27,0,0,0,0,0,7,4,20,4,0.0,106.0
2438,83955de599b2d874,8fd808923cffff82,d9c6f19f958643e9,2020-10-31,0,0,0,900,0,0,72,19,67,5,2,2,3,2,8,6,59,17,34.0,254.0
2439,83955de599b2d874,d9c6f19f958643e9,8fd808923cffff82,2020-10-31,0,1,0,900,13,7,69,28,42,27,5,5,22,12,15,13,27,16,612.0,254.0
2440,7e6f12a95c14f9de,0c258d1d8e16e5f1,46e0d677f91bacc0,2020-10-31,0,0,0,771,1,0,137,23,137,0,0,0,0,0,18,10,119,23,0.0,771.0
2441,7e6f12a95c14f9de,46e0d677f91bacc0,0c258d1d8e16e5f1,2020-10-31,1,0,0,771,7,0,105,39,105,0,0,0,0,0,13,9,92,39,0.0,588.0
2442,783761d95060ffc4,ba1e6cb3d43f7430,e4277e87a789d687,2020-10-31,0,0,0,158,0,0,31,8,31,0,0,0,0,0,2,2,29,8,0.0,148.2
2443,783761d95060ffc4,e4277e87a789d687,ba1e6cb3d43f7430,2020-10-31,2,0,0,158,0,0,38,10,30,8,0,0,8,5,16,12,14,5,9.8,147.0
2444,696ff200d98fa878,5f3805dda9661cba,f9a20a17d712ef7c,2020-10-31,0,1,1,429,3,2,31,17,9,22,0,0,22,15,3,3,6,2,379.0,50.0
2445,696ff200d98fa878,f9a20a17d712ef7c,5f3805dda9661cba,2020-10-31,0,0,0,429,0,0,5,1,5,0,0,0,0,0,1,0,4,1,0.0,50.0
2446,6915d46b49999f60,887961364be5ceb3,d945aae53e3e54e6,2020-10-31,0,0,0,900,3,2,177,29,174,3,0,0,3,0,73,56,101,29,30.4,829.0
2447,6915d46b49999f60,d945aae53e3e54e6,887961364be5ceb3,2020-10-31,0,1,0,900,3,2,119,29,119,0,0,0,0,0,17,13,102,29,0.0,758.6
2448,4e566bd7094b49da,0232cabbc30a2372,f6e5972c9d16c40e,2020-10-31,1,0,0,166,0,0,34,15,34,0,0,0,0,0,2,2,32,15,0.0,161.0
2449,4e566bd7094b49da,f6e5972c9d16c40e,0232cabbc30a2372,2020-10-31,0,0,0,166,3,0,13,5,13,0,0,0,0,0,2,1,11,5,0.0,112.0
2450,09f5fb0bec3c948a,045f25b3a4c08e81,0d8011111be000b2,2020-10-31,0,0,0,900,0,0,252,19,252,0,0,0,0,0,76,29,176,19,0.0,900.0
2451,09f5fb0bec3c948a,0d8011111be000b2,045f25b3a4c08e81,2020-10-31,0,0,0,900,0,0,227,88,227,0,0,0,0,0,24,18,203,88,0.0,900.0
2452,039c645e8f3ac00f,1f454354805b6f75,65578a75fa7900e3,2020-10-31,0,0,0,984,0,0,110,16,110,0,0,0,0,0,49,37,61,16,0.0,938.0
2453,039c645e8f3ac00f,65578a75fa7900e3,1f454354805b6f75,2020-10-31,2,0,0,984,0,0,111,41,87,24,0,0,24,15,21,19,66,26,15.0,969.0
2454,eedcb6c5d163e581,cd13728ae1151f46,d802174b0c0c1f4e,2020-10-24,0,0,0,259,0,0,36,5,36,0,0,0,0,0,9,6,27,5,0.0,254.5
2455,eedcb6c5d163e581,d802174b0c0c1f4e,cd13728ae1151f46,2020-10-24,2,0,0,259,0,0,41,17,32,9,0,0,9,6,5,4,27,11,4.5,254.0
2456,e8ef17c0babcfca5,729d4bd5a6cd0a97,f300763147320d12,2020-10-24,0,1,1,511,1,1,85,16,83,2,0,0,2,2,7,6,76,14,10.8,441.0
2457,e8ef17c0babcfca5,f300763147320d12,729d4bd5a6cd0a97,2020-10-24,0,0,0,511,3,0,75,7,75,0,0,0,0,0,30,16,45,7,0.0,471.2
2458,ccfe7b0d29c5440c,03f982ca3735070c,279566840aa55bf2,2020-10-24,0,0,0,375,1,0,58,7,58,0,0,0,0,0,13,9,45,7,0.0,375.0
2459,ccfe7b0d29c5440c,279566840aa55bf2,03f982ca3735070c,2020-10-24,1,0,0,375,0,0,73,32,73,0,0,0,0,0,14,13,59,32,0.0,370.0
2460,a2620cbef573a837,547afe1017e72dbe,d4270315cbcf2569,2020-10-24,1,0,0,18,0,0,11,7,9,2,0,0,2,2,0,0,9,5,1.0,17.0
2461,a2620cbef573a837,d4270315cbcf2569,547afe1017e72dbe,2020-10-24,0,0,0,18,0,0,2,0,2,0,0,0,0,0,0,0,2,0,0.0,17.0
2462,6eaa4981d0335c8a,c62fbc117d57b943,ebc1f40e00e0c481,2020-10-24,1,0,0,299,0,0,42,15,39,3,0,0,3,3,14,12,25,12,22.3,195.0
2463,6eaa4981d0335c8a,ebc1f40e00e0c481,c62fbc117d57b943,2020-10-24,0,0,0,299,1,0,19,4,19,0,0,0,0,0,13,9,6,4,0.0,276.7
2464,5b062be91c65fb73,01afe0916a40c7c5,57b10fca4f9c9a7a,2020-10-24,0,1,1,280,2,0,25,6,25,0,0,0,0,0,11,7,14,6,0.0,236.0
2465,5b062be91c65fb73,57b10fca4f9c9a7a,01afe0916a40c7c5,2020-10-24,0,0,0,280,2,0,18,3,18,0,0,0,0,0,9,6,9,3,0.0,156.0
2466,59eea37af7efb06c,032cc3922d871c7f,9e8f6c728eb01124,2020-10-24,0,1,1,394,3,2,80,18,79,1,1,1,0,0,7,7,72,18,55.0,339.0
2467,59eea37af7efb06c,9e8f6c728eb01124,032cc3922d871c7f,2020-10-24,0,0,0,394,0,0,45,12,45,0,0,0,0,0,19,17,26,12,0.0,325.0
2468,55c257629ecea80f,74f9448b97bf8bec,d156513a19acf856,2020-10-24,1,0,0,900,3,0,126,43,122,4,0,0,4,4,18,13,104,39,48.3,753.8
2469,55c257629ecea80f,d156513a19acf856,74f9448b97bf8bec,2020-10-24,0,0,0,900,0,0,166,38,165,1,0,0,1,1,26,21,139,37,1.2,846.7
2470,51108eabae8391ca,13a0275fa13c4d26,e1147d3d2dabe1ce,2020-10-24,0,0,0,900,0,0,89,17,89,0,0,0,0,0,43,36,46,17,0.0,758.6
2471,51108eabae8391ca,e1147d3d2dabe1ce,13a0275fa13c4d26,2020-10-24,1,0,0,900,2,0,151,59,139,12,0,0,12,6,13,10,126,53,111.4,770.0
2472,47f9c14a7dca1ad7,eebc23626e38f5dc,f29a6350c69f4a33,2020-10-24,0,0,0,300,0,0,80,26,80,0,0,0,0,0,9,4,71,26,0.0,300.0
2473,47f9c14a7dca1ad7,f29a6350c69f4a33,eebc23626e38f5dc,2020-10-24,1,0,0,300,0,0,95,25,95,0,0,0,0,0,30,24,65,25,0.0,300.0
2474,2279d909f6e3e552,58bbef3770bb2dfc,d06f8869449ba7bd,2020-10-24,0,2,1,180,0,0,6,1,5,1,0,0,1,1,3,3,2,0,0.0,180.0
2475,2279d909f6e3e552,d06f8869449ba7bd,58bbef3770bb2dfc,2020-10-24,0,0,0,180,1,1,1,0,1,0,0,0,0,0,1,1,0,0,0.0,63.0
2476,e7a915f39ecf6db0,6a1901c62ab3870f,e872e9a9a902c045,2020-10-17,1,0,0,295,3,2,43,11,37,6,2,2,4,4,17,15,20,7,58.4,149.0
2477,e7a915f39ecf6db0,e872e9a9a902c045,6a1901c62ab3870f,2020-10-17,0,0,0,295,0,0,53,7,53,0,0,0,0,0,18,12,35,7,0.0,211.6
2478,e5279358b128c2ac,72db2a14ffa73ece,7772b283d288dbe2,2020-10-17,0,0,0,900,16,5,126,42,107,19,1,1,18,10,13,9,94,32,172.7,690.0
2479,e5279358b128c2ac,7772b283d288dbe2,72db2a14ffa73ece,2020-10-17,1,0,0,900,1,0,86,12,84,2,2,2,0,0,36,23,48,12,1.0,726.3
2480,e4d0be5ae320c4ae,2b074403b7c6cdb4,f2477cf43c4975cc,2020-10-17,0,0,0,900,5,0,171,33,171,0,0,0,0,0,44,31,127,33,0.0,898.0
2481,e4d0be5ae320c4ae,f2477cf43c4975cc,2b074403b7c6cdb4,2020-10-17,0,0,0,900,0,0,205,53,205,0,0,0,0,0,35,20,170,53,0.0,900.0
2482,b3e12698e65cf8d0,950d0ef5c17157c5,af997f7611673880,2020-10-17,1,0,0,598,1,1,76,20,51,25,0,0,25,9,15,14,36,11,113.7,430.5
2483,b3e12698e65cf8d0,af997f7611673880,950d0ef5c17157c5,2020-10-17,0,0,0,598,5,1,23,5,22,1,0,0,1,1,8,7,14,4,26.5,325.3
2484,9b6135943a4c8fe7,38c7f72747f4f712,5c126c6aac3ef364,2020-10-17,0,0,0,900,7,3,98,43,30,68,6,6,62,42,15,8,15,1,574.0,297.5
2485,9b6135943a4c8fe7,5c126c6aac3ef364,38c7f72747f4f712,2020-10-17,0,0,0,900,0,0,43,11,40,3,0,0,3,3,11,11,29,8,28.5,250.0
2486,948da1b7ebbb06b3,476fe566d2df676e,70e1f8a821b72c8b,2020-10-17,0,0,0,121,0,0,17,2,17,0,0,0,0,0,6,5,11,2,0.0,104.3
2487,948da1b7ebbb06b3,70e1f8a821b72c8b,476fe566d2df676e,2020-10-17,2,0,0,121,1,0,24,8,22,2,0,0,2,2,10,9,12,6,16.7,96.0
2488,5a440bdee19efaab,c451d67c09c55418,def8166ff24bd237,2020-10-17,0,0,0,1500,0,0,163,35,163,0,0,0,0,0,36,27,127,35,0.0,1473.7
2489,5a440bdee19efaab,def8166ff24bd237,c451d67c09c55418,2020-10-17,2,0,0,1500,10,3,212,64,206,6,1,1,5,3,76,62,130,61,26.3,1443.0
2490,50e0bcba7551a25f,285ae0b4a68221f4,e9ac7bfb65c25497,2020-10-17,0,0,0,900,4,4,21,10,2,19,0,0,19,8,0,0,2,2,791.0,109.0
2491,50e0bcba7551a25f,e9ac7bfb65c25497,285ae0b4a68221f4,2020-10-17,0,0,0,900,0,0,14,1,14,0,0,0,0,0,4,4,10,1,0.0,109.0
2492,4eb5f99202f5fe97,6f7c616b98e18c29,8f6a18831a120817,2020-10-17,0,0,0,900,12,2,214,30,214,0,0,0,0,0,71,34,143,30,0.0,842.0
2493,4eb5f99202f5fe97,8f6a18831a120817,6f7c616b98e18c29,2020-10-17,0,0,0,900,1,0,159,73,159,0,0,0,0,0,24,21,135,73,0.0,886.0
2494,2735a2ea77ddc0b5,1e4f273069fb9e85,af9f42e6894047fc,2020-10-17,0,0,0,900,5,1,89,34,80,9,0,0,9,6,13,13,67,28,38.1,828.0
2495,2735a2ea77ddc0b5,af9f42e6894047fc,1e4f273069fb9e85,2020-10-17,0,0,0,900,11,5,72,7,72,0,0,0,0,0,21,13,51,7,0.0,445.9
2496,024a04f78b37b7d9,0fd5f4b838e890cc,ef1182eb28c17d4e,2020-10-17,1,0,0,51,0,0,24,17,11,13,0,0,13,11,2,1,9,6,3.8,46.0
2497,024a04f78b37b7d9,ef1182eb28c17d4e,0fd5f4b838e890cc,2020-10-17,0,0,0,51,1,0,7,1,7,0,0,0,0,0,2,2,5,1,0.0,47.2
2498,ee57cbd0b68c689d,257b0c8d6f199895,b9437600497350f3,2020-10-10,0,0,0,423,0,0,79,17,79,0,0,0,0,0,15,11,64,17,0.0,391.5
2499,ee57cbd0b68c689d,b9437600497350f3,257b0c8d6f199895,2020-10-10,1,0,0,423,2,1,94,19,91,3,0,0,3,2,15,10,76,17,31.5,360.0
2500,e64075c104471ff0,0d7b51c9d2649a6e,2ac4628c08ec5125,2020-10-10,1,0,0,202,0,0,58,7,54,4,0,0,4,3,30,19,24,4,2.0,200.0
2501,e64075c104471ff0,2ac4628c08ec5125,0d7b51c9d2649a6e,2020-10-10,0,0,0,202,0,0,43,8,43,0,0,0,0,0,7,6,36,8,0.0,200.0
2502,e4d831dc318e4e98,399afbabc02376b5,c9a94278df042f46,2020-10-10,1,0,0,95,1,1,25,15,10,15,0,0,15,12,1,1,9,3,30.0,65.0
2503,e4d831dc318e4e98,c9a94278df042f46,399afbabc02376b5,2020-10-10,0,0,0,95,0,0,12,1,12,0,0,0,0,0,2,2,10,1,0.0,65.0
2504,dfb856d4c80bbf04,1a08b01fdabb6ae2,e87a13e02c01331d,2020-10-10,0,4,0,900,0,0,62,11,62,0,0,0,0,0,19,12,43,11,0.0,604.0
2505,dfb856d4c80bbf04,e87a13e02c01331d,1a08b01fdabb6ae2,2020-10-10,0,1,0,900,15,5,67,12,64,3,0,0,3,1,25,17,39,11,180.0,540.0
2506,dbb5d682a2d7f584,294aa73dbf37d281,f00ac08ab056af5d,2020-10-10,0,0,0,900,8,4,114,20,114,0,0,0,0,0,33,27,81,20,0.0,759.0
2507,dbb5d682a2d7f584,f00ac08ab056af5d,294aa73dbf37d281,2020-10-10,0,0,0,900,11,5,122,38,122,0,0,0,0,0,12,8,110,38,0.0,673.0
2508,db5802643b9fd7d4,64a50dad704d1d49,87a1dc546b1c5caf,2020-10-10,2,1,0,900,0,0,74,8,70,4,0,0,4,1,32,24,38,7,78.4,673.3
2509,db5802643b9fd7d4,87a1dc546b1c5caf,64a50dad704d1d49,2020-10-10,0,0,0,900,6,3,39,10,37,2,0,0,2,1,3,1,34,9,128.7,628.6
2510,89dd4c256ca5d317,9560ff14eb3129f7,a0e6753c42698f13,2020-10-10,1,0,0,900,1,0,157,32,136,21,5,4,16,7,35,29,101,25,26.5,807.0
2511,89dd4c256ca5d317,a0e6753c42698f13,9560ff14eb3129f7,2020-10-10,0,0,0,900,0,0,128,23,125,3,0,0,3,0,17,11,108,23,64.0,809.5
2512,849cc2c331e9b24f,5e6294b37bbef029,68d4a891e5cf2029,2020-10-10,0,0,0,900,6,1,32,6,32,0,0,0,0,0,8,4,24,6,0.0,241.39999999999998
2513,849cc2c331e9b24f,68d4a891e5cf2029,5e6294b37bbef029,2020-10-10,0,0,0,900,5,3,42,11,26,16,1,0,15,11,13,9,13,0,531.6,302.0
2514,7c4eb0b4845eb0ed,1588b787bda7b540,9cd047a828dd7515,2020-10-10,1,0,0,102,0,0,27,15,20,7,0,0,7,6,2,2,18,9,4.4,97.0
2515,7c4eb0b4845eb0ed,9cd047a828dd7515,1588b787bda7b540,2020-10-10,0,0,0,102,0,0,15,0,15,0,0,0,0,0,6,2,9,0,0.0,97.6
2516,727ecd251325b6a8,65f09bacd3957381,fea79f9bc8c68769,2020-10-10,1,0,0,363,0,0,88,16,84,4,0,0,4,2,25,22,59,14,4.0,359.0
2517,727ecd251325b6a8,fea79f9bc8c68769,65f09bacd3957381,2020-10-10,0,0,0,363,1,1,50,10,50,0,0,0,0,0,11,4,39,10,0.0,350.0
2518,22fe6779c3fa649d,52c2ae6d2f2d2613,54f64b5e283b0ce7,2020-10-10,0,1,0,900,2,0,53,10,52,1,0,0,1,0,10,7,42,10,57.0,568.3
2519,22fe6779c3fa649d,54f64b5e283b0ce7,52c2ae6d2f2d2613,2020-10-10,0,5,0,900,9,5,33,7,32,1,0,0,1,0,10,6,22,7,160.7,361.0
2520,1e525f9857019a2e,d0aaedcf7ccd0b45,d31a5546c0e9b213,2020-10-10,2,0,0,45,0,0,21,13,11,10,0,0,10,7,0,0,11,6,24.0,21.0
2521,1e525f9857019a2e,d31a5546c0e9b213,d0aaedcf7ccd0b45,2020-10-10,0,0,0,45,0,0,4,0,4,0,0,0,0,0,1,1,3,0,0.0,21.0
2522,1720a97a2fa261f8,bd58d34e39b7b12a,c9cf753cfdf77fc2,2020-10-10,0,0,0,900,0,0,276,63,276,0,0,0,0,0,29,26,247,63,0.0,818.3
2523,1720a97a2fa261f8,c9cf753cfdf77fc2,bd58d34e39b7b12a,2020-10-10,0,0,0,900,3,1,183,69,177,6,0,0,6,2,29,25,148,67,62.7,712.0
2524,f4e262b04f4e94bd,6751eacd16bd59bc,f1d64ae34e088832,2020-10-03,1,0,0,900,7,0,124,19,117,7,0,0,7,4,46,27,71,15,115.1,581.0
2525,f4e262b04f4e94bd,f1d64ae34e088832,6751eacd16bd59bc,2020-10-03,0,3,0,900,0,0,101,17,81,20,2,2,18,8,36,25,45,9,171.0,613.9
2526,d866afa89d62a4ae,2f1a257d6777096d,6eaec40f724852f4,2020-10-03,1,0,0,72,1,0,23,11,18,5,0,0,5,2,2,2,16,9,2.0,70.0
2527,d866afa89d62a4ae,6eaec40f724852f4,2f1a257d6777096d,2020-10-03,0,0,0,72,0,0,10,1,10,0,0,0,0,0,2,1,8,1,0.0,70.0
2528,c00a8682fb5b71bd,5f3da9a9610d8969,60425d07ef4b91a7,2020-10-03,0,0,0,344,0,0,30,4,28,2,2,1,0,0,8,6,20,4,3.0,196.0
2529,c00a8682fb5b71bd,60425d07ef4b91a7,5f3da9a9610d8969,2020-10-03,1,0,0,344,2,2,78,22,41,37,4,4,33,15,11,6,30,7,145.0,196.0
2530,ba6093c9136f99e9,1eff7bc0f815b270,a2ea77e974c5889f,2020-10-03,0,0,0,900,1,0,100,24,100,0,0,0,0,0,28,24,72,24,0.0,707.0
2531,ba6093c9136f99e9,a2ea77e974c5889f,1eff7bc0f815b270,2020-10-03,0,0,0,900,0,0,177,39,177,0,0,0,0,0,50,39,127,39,0.0,812.0
2532,ac6b2a5f24c2b8bd,1897b7b913736a7c,e7bba7ce4d6c7b07,2020-10-03,0,0,0,900,0,0,171,26,171,0,0,0,0,0,31,20,140,26,0.0,900.0
2533,ac6b2a5f24c2b8bd,e7bba7ce4d6c7b07,1897b7b913736a7c,2020-10-03,0,0,0,900,1,0,263,57,263,0,0,0,0,0,71,52,192,57,0.0,900.0
2534,87105c63df95f929,4e30e4250cb08b61,d05cb1e8d1b885d8,2020-10-03,0,0,0,900,1,0,137,27,136,1,0,0,1,0,76,53,60,27,1.6,817.0
2535,87105c63df95f929,d05cb1e8d1b885d8,4e30e4250cb08b61,2020-10-03,0,0,0,900,4,1,61,21,61,0,0,0,0,0,12,5,49,21,0.0,744.4
2536,81b16b26774be5d1,1d239d571e342453,3253b16d38ae087d,2020-10-03,0,2,1,805,0,0,91,32,90,1,0,0,1,1,5,5,85,31,6.9,446.4
2537,81b16b26774be5d1,3253b16d38ae087d,1d239d571e342453,2020-10-03,0,0,0,805,6,3,91,19,77,14,5,5,9,2,7,3,70,17,310.6,443.1
2538,24ff0bb908095565,523fa774700d7d3f,f9f07bb5a43535ed,2020-10-03,0,0,0,900,0,0,182,9,182,0,0,0,0,0,109,75,73,9,0.0,898.0
2539,24ff0bb908095565,f9f07bb5a43535ed,523fa774700d7d3f,2020-10-03,1,0,0,900,0,0,230,50,228,2,0,0,2,1,57,38,171,49,2.0,898.0
2540,1e7caef3f6dfde10,3f7dab21b6c971bc,866fd7b1a6c90e7f,2020-10-03,0,0,0,495,0,0,41,5,41,0,0,0,0,0,13,8,28,5,0.0,333.2
2541,1e7caef3f6dfde10,866fd7b1a6c90e7f,3f7dab21b6c971bc,2020-10-03,1,0,0,495,2,1,134,66,87,47,0,0,47,29,20,19,67,37,143.8,290.0
2542,15a422574c3b89e1,881bf86d4cba8578,e26bd53b751d61d9,2020-10-03,0,4,0,900,8,1,110,50,96,14,0,0,14,8,20,18,76,42,150.9,609.0
2543,15a422574c3b89e1,e26bd53b751d61d9,881bf86d4cba8578,2020-10-03,0,0,0,900,3,0,98,25,98,0,0,0,0,0,10,5,88,25,0.0,605.1
2544,0005e00b07cee542,578ef12674df1e6a,634e2fb70bde3fd5,2020-10-03,0,0,0,1500,0,0,185,38,185,0,0,0,0,0,57,31,128,38,0.0,1191.9
2545,0005e00b07cee542,634e2fb70bde3fd5,578ef12674df1e6a,2020-10-03,0,0,0,1500,14,5,301,81,273,28,7,6,21,7,80,67,193,74,305.1,1184.0
2546,fd76b75c28dc247a,1338e2c7480bdf9e,2e5c2aa8e4ab9d82,2020-09-26,1,0,0,539,0,0,84,24,74,10,0,0,10,8,33,31,41,16,6.9,530.0
2547,fd76b75c28dc247a,2e5c2aa8e4ab9d82,1338e2c7480bdf9e,2020-09-26,0,0,0,539,0,0,26,2,26,0,0,0,0,0,13,10,13,2,0.0,531.1
2548,eed8c9955cad1e30,4cd8b03aee1d0138,5b86d491d63890c5,2020-09-26,0,0,0,76,0,0,7,0,7,0,0,0,0,0,7,4,0,0,0.0,73.0
2549,eed8c9955cad1e30,5b86d491d63890c5,4cd8b03aee1d0138,2020-09-26,1,0,0,76,0,0,13,6,12,1,0,0,1,1,3,3,9,5,3.0,73.0
2550,e842c6f63fa2e27a,4234f0097c83fa62,b9706f80d005036c,2020-09-26,0,0,0,900,1,0,149,34,146,3,0,0,3,2,47,35,99,32,19.5,861.0
2551,e842c6f63fa2e27a,b9706f80d005036c,4234f0097c83fa62,2020-09-26,0,0,0,900,5,2,171,65,171,0,0,0,0,0,6,3,165,65,0.0,733.5
2552,e10481ee3fda7080,687c15b2eddfaa63,c3218c810959d279,2020-09-26,0,0,0,900,16,4,22,7,21,1,0,0,1,1,10,9,11,6,218.0,404.0
2553,e10481ee3fda7080,c3218c810959d279,687c15b2eddfaa63,2020-09-26,0,1,0,900,0,0,46,16,40,6,0,0,6,4,3,3,37,12,60.0,592.0
2554,9f4d6d192ab4a027,37ed1ab2f8b819f4,c3ded6f7155f9ea4,2020-09-26,0,0,0,900,6,1,166,47,165,1,1,1,0,0,23,19,142,47,10.5,770.7
2555,9f4d6d192ab4a027,c3ded6f7155f9ea4,37ed1ab2f8b819f4,2020-09-26,0,1,0,900,9,3,112,35,111,1,0,0,1,1,21,19,90,34,45.3,572.5
2556,9e674a02db6c03c8,6e15f63b6c2e2c15,853eb0dd5c0e2149,2020-09-26,2,1,1,348,0,0,71,27,70,1,0,0,1,1,15,12,55,26,13.0,257.0
2557,9e674a02db6c03c8,853eb0dd5c0e2149,6e15f63b6c2e2c15,2020-09-26,1,0,0,348,1,0,38,12,38,0,0,0,0,0,10,10,28,12,0.0,244.0
2558,8e7b2d62f834b417,6a11e325aa60ad02,ccf5dc41417e9daf,2020-09-26,0,0,0,228,0,0,1,0,1,0,0,0,0,0,1,0,0,0,0.0,72.0
2559,8e7b2d62f834b417,ccf5dc41417e9daf,6a11e325aa60ad02,2020-09-26,0,1,1,228,7,5,17,9,7,10,1,1,9,7,2,0,5,2,156.0,72.0
2560,73dbbdfcf7f989c0,82e7929bf6c2b689,a845f0735bc67405,2020-09-26,0,0,0,900,1,0,81,12,77,4,0,0,4,2,24,13,53,10,0.0,613.7
2561,73dbbdfcf7f989c0,a845f0735bc67405,82e7929bf6c2b689,2020-09-26,1,0,0,900,2,1,148,69,98,50,0,0,50,29,3,3,95,40,286.3,608.0
2562,5fb63c34935acce9,5da33b8fbfa5ee95,c2a670b22d2e196f,2020-09-26,0,1,0,900,5,4,54,29,33,21,0,0,21,19,14,9,19,10,279.3,501.0
2563,5fb63c34935acce9,c2a670b22d2e196f,5da33b8fbfa5ee95,2020-09-26,0,0,0,900,4,1,30,8,30,0,0,0,0,0,12,9,18,8,0.0,294.7
2564,5a00c73efbcf323e,2c9d00968f818270,aceffa19749c4dc0,2020-09-26,0,0,0,900,0,0,136,31,136,0,0,0,0,0,56,38,80,31,0.0,777.0
2565,5a00c73efbcf323e,aceffa19749c4dc0,2c9d00968f818270,2020-09-26,0,0,0,900,7,1,93,31,92,1,0,0,1,1,5,4,87,30,123.0,777.0
2566,4c12c9085200121f,2e19380f34871c6a,99df7d0a2a08a8a8,2020-09-26,0,0,0,576,0,0,51,9,51,0,0,0,0,0,16,12,35,9,0.0,574.0
2567,4c12c9085200121f,99df7d0a2a08a8a8,2e19380f34871c6a,2020-09-26,1,0,0,576,0,0,89,25,85,4,0,0,4,3,19,16,66,22,2.0,573.0
2568,ca531425f5c042db,dc9572dd6ec74859,effd9de9937996f8,2020-09-19,1,0,0,1279,8,3,143,47,121,22,0,0,22,16,37,31,84,31,377.7,558.0
2569,ca531425f5c042db,effd9de9937996f8,dc9572dd6ec74859,2020-09-19,0,0,0,1279,1,1,83,14,83,0,0,0,0,0,25,20,58,14,0.0,887.3
2570,c0568b225d5f0fe6,1d00756835ca67c9,d8da10db80131bec,2020-09-19,0,0,0,900,5,0,230,69,229,1,1,1,0,0,48,43,181,69,3.6,843.3
2571,c0568b225d5f0fe6,d8da10db80131bec,1d00756835ca67c9,2020-09-19,0,0,0,900,1,0,312,80,308,4,3,3,1,0,84,67,224,80,6.7,849.4
2572,bf614956b28f231c,49b130de1da2e1bf,6c8072b61c276e67,2020-09-19,0,0,0,861,11,2,30,3,30,0,0,0,0,0,15,9,15,3,0.0,345.0
2573,bf614956b28f231c,6c8072b61c276e67,49b130de1da2e1bf,2020-09-19,1,0,0,861,1,1,106,66,59,47,2,2,45,34,9,8,50,32,308.0,363.0
2574,aa08ebe1a69c76ca,29af297d9f1de0f8,cbd3e590a85b18c5,2020-09-19,0,7,1,681,0,0,26,10,15,11,0,0,11,7,3,2,12,3,44.0,112.29999999999995
2575,aa08ebe1a69c76ca,cbd3e590a85b18c5,29af297d9f1de0f8,2020-09-19,0,0,0,681,9,7,21,9,11,10,3,3,7,6,2,1,9,3,512.7,73.0
2576,859ca56770ac7672,4a57ebb14315b251,7447e9f28508106a,2020-09-19,0,0,0,224,0,0,5,3,5,0,0,0,0,0,0,0,5,3,0.0,23.0
2577,859ca56770ac7672,7447e9f28508106a,4a57ebb14315b251,2020-09-19,0,5,1,224,0,0,13,6,6,7,2,2,5,5,1,1,5,1,105.0,119.0
2578,78c3ca588e55bf31,3a46b268013afede,a17ad5a5048e8c3f,2020-09-19,0,0,0,900,3,0,129,54,127,2,2,1,0,0,26,19,101,54,25.3,484.6
2579,78c3ca588e55bf31,a17ad5a5048e8c3f,3a46b268013afede,2020-09-19,0,0,0,900,8,3,110,26,77,33,7,4,26,14,29,27,48,12,200.4,625.7
2580,579f3280456ad450,6e00cfffd54653c4,c9587d81e1d33925,2020-09-19,1,0,0,334,0,0,72,27,50,22,0,0,22,15,14,9,36,12,20.2,311.0
2581,579f3280456ad450,c9587d81e1d33925,6e00cfffd54653c4,2020-09-19,0,0,0,334,0,0,80,9,80,0,0,0,0,0,35,21,45,9,0.0,313.8
2582,4f3cd94861c6a876,82cbb809d5ee565c,cc8c623cca88f54f,2020-09-19,0,0,0,149,2,1,9,5,7,2,0,0,2,2,2,1,5,3,120.0,29.0
2583,4f3cd94861c6a876,cc8c623cca88f54f,82cbb809d5ee565c,2020-09-19,0,1,1,149,0,0,7,1,7,0,0,0,0,0,2,1,5,1,0.0,29.0
2584,498766b46b8b4a7f,6ac9bc2953c47345,767755fd74662dbf,2020-09-19,0,0,0,17,0,0,1,0,1,0,0,0,0,0,0,0,1,0,0.0,15.0
2585,498766b46b8b4a7f,767755fd74662dbf,6ac9bc2953c47345,2020-09-19,1,0,0,17,0,0,6,3,3,3,0,0,3,2,1,1,2,1,2.0,15.0
2586,42ecb9a94bebc24d,325ad0dd9126d3df,78f485f851891d68,2020-09-19,1,0,0,41,0,0,6,4,4,2,0,0,2,2,0,0,4,2,2.0,39.0
2587,42ecb9a94bebc24d,78f485f851891d68,325ad0dd9126d3df,2020-09-19,0,0,0,41,0,0,5,1,5,0,0,0,0,0,1,0,4,1,0.0,39.0
2588,3a38b0b566f3045d,06a80a685ea98573,5f6f049d54728e88,2020-09-19,0,0,0,900,9,1,176,49,168,8,0,0,8,6,42,32,126,43,12.0,882.0
2589,3a38b0b566f3045d,5f6f049d54728e88,06a80a685ea98573,2020-09-19,0,0,0,900,0,0,299,78,299,0,0,0,0,0,73,45,226,78,0.0,840.0
2590,36807d8a7ebc84a5,215a70f073a7b726,9ada30894bf04e19,2020-09-19,0,0,0,900,1,0,162,16,162,0,0,0,0,0,43,34,119,16,0.0,900.0
2591,36807d8a7ebc84a5,9ada30894bf04e19,215a70f073a7b726,2020-09-19,0,0,0,900,1,0,146,30,146,0,0,0,0,0,56,38,90,30,0.0,896.0
2592,36656dfa32341671,34e516ab361afb1c,cd2e5a390821fb48,2020-09-19,0,1,1,52,0,0,17,1,17,0,0,0,0,0,14,14,3,1,0.0,45.0
2593,36656dfa32341671,cd2e5a390821fb48,34e516ab361afb1c,2020-09-19,0,0,0,52,1,0,4,0,4,0,0,0,0,0,1,0,3,0,0.0,29.0
2594,1a484c452623181e,a67f5afa8d6a1b80,c21f26bbde777573,2020-09-19,2,0,0,163,2,2,13,7,7,6,0,0,6,4,0,0,7,3,106.0,17.0
2595,1a484c452623181e,c21f26bbde777573,a67f5afa8d6a1b80,2020-09-19,1,0,0,163,0,0,30,24,5,25,0,0,25,22,3,2,2,2,40.0,17.0
2596,ed8fb10b596e6fa4,70d2329a92864fdb,928ae2e5b5f7a9ec,2020-09-12,1,1,1,837,0,0,275,45,274,1,0,0,1,0,117,86,157,45,1.3,814.3
2597,ed8fb10b596e6fa4,928ae2e5b5f7a9ec,70d2329a92864fdb,2020-09-12,0,0,0,837,3,1,210,25,207,3,1,0,2,1,91,68,116,24,8.7,803.7
2598,e1bb0b615c02d715,35b3772629e27a49,37c5366d18ed6c05,2020-09-12,1,1,0,31,0,0,6,2,5,1,0,0,1,1,4,3,1,1,15.0,16.0
2599,e1bb0b615c02d715,37c5366d18ed6c05,35b3772629e27a49,2020-09-12,0,0,0,31,1,0,5,2,5,0,0,0,0,0,1,0,4,2,0.0,16.0
2600,cf0e0f95524f187a,4234f0097c83fa62,86d9dbe1bfcbade7,2020-09-12,0,3,0,900,7,3,107,46,66,41,3,3,38,25,6,4,60,21,597.4,259.5
2601,cf0e0f95524f187a,86d9dbe1bfcbade7,4234f0097c83fa62,2020-09-12,0,0,0,900,1,1,87,26,86,1,0,0,1,1,11,8,75,25,28.5,188.60000000000002
2602,c58aaabf2c5635d7,31f8081c7600da93,aa171d55d4b5208f,2020-09-12,0,0,0,607,4,0,114,40,111,3,0,0,3,3,23,16,88,37,13.7,505.1
2603,c58aaabf2c5635d7,aa171d55d4b5208f,31f8081c7600da93,2020-09-12,1,0,0,607,6,2,150,52,149,1,0,0,1,0,33,27,116,52,14.9,385.3
2604,764012f51c7dc223,05fa626cb33d15b8,4498b382c65a7faa,2020-09-12,0,0,0,900,4,3,189,50,186,3,0,0,3,3,61,47,125,47,26.5,586.2
2605,764012f51c7dc223,4498b382c65a7faa,05fa626cb33d15b8,2020-09-12,0,0,0,900,7,4,169,56,166,3,0,0,3,3,7,4,159,53,216.8,584.5
2606,463fc1fd1f17befb,3c5005b66696d790,a331233f597090a5,2020-09-12,0,0,0,900,24,5,84,26,74,10,2,1,8,5,10,9,64,21,112.9,527.9
2607,463fc1fd1f17befb,a331233f597090a5,3c5005b66696d790,2020-09-12,0,2,0,900,1,0,126,49,119,7,1,1,6,4,15,13,104,45,22.1,670.1
2608,3901d9cdbb0949bc,06f36cf4bd97ec77,18b602842a24f7c5,2020-09-12,0,1,1,761,4,2,73,14,72,1,1,0,0,0,31,26,41,14,8.3,472.2
2609,3901d9cdbb0949bc,18b602842a24f7c5,06f36cf4bd97ec77,2020-09-12,2,0,0,761,1,0,124,42,110,14,2,1,12,6,56,46,54,36,39.8,556.7
2610,2461756d8acd56d2,2c5a0b8317f8f27a,c0badf3243907e59,2020-09-12,0,0,0,562,0,0,15,3,14,1,0,0,1,0,5,4,9,3,0.0,70.5
2611,2461756d8acd56d2,c0badf3243907e59,2c5a0b8317f8f27a,2020-09-12,0,2,1,562,4,4,147,47,6,141,3,3,138,47,5,5,1,0,491.5,67.0
2612,1ed8776f978a0155,78e501478a36a018,ee18ff42063174df,2020-09-12,0,0,0,93,0,0,9,0,9,0,0,0,0,0,4,1,5,0,0.0,90.5
2613,1ed8776f978a0155,ee18ff42063174df,78e501478a36a018,2020-09-12,1,0,0,93,0,0,22,12,15,7,0,0,7,7,4,4,11,5,2.5,87.0
2614,0ffbf3096a13b47e,eb04b9d31e938edb,f0feeb2192937424,2020-09-12,0,0,0,1500,18,1,324,65,317,7,0,0,7,5,90,63,227,60,70.9,1252.7
2615,0ffbf3096a13b47e,f0feeb2192937424,eb04b9d31e938edb,2020-09-12,0,0,0,1500,0,0,261,82,260,1,0,0,1,1,67,49,193,81,4.3,1299.1
2616,06910bddb0745856,887961364be5ceb3,cd7763bcadb5d4c8,2020-09-12,0,0,0,900,6,4,95,41,81,14,0,0,14,9,21,20,60,32,197.3,346.0
2617,06910bddb0745856,cd7763bcadb5d4c8,887961364be5ceb3,2020-09-12,0,0,0,900,6,1,69,8,68,1,0,0,1,1,19,11,49,7,103.0,599.7
2618,e8206c7380441fbb,886264a0c9f4ea5e,e17ac6410c8377f4,2020-09-05,0,2,1,162,0,0,8,2,8,0,0,0,0,0,2,2,6,2,0.0,160.0
2619,e8206c7380441fbb,e17ac6410c8377f4,886264a0c9f4ea5e,2020-09-05,0,0,0,162,2,1,8,3,8,0,0,0,0,0,2,2,6,3,0.0,16.0
2620,7930c605c6a6ec88,36541f1e6c5d4955,80d8aed0ca9b00f3,2020-09-05,0,0,0,900,1,0,140,57,140,0,0,0,0,0,27,25,113,57,0.0,888.0
2621,7930c605c6a6ec88,80d8aed0ca9b00f3,36541f1e6c5d4955,2020-09-05,0,0,0,900,6,1,215,57,215,0,0,0,0,0,38,28,177,57,0.0,864.0
2622,7595aabe89020780,7be14eaed4c74856,90e0985df05e51bc,2020-09-05,0,1,1,39,0,0,3,0,3,0,0,0,0,0,1,1,2,0,0.0,39.0
2623,7595aabe89020780,90e0985df05e51bc,7be14eaed4c74856,2020-09-05,0,0,0,39,1,1,5,0,5,0,0,0,0,0,2,1,3,0,0.0,27.0
2624,7340b4cbdbac5863,2af2f2e26c4c0402,56709e66f1c6008f,2020-09-05,1,0,0,900,8,5,56,29,42,14,2,2,12,11,11,11,31,18,321.3,335.3
2625,7340b4cbdbac5863,56709e66f1c6008f,2af2f2e26c4c0402,2020-09-05,0,3,0,900,5,2,81,16,75,6,1,1,5,5,37,14,38,11,82.7,385.7
2626,24341a8cf1152c5c,441eacbe20e0e80b,b4ad3a06ee4d660c,2020-09-05,0,0,0,1226,0,0,173,66,170,3,0,0,3,2,43,33,127,64,9.3,829.1
2627,24341a8cf1152c5c,b4ad3a06ee4d660c,441eacbe20e0e80b,2020-09-05,1,0,0,1226,3,3,114,53,59,55,7,7,48,41,34,32,25,12,254.9,887.7
2628,0f279b25ccbecc76,595db60957de51d3,7f0f171414d0a287,2020-09-05,0,1,1,879,1,1,153,39,153,0,0,0,0,0,58,49,95,39,0.0,868.0
2629,0f279b25ccbecc76,7f0f171414d0a287,595db60957de51d3,2020-09-05,0,0,0,879,0,0,90,10,90,0,0,0,0,0,17,13,73,10,0.0,871.0
2630,0e809b7e37681783,50db8711c70196cd,a495f599e787614f,2020-09-05,1,0,0,547,0,0,80,12,80,0,0,0,0,0,36,21,44,12,0.0,544.0
2631,0e809b7e37681783,a495f599e787614f,50db8711c70196cd,2020-09-05,0,0,0,547,2,0,40,12,40,0,0,0,0,0,9,7,31,12,0.0,511.0
2632,eb9097be07a3c26a,257b0c8d6f199895,c549573c0df4d676,2020-08-29,0,0,0,900,1,0,198,68,198,0,0,0,0,0,34,17,164,68,0.0,885.0
2633,eb9097be07a3c26a,c549573c0df4d676,257b0c8d6f199895,2020-08-29,0,0,0,900,0,0,173,54,173,0,0,0,0,0,32,17,141,54,0.0,884.0
2634,e1e31a8dfa9c27f6,19b7738321cfae42,2244d9a2b64b8c3b,2020-08-29,0,1,1,393,2,1,38,21,32,6,0,0,6,5,1,1,31,16,74.0,299.9
2635,e1e31a8dfa9c27f6,2244d9a2b64b8c3b,19b7738321cfae42,2020-08-29,1,0,0,393,0,0,100,35,94,6,0,0,6,4,22,14,72,31,19.1,233.0
2636,d43c007dab9c51b0,37cc294027f55e4d,7aa3d6964eff4877,2020-08-29,0,0,0,218,1,0,32,3,32,0,0,0,0,0,15,11,17,3,0.0,215.0
2637,d43c007dab9c51b0,7aa3d6964eff4877,37cc294027f55e4d,2020-08-29,0,1,1,218,0,0,31,11,31,0,0,0,0,0,9,7,22,11,0.0,208.0
2638,c5ba56d51f6b0171,45f7cb591c3ab00b,ae071698e1a3ccd4,2020-08-29,0,2,1,407,2,2,60,16,54,6,0,0,6,6,19,18,35,10,128.0,279.0
2639,c5ba56d51f6b0171,ae071698e1a3ccd4,45f7cb591c3ab00b,2020-08-29,0,0,0,407,0,0,39,6,39,0,0,0,0,0,12,10,27,6,0.0,279.0
2640,864cddd6e165ea2d,84b3e7d38f2d2ec5,f2925e6db404bf1d,2020-08-29,0,0,0,900,7,4,88,36,81,7,6,6,1,1,21,20,60,35,138.3,359.5
2641,864cddd6e165ea2d,f2925e6db404bf1d,84b3e7d38f2d2ec5,2020-08-29,0,0,0,900,1,0,45,18,39,6,0,0,6,5,9,8,30,13,46.5,668.7
2642,3a8e4b830750e9d4,3974fa35c917af1d,9abc648e76c4493a,2020-08-29,0,0,0,900,11,5,156,64,123,33,2,2,31,26,48,38,75,38,256.4,520.1
2643,3a8e4b830750e9d4,9abc648e76c4493a,3974fa35c917af1d,2020-08-29,0,0,0,900,1,1,168,57,166,2,0,0,2,2,44,32,122,55,6.9,564.6
2644,1ff4586752ee8a93,333b9e5c723ac873,d4c9dcd330403612,2020-08-29,1,0,0,900,0,0,57,16,36,21,10,10,11,7,19,18,17,9,670.2,140.3
2645,1ff4586752ee8a93,d4c9dcd330403612,333b9e5c723ac873,2020-08-29,0,0,0,900,2,0,21,5,16,5,0,0,5,2,5,4,11,3,25.7,193.79999999999995
2646,16358c536d739017,9673a497a9da119a,b3d21b2610dcfaeb,2020-08-29,0,1,1,113,1,0,15,6,12,3,0,0,3,3,3,3,9,3,0.0,113.0
2647,16358c536d739017,b3d21b2610dcfaeb,9673a497a9da119a,2020-08-29,0,0,0,113,1,0,11,1,11,0,0,0,0,0,2,1,9,1,0.0,51.0
2648,0a9f22de8600c762,a20f234df70f2182,e8b731feff72294b,2020-08-29,0,0,0,900,0,0,188,61,188,0,0,0,0,0,11,7,177,61,0.0,774.6
2649,0a9f22de8600c762,e8b731feff72294b,a20f234df70f2182,2020-08-29,0,0,0,900,2,1,182,51,177,5,1,1,4,3,47,36,130,48,79.4,773.0
2650,0a7517a16d2d9db6,4ba8d454f762005d,77d7295d1b22c694,2020-08-29,1,0,0,900,0,0,139,34,139,0,0,0,0,0,24,20,115,34,0.0,900.0
2651,0a7517a16d2d9db6,77d7295d1b22c694,4ba8d454f762005d,2020-08-29,0,0,0,900,2,0,157,33,157,0,0,0,0,0,30,20,127,33,0.0,900.0
2652,dfe14e13aa727a0c,6bd02119599741a4,f2688492b9a525a3,2020-08-22,0,0,0,1500,0,0,350,98,350,0,0,0,0,0,91,68,259,98,0.0,1500.0
2653,dfe14e13aa727a0c,f2688492b9a525a3,6bd02119599741a4,2020-08-22,0,0,0,1500,8,2,363,105,363,0,0,0,0,0,54,30,309,105,0.0,1482.0
2654,cfa0dbc7534f3545,8a1f3b5c526cd6e6,8be158ca1e5ea6a0,2020-08-22,3,0,0,144,0,0,32,10,27,5,0,0,5,4,6,5,21,6,2.0,89.0
2655,cfa0dbc7534f3545,8be158ca1e5ea6a0,8a1f3b5c526cd6e6,2020-08-22,1,0,0,144,0,0,68,25,24,44,1,1,43,16,6,4,18,9,53.0,89.0
2656,949619e1b1de9e5f,40d8b74488743800,4aa58269d0664b5b,2020-08-22,0,0,0,900,1,0,182,61,181,1,0,0,1,0,17,16,164,61,0.0,822.5
2657,949619e1b1de9e5f,4aa58269d0664b5b,40d8b74488743800,2020-08-22,1,1,0,900,2,2,233,79,226,7,1,1,6,3,46,38,180,76,77.5,734.0
2658,5d9a3bfdcd28abb8,18b602842a24f7c5,6370c1c1e12723d5,2020-08-22,1,0,0,137,0,0,26,9,24,2,0,0,2,2,13,12,11,7,2.1,121.0
2659,5d9a3bfdcd28abb8,6370c1c1e12723d5,18b602842a24f7c5,2020-08-22,0,0,0,137,0,0,20,1,20,0,0,0,0,0,15,13,5,1,0.0,109.9
2660,37a6fc5e69a7932d,122ac9b816d8b71c,a08ddd04eaffd81d,2020-08-22,1,0,0,398,2,2,36,18,17,19,0,0,19,15,6,6,11,3,129.5,78.19999999999999
2661,37a6fc5e69a7932d,a08ddd04eaffd81d,122ac9b816d8b71c,2020-08-22,0,0,0,398,2,2,46,18,30,16,0,0,16,10,6,4,24,8,169.8,77.5
2662,23e548f618dd0e5f,af65aa688d13eedf,d2cd7a69cc55e7ed,2020-08-22,0,1,1,231,2,0,20,8,20,0,0,0,0,0,5,5,15,8,0.0,74.0
2663,23e548f618dd0e5f,d2cd7a69cc55e7ed,af65aa688d13eedf,2020-08-22,0,0,0,231,0,0,14,2,14,0,0,0,0,0,9,7,5,2,0.0,231.0
2664,0ccc86f7d0e84c3e,c878270af633eb11,f9d0cae37dabfafc,2020-08-22,1,0,0,91,0,0,15,10,13,2,0,0,2,2,5,5,8,8,1.9,78.0
2665,0ccc86f7d0e84c3e,f9d0cae37dabfafc,c878270af633eb11,2020-08-22,0,0,0,91,0,0,7,5,7,0,0,0,0,0,2,2,5,5,0.0,31.1
2666,0a3e48cdd97267f4,3df5493bb279226f,43a59ce3bb40449e,2020-08-22,1,0,0,900,2,2,129,51,117,12,1,1,11,7,36,31,81,44,37.9,758.0
2667,0a3e48cdd97267f4,43a59ce3bb40449e,3df5493bb279226f,2020-08-22,0,0,0,900,1,0,94,30,94,0,0,0,0,0,32,27,62,30,0.0,449.1
2668,dc24c4759651c6ad,2cd428e9606856fd,63def5a5662a6917,2020-08-15,1,0,0,527,0,0,66,21,49,17,0,0,17,12,25,21,24,9,9.0,518.0
2669,dc24c4759651c6ad,63def5a5662a6917,2cd428e9606856fd,2020-08-15,0,0,0,527,0,0,44,6,44,0,0,0,0,0,22,18,22,6,0.0,518.0
2670,86deadaab9905a03,1a08b01fdabb6ae2,eee0ef3e2b14816b,2020-08-15,0,0,0,900,1,0,226,63,226,0,0,0,0,0,74,51,152,63,0.0,862.9
2671,86deadaab9905a03,eee0ef3e2b14816b,1a08b01fdabb6ae2,2020-08-15,0,0,0,900,5,5,185,49,182,3,1,1,2,1,71,64,111,48,37.1,591.0
2672,745bdd823161da89,b4c6c904a9ffc5e8,dab8cfbb6b1db10a,2020-08-15,0,0,0,900,1,0,114,23,114,0,0,0,0,0,22,9,92,23,0.0,583.1
2673,745bdd823161da89,dab8cfbb6b1db10a,b4c6c904a9ffc5e8,2020-08-15,0,0,0,900,4,1,70,15,62,8,0,0,8,5,37,31,25,10,86.9,737.0
2674,7200343d2e957cf3,7c7332319c14094c,b50a426a33da0012,2020-08-15,1,0,0,280,0,0,30,5,22,8,2,2,6,5,18,11,4,0,11.0,269.0
2675,7200343d2e957cf3,b50a426a33da0012,7c7332319c14094c,2020-08-15,0,0,0,280,0,0,21,3,21,0,0,0,0,0,9,7,12,3,0.0,269.0
2676,57939328c1214107,99506df1af6c8b3b,c03520b5c88ed6b4,2020-08-15,0,0,0,900,0,0,86,11,86,0,0,0,0,0,23,16,63,11,0.0,896.0
2677,57939328c1214107,c03520b5c88ed6b4,99506df1af6c8b3b,2020-08-15,0,0,0,900,20,2,133,16,133,0,0,0,0,0,39,34,94,16,0.0,676.0
2678,5081319e58f9759f,7dda2cf308f24a02,b6850671a008bf9a,2020-08-15,0,2,1,104,1,1,5,4,0,5,0,0,5,4,0,0,0,0,93.0,11.0
2679,5081319e58f9759f,b6850671a008bf9a,7dda2cf308f24a02,2020-08-15,0,0,0,104,0,0,1,0,1,0,0,0,0,0,1,1,0,0,0.0,11.0
2680,3e4b8bd71e8bceb2,0de720c0f1d4ab9c,d31cbcdd7d69536d,2020-08-15,0,0,0,900,4,4,110,23,97,13,2,1,11,8,27,25,70,15,125.0,775.0
2681,3e4b8bd71e8bceb2,d31cbcdd7d69536d,0de720c0f1d4ab9c,2020-08-15,0,0,0,900,6,0,139,25,139,0,0,0,0,0,36,18,103,25,0.0,712.0
2682,3bdacc82209b33f5,d28dee5c705991df,d967f0128c323de6,2020-08-15,1,0,0,1500,6,0,187,67,187,0,0,0,0,0,51,48,136,67,0.0,1148.0
2683,3bdacc82209b33f5,d967f0128c323de6,d28dee5c705991df,2020-08-15,0,0,0,1500,2,1,183,70,183,0,0,0,0,0,51,35,132,70,0.0,1447.0
2684,2e9ad55f2e2f7c56,ac40f7e3cbecdda4,d0aaedcf7ccd0b45,2020-08-15,0,0,0,268,0,0,52,12,52,0,0,0,0,0,8,5,44,12,0.0,260.2
2685,2e9ad55f2e2f7c56,d0aaedcf7ccd0b45,ac40f7e3cbecdda4,2020-08-15,2,0,0,268,0,0,59,29,57,2,0,0,2,2,10,8,47,27,7.8,233.0
2686,0d9e9127c62811f9,361d49960a196976,4f140403000158b5,2020-08-15,1,0,0,577,2,1,75,50,14,61,4,2,57,46,6,5,8,4,367.0,90.4
2687,0d9e9127c62811f9,4f140403000158b5,361d49960a196976,2020-08-15,0,0,0,577,4,3,22,6,17,5,1,1,4,3,6,3,11,3,113.6,51.0
2688,054794810817c1cc,c77a953488e5607d,d1941565abf50b16,2020-08-15,0,0,0,900,5,3,78,27,46,32,0,0,32,17,14,14,32,10,293.2,351.0
2689,054794810817c1cc,d1941565abf50b16,c77a953488e5607d,2020-08-15,0,2,0,900,2,2,39,6,33,6,1,1,5,2,8,7,25,4,155.0,296.8
2690,e8f4e8ff49678b44,4dcfb28c011c11b2,fccf811c1e8b01c7,2020-08-08,0,0,0,254,1,0,51,16,51,0,0,0,0,0,11,5,40,16,0.0,183.0
2691,e8f4e8ff49678b44,fccf811c1e8b01c7,4dcfb28c011c11b2,2020-08-08,1,0,0,254,1,0,55,23,53,2,0,0,2,2,7,5,46,21,71.0,183.0
2692,e255fc129f225a55,52c2ae6d2f2d2613,d21113c9ff3788ae,2020-08-08,1,3,0,900,5,3,92,40,73,19,0,0,19,12,18,14,55,28,357.5,486.0
2693,e255fc129f225a55,d21113c9ff3788ae,52c2ae6d2f2d2613,2020-08-08,0,0,0,900,2,0,57,13,57,0,0,0,0,0,14,10,43,13,0.0,448.5
2694,cfb189e326553f0a,08af939f41b5a57b,df1eb4354d18a906,2020-08-08,1,0,0,278,2,0,64,30,64,0,0,0,0,0,7,6,57,30,0.0,161.0
2695,cfb189e326553f0a,df1eb4354d18a906,08af939f41b5a57b,2020-08-08,0,0,0,278,1,0,18,4,18,0,0,0,0,0,6,5,12,4,0.0,254.0
2696,c2ddadfa1a1056be,a17ad5a5048e8c3f,c549573c0df4d676,2020-08-08,0,1,1,221,1,0,38,9,38,0,0,0,0,0,6,4,32,9,0.0,202.0
2697,c2ddadfa1a1056be,c549573c0df4d676,a17ad5a5048e8c3f,2020-08-08,0,0,0,221,1,1,31,7,31,0,0,0,0,0,9,5,22,7,0.0,204.0
2698,ad62675e819e92fc,3143bf892608139a,a78a87d8c2bbb1cb,2020-08-08,0,0,0,900,2,1,57,20,51,6,3,3,3,3,20,20,31,17,125.7,104.0
2699,ad62675e819e92fc,a78a87d8c2bbb1cb,3143bf892608139a,2020-08-08,0,0,0,900,1,0,26,5,26,0,0,0,0,0,3,1,23,5,0.0,753.3
2700,a2e34655a41ba45c,98c23cb6da5b3352,d3df1add9d9a7efb,2020-08-08,0,2,0,321,1,1,6,1,5,1,1,1,0,0,1,0,4,1,141.0,21.0
2701,a2e34655a41ba45c,d3df1add9d9a7efb,98c23cb6da5b3352,2020-08-08,1,0,0,321,1,1,42,34,7,35,0,0,35,30,1,1,6,4,159.0,21.0
2702,6f1892ed71d943d7,4b47e71384a9522f,a12a8314adc1c1c9,2020-08-08,1,0,0,900,6,2,147,55,144,3,0,0,3,2,32,30,112,53,34.4,533.0
2703,6f1892ed71d943d7,a12a8314adc1c1c9,4b47e71384a9522f,2020-08-08,0,0,0,900,1,0,161,47,161,0,0,0,0,0,40,24,121,47,0.0,861.6
2704,5c8d9d893d163d51,06a80a685ea98573,e87a13e02c01331d,2020-08-08,0,0,0,900,5,2,73,30,70,3,0,0,3,3,12,6,58,27,16.9,838.0
2705,5c8d9d893d163d51,e87a13e02c01331d,06a80a685ea98573,2020-08-08,0,1,0,900,9,2,105,28,105,0,0,0,0,0,19,16,86,28,0.0,768.1
2706,26173f6491300eaa,b7b84ccd221be298,f8f1ec513bcfef43,2020-08-08,0,0,0,900,0,0,215,93,215,0,0,0,0,0,14,11,201,93,0.0,898.0
2707,26173f6491300eaa,f8f1ec513bcfef43,b7b84ccd221be298,2020-08-08,0,0,0,900,8,1,144,32,144,0,0,0,0,0,8,5,136,32,0.0,846.0
2708,22e10b23784e5efc,16690d100f995f8f,3a8176e15b9887c1,2020-08-08,0,0,0,900,8,4,91,25,85,6,0,0,6,4,10,8,75,21,33.2,380.0
2709,22e10b23784e5efc,3a8176e15b9887c1,16690d100f995f8f,2020-08-08,0,0,0,900,16,5,56,25,44,12,1,1,11,10,5,3,39,15,426.0,369.8
2710,1308213458d8596b,304a21d0595e1a08,da816417a579a0bd,2020-08-08,1,1,0,703,1,0,101,30,89,12,0,0,12,8,17,11,72,22,32.6,644.0
2711,1308213458d8596b,da816417a579a0bd,304a21d0595e1a08,2020-08-08,0,4,1,703,2,1,211,61,210,1,0,0,1,0,34,26,176,61,21.0,586.4
2712,05f6459d1f3ed13f,3a46b268013afede,b9437600497350f3,2020-08-08,2,0,0,632,0,0,134,45,131,3,0,0,3,3,48,34,83,42,3.6,620.0
2713,05f6459d1f3ed13f,b9437600497350f3,3a46b268013afede,2020-08-08,0,0,0,632,2,0,120,6,120,0,0,0,0,0,61,34,59,6,0.0,615.4
2714,dcf161082c849205,45f0cc9d18f35137,7f6ed67d3ed3c036,2020-08-01,0,1,0,900,1,1,109,28,102,7,1,1,6,3,49,37,53,25,40.7,540.8
2715,dcf161082c849205,7f6ed67d3ed3c036,45f0cc9d18f35137,2020-08-01,0,1,0,900,13,2,85,20,81,4,0,0,4,2,24,16,57,18,295.2,490.3
2716,94b48b98d0292720,9ba2226646046b63,f2477cf43c4975cc,2020-08-01,0,0,0,657,4,1,72,12,72,0,0,0,0,0,29,27,43,12,0.0,548.9
2717,94b48b98d0292720,f2477cf43c4975cc,9ba2226646046b63,2020-08-01,3,0,0,657,1,1,133,48,111,22,1,1,21,18,42,30,69,30,38.1,612.0
2718,76b9a338597fc604,e00a3dee329a51f7,ed2a8cc402173781,2020-08-01,0,0,0,900,7,5,196,58,194,2,0,0,2,2,53,45,141,56,21.7,548.8
2719,76b9a338597fc604,ed2a8cc402173781,e00a3dee329a51f7,2020-08-01,0,0,0,900,2,0,152,58,149,3,0,0,3,3,25,18,124,55,4.2,850.3
2720,6ba9f6a7a9361354,6e9f40c706f91f32,f6bcbd91b114ff58,2020-08-01,0,0,0,900,1,1,50,9,50,0,0,0,0,0,13,12,37,9,0.0,550.6
2721,6ba9f6a7a9361354,f6bcbd91b114ff58,6e9f40c706f91f32,2020-08-01,0,1,0,900,16,2,78,18,61,17,1,1,16,12,43,30,18,6,260.4,318.0
2722,5885445f39dac389,12f91bfa8f1f723b,8e1f36476ef02a6a,2020-08-01,0,0,0,269,1,1,49,6,46,3,0,0,3,2,24,20,22,4,98.2,138.0
2723,5885445f39dac389,8e1f36476ef02a6a,12f91bfa8f1f723b,2020-08-01,0,1,1,269,0,0,37,16,37,0,0,0,0,0,5,4,32,16,0.0,170.8
2724,2fb1abeb337e0ccc,6d4b63c767106d3a,c6aee362c7a7d482,2020-08-01,2,0,0,596,0,0,122,33,114,8,1,1,7,4,33,30,81,29,48.0,525.3
2725,2fb1abeb337e0ccc,c6aee362c7a7d482,6d4b63c767106d3a,2020-08-01,0,0,0,596,2,1,133,35,132,1,0,0,1,0,31,26,101,35,4.7,496.0
2726,0b88d0c76f9cd7e4,4144798612ef96e5,b1a3e0aca758b322,2020-08-01,0,0,0,626,0,0,72,17,72,0,0,0,0,0,22,18,50,17,0.0,500.2
2727,0b88d0c76f9cd7e4,b1a3e0aca758b322,4144798612ef96e5,2020-08-01,1,0,0,626,8,4,145,58,112,33,0,0,33,26,39,30,73,32,122.8,440.0
2728,0b21755eb0897396,887961364be5ceb3,f9b200db02b488d9,2020-08-01,1,0,0,900,3,3,195,67,172,23,1,1,22,14,59,47,113,53,121.6,715.0
2729,0b21755eb0897396,f9b200db02b488d9,887961364be5ceb3,2020-08-01,0,0,0,900,2,1,127,31,127,0,0,0,0,0,28,23,99,31,0.0,751.4
2730,f786136e55007e17,3c6976f8182d9527,492b202d2064e7a9,2020-07-25,0,0,0,150,0,0,19,9,12,7,0,0,7,7,4,2,8,2,12.0,72.0
2731,f786136e55007e17,492b202d2064e7a9,3c6976f8182d9527,2020-07-25,0,1,1,150,2,1,5,1,4,1,0,0,1,1,3,3,1,0,66.0,72.0
2732,a3820f1eb82f2ba6,140745cbbcb023ac,73e09f837f3b5ecc,2020-07-25,0,0,0,900,4,2,103,27,97,6,1,1,5,2,30,26,67,25,88.5,658.2
2733,a3820f1eb82f2ba6,73e09f837f3b5ecc,140745cbbcb023ac,2020-07-25,0,0,0,900,0,0,100,39,96,4,3,3,1,1,6,4,90,38,64.8,730.5
2734,88d3b6b833e31712,04c8b08b16a5b99e,41f90012b86a11bf,2020-07-25,1,0,0,456,0,0,60,15,48,12,1,1,11,8,28,27,20,7,6.0,450.0
2735,88d3b6b833e31712,41f90012b86a11bf,04c8b08b16a5b99e,2020-07-25,0,0,0,456,1,0,36,6,36,0,0,0,0,0,8,6,28,6,0.0,450.0
2736,87daaa6db4f6940c,62f7097c04311193,abd5fb12437eda21,2020-07-25,0,0,0,900,1,1,72,13,69,3,0,0,3,2,30,17,39,11,10.5,752.8
2737,87daaa6db4f6940c,abd5fb12437eda21,62f7097c04311193,2020-07-25,0,2,0,900,12,4,67,22,63,4,2,2,2,1,6,5,57,21,126.2,479.5
2738,74dae3d87a99cf5d,af997f7611673880,eabf206b162b3b83,2020-07-25,0,0,0,126,2,1,16,9,2,14,1,1,13,9,1,1,1,0,101.0,25.0
2739,74dae3d87a99cf5d,eabf206b162b3b83,af997f7611673880,2020-07-25,0,1,1,126,0,0,5,2,5,0,0,0,0,0,0,0,5,2,0.0,25.0
2740,6cfab1da57d260f4,399afbabc02376b5,92fa1401b7927da3,2020-07-25,1,0,0,45,0,0,10,7,9,1,0,0,1,1,3,3,6,6,2.0,43.0
2741,6cfab1da57d260f4,92fa1401b7927da3,399afbabc02376b5,2020-07-25,0,0,0,45,0,0,9,1,9,0,0,0,0,0,2,2,7,1,0.0,43.0
2742,67db05bac9165722,329e403448756217,5fa2974cbd18e05c,2020-07-25,0,0,0,900,3,1,232,59,232,0,0,0,0,0,89,72,143,59,0.0,851.0
2743,67db05bac9165722,5fa2974cbd18e05c,329e403448756217,2020-07-25,0,0,0,900,1,0,130,35,130,0,0,0,0,0,22,20,108,35,0.0,889.0
2744,58e07add007685f8,1fcfc3709fe58151,57b10fca4f9c9a7a,2020-07-25,0,0,0,900,3,0,67,13,67,0,0,0,0,0,21,16,46,13,0.0,849.8
2745,58e07add007685f8,57b10fca4f9c9a7a,1fcfc3709fe58151,2020-07-25,1,0,0,900,0,0,93,19,92,1,0,0,1,1,42,26,50,18,3.2,874.0
2746,573d3a6984cbcd29,767755fd74662dbf,f748267c4ab6c127,2020-07-25,1,1,0,189,2,1,62,40,1,61,0,0,61,40,0,0,1,0,179.0,10.0
2747,573d3a6984cbcd29,f748267c4ab6c127,767755fd74662dbf,2020-07-25,0,0,0,189,0,0,0,0,0,0,0,0,0,0,0,0,0,0,0.0,10.0
2748,5632f2364016e879,cd2c4d30c6e13b47,d910665038efc639,2020-07-25,0,0,0,900,0,0,76,34,39,37,0,0,37,25,6,6,33,9,62.3,314.1
2749,5632f2364016e879,d910665038efc639,cd2c4d30c6e13b47,2020-07-25,0,1,0,900,9,5,60,29,17,43,2,2,41,26,2,2,15,3,521.9,303.7
2750,54bbc7974df586a1,673ea7dcc786b1b3,91dac5e69e28d5b5,2020-07-25,0,0,0,900,5,1,143,40,141,2,1,1,1,0,25,15,116,40,14.2,779.0
2751,54bbc7974df586a1,91dac5e69e28d5b5,673ea7dcc786b1b3,2020-07-25,0,0,0,900,0,0,199,76,199,0,0,0,0,0,31,27,168,76,0.0,880.8
2752,407e1c6850e7022c,5580771f383e141f,9d19d9e4aa2662e8,2020-07-25,1,1,0,168,0,0,45,22,37,8,0,0,8,7,11,8,26,15,12.9,147.0
2753,407e1c6850e7022c,9d19d9e4aa2662e8,5580771f383e141f,2020-07-25,0,0,0,168,0,0,50,10,50,0,0,0,0,0,12,10,38,10,0.0,129.1
2754,3b209a2aee014ac2,4c88a1db5a46c6a4,a8283a4f415e1eb9,2020-07-25,1,0,0,690,0,0,70,15,67,3,0,0,3,0,7,6,60,15,66.7,352.9
2755,3b209a2aee014ac2,a8283a4f415e1eb9,4c88a1db5a46c6a4,2020-07-25,1,2,0,690,3,2,58,15,49,9,1,0,8,8,22,15,27,7,137.1,425.3
2756,32b0e450b11b32fe,56fcb2c4d99f9d1b,76e2870ffafbe38f,2020-07-25,0,1,0,900,15,6,66,11,65,1,0,0,1,1,13,9,52,10,77.5,745.0
2757,32b0e450b11b32fe,76e2870ffafbe38f,56fcb2c4d99f9d1b,2020-07-25,0,0,0,900,0,0,150,53,150,0,0,0,0,0,30,26,120,53,0.0,774.5
2758,11f715fa5e825e51,9ce6d5a03af801b7,e1147d3d2dabe1ce,2020-07-25,0,0,0,1500,0,0,99,29,96,3,0,0,3,3,13,12,83,26,8.8,1407.1
2759,11f715fa5e825e51,e1147d3d2dabe1ce,9ce6d5a03af801b7,2020-07-25,1,0,0,1500,13,2,157,32,150,7,0,0,7,5,41,37,109,27,57.9,1342.2
2760,fcfd2e6eed519cb9,0a1942069c9ad6b6,8c0580d4fff106c1,2020-07-18,0,1,1,78,1,0,4,0,4,0,0,0,0,0,3,2,1,0,0.0,78.0
2761,fcfd2e6eed519cb9,8c0580d4fff106c1,0a1942069c9ad6b6,2020-07-18,0,0,0,78,1,1,3,0,3,0,0,0,0,0,2,0,1,0,0.0,45.0
2762,ecb24300bb3bef8c,0052de90691d4a93,eae48ff31db420c2,2020-07-18,0,0,0,900,5,0,103,20,99,4,0,0,4,0,21,13,78,20,6.5,781.7
2763,ecb24300bb3bef8c,eae48ff31db420c2,0052de90691d4a93,2020-07-18,0,0,0,900,5,1,197,60,189,8,0,0,8,5,37,31,152,55,100.3,705.5
2764,e5a9f75b1117d848,327d5f279895110d,c3218c810959d279,2020-07-18,1,0,0,255,0,0,22,9,16,6,0,0,6,6,11,10,5,3,3.0,218.0
2765,e5a9f75b1117d848,c3218c810959d279,327d5f279895110d,2020-07-18,0,0,0,255,0,0,14,0,12,2,2,1,0,0,4,3,8,0,34.0,218.0
2766,e5872dfa5b93fcbb,32c355b04fc57f3a,c814b4c899793af6,2020-07-18,0,0,0,900,4,0,148,31,148,0,0,0,0,0,43,37,105,31,0.0,853.9
2767,e5872dfa5b93fcbb,c814b4c899793af6,32c355b04fc57f3a,2020-07-18,0,0,0,900,2,1,124,28,122,2,0,0,2,2,59,50,63,26,24.1,731.0
2768,c4c379b8f99fea88,528b071cf3da7c56,6551c64fbcd1a467,2020-07-18,0,1,0,88,0,0,4,0,4,0,0,0,0,0,2,2,2,0,0.0,88.0
2769,c4c379b8f99fea88,6551c64fbcd1a467,528b071cf3da7c56,2020-07-18,0,1,1,88,0,0,4,1,4,0,0,0,0,0,2,2,2,1,0.0,21.0
2770,ba4485ce4e8e3fe1,a0f0004aadf10b71,b1d19449397541dc,2020-07-18,0,0,0,900,2,1,62,17,61,1,0,0,1,1,22,15,39,16,68.5,659.3
2771,ba4485ce4e8e3fe1,b1d19449397541dc,a0f0004aadf10b71,2020-07-18,0,0,0,900,15,2,63,31,60,3,0,0,3,2,10,10,50,29,103.7,520.5
2772,b9b0da84b243213f,6d35bf94f7d30241,dee294e9717012c2,2020-07-18,0,1,1,282,1,1,28,8,25,3,0,0,3,2,4,4,21,6,141.0,141.0
2773,b9b0da84b243213f,dee294e9717012c2,6d35bf94f7d30241,2020-07-18,0,0,0,282,0,0,16,1,16,0,0,0,0,0,5,2,11,1,0.0,119.0
2774,b76c0b0ed2926737,58bbef3770bb2dfc,654ae722109a0d31,2020-07-18,0,1,1,145,0,0,37,7,37,0,0,0,0,0,13,11,24,7,0.0,145.0
2775,b76c0b0ed2926737,654ae722109a0d31,58bbef3770bb2dfc,2020-07-18,0,0,0,145,1,1,26,6,26,0,0,0,0,0,10,8,16,6,0.0,136.0
2776,b5f70d0c88f12645,cc1a8b4b38b92c6d,ec52462a1b41f714,2020-07-18,1,0,0,900,3,2,44,18,36,8,1,1,7,6,8,7,28,12,99.1,608.5
2777,b5f70d0c88f12645,ec52462a1b41f714,cc1a8b4b38b92c6d,2020-07-18,0,1,0,900,19,8,19,7,17,2,0,0,2,1,5,4,12,6,130.5,278.9
2778,4dc5039b21013b3a,80eacd4da0617c57,aa72b0f831d0bfe5,2020-07-18,0,0,0,288,0,0,28,8,28,0,0,0,0,0,13,10,15,8,0.0,145.0
2779,4dc5039b21013b3a,aa72b0f831d0bfe5,80eacd4da0617c57,2020-07-18,2,4,1,288,0,0,40,31,16,24,0,0,24,23,4,4,12,8,143.0,145.0
2780,147e31abbe3927d0,a2ea77e974c5889f,e2f6b2769aaedd6c,2020-07-18,0,0,0,900,0,0,121,30,121,0,0,0,0,0,14,14,107,30,0.0,639.3
2781,147e31abbe3927d0,e2f6b2769aaedd6c,a2ea77e974c5889f,2020-07-18,0,0,0,900,7,3,149,72,124,25,0,0,25,23,1,1,123,49,260.7,608.0
2782,f3efc6121c5323ff,1ae8f3c723aacff4,396fe87b84ac2e1c,2020-07-15,0,0,0,258,2,0,29,3,27,2,0,0,2,2,12,7,15,1,28.5,127.8
2783,f3efc6121c5323ff,396fe87b84ac2e1c,1ae8f3c723aacff4,2020-07-15,1,0,0,258,2,1,40,14,15,25,3,3,22,14,5,5,10,0,73.2,147.5
2784,f3c42ce9fad55eb7,34c2b3656f88f7ef,b8a85389d115e35a,2020-07-15,0,0,0,449,0,0,15,1,15,0,0,0,0,0,6,5,9,1,0.0,181.89999999999998
2785,f3c42ce9fad55eb7,b8a85389d115e35a,34c2b3656f88f7ef,2020-07-15,0,1,1,449,8,3,45,19,20,25,0,0,25,16,13,10,7,3,262.1,124.0
2786,dccea04cc3567955,d7e40dca3ae125be,eebc23626e38f5dc,2020-07-15,0,0,0,163,2,1,9,3,9,0,0,0,0,0,3,2,6,3,0.0,69.0
2787,dccea04cc3567955,eebc23626e38f5dc,d7e40dca3ae125be,2020-07-15,0,3,1,163,0,0,3,1,3,0,0,0,0,0,1,1,2,1,0.0,111.0
2788,d4c314616eac8f8b,9c907996820d2d69,bf7ad5628363eec9,2020-07-15,0,1,0,900,3,2,89,16,84,5,3,3,2,1,42,29,42,15,28.3,781.0
2789,d4c314616eac8f8b,bf7ad5628363eec9,9c907996820d2d69,2020-07-15,0,0,0,900,5,1,72,13,72,0,0,0,0,0,17,13,55,13,0.0,606.7
2790,abeaae1a64934178,751de04455cfaac0,82a5152216251682,2020-07-15,0,0,0,1500,1,1,260,70,239,21,1,1,20,8,48,34,191,62,57.8,1434.0
2791,abeaae1a64934178,82a5152216251682,751de04455cfaac0,2020-07-15,0,0,0,1500,9,0,218,37,218,0,0,0,0,0,68,47,150,37,0.0,1439.2
2792,819f51ef9d945a46,7026eca45f65377b,bebb4ae55ac2bf6f,2020-07-15,0,0,0,900,6,3,69,35,38,31,2,2,29,21,9,7,29,14,567.1,278.0
2793,819f51ef9d945a46,bebb4ae55ac2bf6f,7026eca45f65377b,2020-07-15,0,1,0,900,1,0,58,13,58,0,0,0,0,0,9,7,49,13,0.0,289.9
2794,7fd810af30144119,767755fd74662dbf,e9ac7bfb65c25497,2020-07-15,0,1,1,372,2,2,52,40,1,51,2,2,49,40,1,1,0,0,354.0,18.0
2795,7fd810af30144119,e9ac7bfb65c25497,767755fd74662dbf,2020-07-15,0,0,0,372,0,0,2,1,2,0,0,0,0,0,0,0,2,1,0.0,18.0
2796,7dbf23cb872edc9c,20999e27ddd94bda,c96d9178c9ed9e62,2020-07-15,0,2,0,900,2,1,122,39,122,0,0,0,0,0,25,16,97,39,0.0,824.0
2797,7dbf23cb872edc9c,c96d9178c9ed9e62,20999e27ddd94bda,2020-07-15,0,2,0,900,13,1,169,31,159,10,0,0,10,9,69,36,90,22,54.0,738.0
2798,33d2a1dbb8a7fef5,49ee5024966efc0d,eae431e70064e046,2020-07-15,0,0,0,900,4,4,177,51,171,6,3,3,3,3,56,44,115,48,67.4,608.0
2799,33d2a1dbb8a7fef5,eae431e70064e046,49ee5024966efc0d,2020-07-15,0,0,0,900,4,1,133,49,133,0,0,0,0,0,25,18,108,49,0.0,741.6
2800,15def71ff1679e06,51018a31ddf31eb2,f7467152fd9f18a2,2020-07-15,0,0,0,900,4,0,106,25,106,0,0,0,0,0,27,23,79,25,0.0,576.0
2801,15def71ff1679e06,f7467152fd9f18a2,51018a31ddf31eb2,2020-07-15,0,1,0,900,7,5,143,24,126,17,1,1,16,10,52,32,74,14,268.0,427.0
2802,0e969ae805006d1f,476fe566d2df676e,79325a3c1a5c3bf4,2020-07-15,1,0,0,300,0,0,49,11,49,0,0,0,0,0,9,7,40,11,0.0,300.0
2803,0e969ae805006d1f,79325a3c1a5c3bf4,476fe566d2df676e,2020-07-15,0,0,0,300,1,0,46,8,46,0,0,0,0,0,20,15,26,8,0.0,291.0
2804,e16f42a666e163d8,47b63240018d5d86,6a1901c62ab3870f,2020-07-11,0,0,0,900,1,0,235,63,235,0,0,0,0,0,26,19,209,63,0.0,900.0
2805,e16f42a666e163d8,6a1901c62ab3870f,47b63240018d5d86,2020-07-11,0,0,0,900,3,1,205,31,205,0,0,0,0,0,71,40,134,31,0.0,871.0
2806,d292243c6499b2fe,47b9e0e7703a4868,f1b2aa7853d1ed6e,2020-07-11,0,0,0,1500,0,0,125,23,124,1,0,0,1,1,56,43,68,22,0.0,1254.3
2807,d292243c6499b2fe,f1b2aa7853d1ed6e,47b9e0e7703a4868,2020-07-11,0,0,0,1500,16,5,151,43,135,16,1,1,15,12,54,50,81,31,245.7,502.0
2808,ce7cd2ec773bea7f,447f9858ae78f921,8adcbd525fab8d9b,2020-07-11,0,0,0,900,3,0,88,23,88,0,0,0,0,0,24,17,64,23,0.0,860.1
2809,ce7cd2ec773bea7f,8adcbd525fab8d9b,447f9858ae78f921,2020-07-11,0,0,0,900,4,0,138,23,128,10,0,0,10,8,40,23,88,15,37.9,847.0
2810,cd8cdb539deaa47f,009341ed974bad72,0845c81e37d3bcb3,2020-07-11,1,0,0,349,0,0,73,29,73,0,0,0,0,0,6,4,67,29,0.0,347.0
2811,cd8cdb539deaa47f,0845c81e37d3bcb3,009341ed974bad72,2020-07-11,0,0,0,349,1,0,92,30,92,0,0,0,0,0,16,11,76,30,0.0,332.0
2812,94b1596c6ff9a25d,150ff4cc642270b9,e1248941344b3288,2020-07-11,0,0,0,1500,0,0,268,44,268,0,0,0,0,0,101,58,167,44,0.0,1487.7
2813,94b1596c6ff9a25d,e1248941344b3288,150ff4cc642270b9,2020-07-11,0,0,0,1500,9,3,272,64,271,1,0,0,1,0,111,73,160,64,12.3,1414.0
2814,7c76c752c7abf2e0,9c65736747ca92ec,d61316139d68dbe3,2020-07-11,0,0,0,900,2,1,119,56,101,18,0,0,18,14,13,10,88,42,56.4,561.3
2815,7c76c752c7abf2e0,d61316139d68dbe3,9c65736747ca92ec,2020-07-11,0,0,0,900,11,1,117,24,103,14,2,1,12,6,33,25,70,18,244.7,476.6
2816,6e0c1faaf40caf9a,4d5197f331c47290,beecb672a279223e,2020-07-11,0,0,0,141,0,0,5,1,5,0,0,0,0,0,4,2,1,1,0.0,109.0
2817,6e0c1faaf40caf9a,beecb672a279223e,4d5197f331c47290,2020-07-11,0,1,1,141,1,1,7,1,7,0,0,0,0,0,6,5,1,1,0.0,73.0
2818,5d6fb4acfe5cc8a1,113df4fde64735c6,ea3dcc417c322064,2020-07-11,1,1,0,758,4,2,177,47,172,5,0,0,5,3,33,27,139,44,80.0,542.0
2819,5d6fb4acfe5cc8a1,ea3dcc417c322064,113df4fde64735c6,2020-07-11,1,0,0,758,1,0,160,45,155,5,0,0,5,2,27,17,128,43,88.0,590.0
2820,159646a9d2ae8ea5,87a1dc546b1c5caf,f7d73e452b064bf2,2020-07-11,0,1,1,195,1,1,6,1,6,0,0,0,0,0,1,1,5,1,0.0,148.0
2821,159646a9d2ae8ea5,f7d73e452b064bf2,87a1dc546b1c5caf,2020-07-11,0,0,0,195,0,0,16,1,16,0,0,0,0,0,10,5,6,1,0.0,195.0
2822,137646de0ffd9c35,950d0ef5c17157c5,c9cf753cfdf77fc2,2020-07-11,0,0,0,900,0,0,32,9,32,0,0,0,0,0,12,9,20,9,0.0,733.3
2823,137646de0ffd9c35,c9cf753cfdf77fc2,950d0ef5c17157c5,2020-07-11,0,0,0,900,7,3,52,15,48,4,0,0,4,4,16,9,32,11,150.7,335.0
2824,0f9be7ac405772f8,d0f3959b4a9747e6,d661ce4da776fc20,2020-07-11,0,0,0,1404,1,0,157,38,157,0,0,0,0,0,60,45,97,38,0.0,1143.5
2825,0f9be7ac405772f8,d661ce4da776fc20,d0f3959b4a9747e6,2020-07-11,1,0,0,1404,2,1,309,150,212,97,9,9,88,77,44,35,168,73,260.5,1114.0
2826,0e8d5c16eb9cb1cf,55fa6ce3e522c8bb,82b4e942781b1046,2020-07-11,0,0,0,900,11,2,119,19,117,2,0,0,2,1,58,47,59,18,14.5,871.0
2827,0e8d5c16eb9cb1cf,82b4e942781b1046,55fa6ce3e522c8bb,2020-07-11,0,0,0,900,0,0,121,14,121,0,0,0,0,0,50,38,71,14,0.0,842.5
2828,08e48648e3504638,351c4ec637380ad5,9b7dfb3b7d99926a,2020-07-11,0,0,0,900,4,2,228,82,179,49,0,0,49,32,48,38,131,50,343.0,550.0
2829,08e48648e3504638,9b7dfb3b7d99926a,351c4ec637380ad5,2020-07-11,0,0,0,900,2,0,135,22,135,0,0,0,0,0,32,23,103,22,0.0,551.0
2830,f8dd1e75978a3957,029eaff01e6bb8f0,193b9d1858bc4df3,2020-06-27,0,4,0,1500,7,1,231,131,210,21,1,1,20,16,25,21,185,115,82.5,1210.3
2831,f8dd1e75978a3957,193b9d1858bc4df3,029eaff01e6bb8f0,2020-06-27,0,0,0,1500,9,4,253,98,245,8,0,0,8,7,76,57,169,91,120.7,1055.5
2832,f2d9814936a6eb35,9e50097a89442158,f2b6fdb20675b11c,2020-06-27,0,0,0,900,6,0,106,39,103,3,0,0,3,1,17,16,86,38,17.0,571.6
2833,f2d9814936a6eb35,f2b6fdb20675b11c,9e50097a89442158,2020-06-27,1,0,0,900,1,1,131,49,106,25,0,0,25,19,33,27,73,30,277.4,539.0
2834,cfd47fddbb705f26,2f181c0467965b98,d6c0cdd7e467c440,2020-06-27,1,0,0,900,0,0,66,31,29,37,1,1,36,24,10,9,19,7,311.7,159.5
2835,cfd47fddbb705f26,d6c0cdd7e467c440,2f181c0467965b98,2020-06-27,0,0,0,900,5,3,58,29,38,20,1,1,19,12,6,4,32,17,403.5,124.30000000000001
2836,9ce56acac775d386,068f8a189a47fea6,fcd448a2fe1a23cc,2020-06-27,0,1,1,824,0,0,137,24,137,0,0,0,0,0,50,39,87,24,0.0,667.0
2837,9ce56acac775d386,fcd448a2fe1a23cc,068f8a189a47fea6,2020-06-27,1,0,0,824,0,0,105,35,79,26,1,1,25,20,45,36,34,15,157.0,667.0
2838,9025e3c6b6d71253,2844b047183a1adb,78e501478a36a018,2020-06-27,0,3,0,773,7,3,77,25,70,7,1,1,6,4,15,12,55,21,253.0,492.4
2839,9025e3c6b6d71253,78e501478a36a018,2844b047183a1adb,2020-06-27,0,1,1,773,0,0,101,20,98,3,0,0,3,3,40,35,58,17,27.6,474.0
2840,75570ea2da94a4fb,04c8b08b16a5b99e,53c943c873cffe90,2020-06-27,1,0,0,161,0,0,22,6,21,1,0,0,1,1,10,9,11,5,1.0,160.0
2841,75570ea2da94a4fb,53c943c873cffe90,04c8b08b16a5b99e,2020-06-27,0,0,0,161,0,0,17,3,17,0,0,0,0,0,8,3,9,3,0.0,160.0
2842,67ed3ad521ef619c,5f3805dda9661cba,8abac218746e04ca,2020-06-27,0,0,0,48,1,0,5,0,5,0,0,0,0,0,3,2,2,0,0.0,37.0
2843,67ed3ad521ef619c,8abac218746e04ca,5f3805dda9661cba,2020-06-27,1,0,0,48,0,0,21,18,5,16,0,0,16,15,0,0,5,3,11.0,37.0
2844,1b8d366ac0f110f3,4100c7a09497ad41,d05cb1e8d1b885d8,2020-06-27,0,1,1,746,11,2,55,16,41,14,7,7,7,7,11,8,30,9,252.9,474.0
2845,1b8d366ac0f110f3,d05cb1e8d1b885d8,4100c7a09497ad41,2020-06-27,0,0,0,746,0,0,46,7,45,1,0,0,1,0,24,19,21,7,1.0,486.1
2846,0f369d09416b9e34,52c2ae6d2f2d2613,ebef46976554f975,2020-06-27,0,0,0,900,2,0,112,42,110,2,0,0,2,0,27,17,83,42,37.6,303.0
2847,0f369d09416b9e34,ebef46976554f975,52c2ae6d2f2d2613,2020-06-27,0,0,0,900,8,2,69,26,67,2,0,0,2,0,2,2,65,26,334.0,528.4
2848,f044802db5688bbe,1cf7ccf64a5bf24e,8e9eb3fc86db0f7d,2020-06-20,0,0,0,590,1,0,84,27,84,0,0,0,0,0,12,10,72,27,0.0,542.8
2849,f044802db5688bbe,8e9eb3fc86db0f7d,1cf7ccf64a5bf24e,2020-06-20,1,0,0,590,1,1,137,61,119,18,0,0,18,14,16,13,103,47,40.2,485.0
2850,f00921c62315be96,4e0692ad070976e4,b1b0729d27936f2f,2020-06-20,0,0,0,900,0,0,172,54,172,0,0,0,0,0,31,27,141,54,0.0,893.0
2851,f00921c62315be96,b1b0729d27936f2f,4e0692ad070976e4,2020-06-20,0,0,0,900,8,2,172,58,172,0,0,0,0,0,27,24,145,58,0.0,796.0
2852,d851cbbbdfd05a49,887961364be5ceb3,c47df9303d318c67,2020-06-20,0,2,0,900,3,2,150,38,136,14,9,9,5,5,46,38,90,33,32.1,829.0
2853,d851cbbbdfd05a49,c47df9303d318c67,887961364be5ceb3,2020-06-20,0,0,0,900,12,3,65,10,65,0,0,0,0,0,19,13,46,10,0.0,595.9
2854,d333a6c34ff16397,59a27d2e6d0802ac,d2cd7a69cc55e7ed,2020-06-20,0,1,0,600,6,2,54,9,54,0,0,0,0,0,10,8,44,9,0.0,533.0
2855,d333a6c34ff16397,d2cd7a69cc55e7ed,59a27d2e6d0802ac,2020-06-20,1,0,0,600,0,0,101,28,101,0,0,0,0,0,47,30,54,28,0.0,600.0
2856,90715135a543b6e3,38c7f72747f4f712,5f179af5fffeb9f6,2020-06-20,0,1,1,876,4,3,50,15,34,16,1,1,15,11,8,5,26,4,625.9,211.0
2857,90715135a543b6e3,5f179af5fffeb9f6,38c7f72747f4f712,2020-06-20,0,0,0,876,0,0,55,16,55,0,0,0,0,0,8,6,47,16,0.0,250.10000000000002
2858,8b9e9f283e76b429,c7d297714d9ab1a4,fc169c387b4b465d,2020-06-20,0,0,0,900,4,2,117,20,117,0,0,0,0,0,32,26,85,20,0.0,645.0
2859,8b9e9f283e76b429,fc169c387b4b465d,c7d297714d9ab1a4,2020-06-20,0,0,0,900,2,1,154,54,149,5,1,1,4,3,56,52,93,51,27.0,571.0
2860,7f0175f71481b63d,304a21d0595e1a08,764342d39cdaa54a,2020-06-20,1,0,0,41,0,0,30,14,27,3,0,0,3,2,2,2,25,12,1.1,38.0
2861,7f0175f71481b63d,764342d39cdaa54a,304a21d0595e1a08,2020-06-20,0,0,0,41,0,0,15,4,15,0,0,0,0,0,1,0,14,4,0.0,39.9
2862,4f99b4a39925cb47,98d961097baaf308,fba03cd6cc28dc41,2020-06-20,0,0,0,900,0,0,250,68,250,0,0,0,0,0,76,60,174,68,0.0,816.0
2863,4f99b4a39925cb47,fba03cd6cc28dc41,98d961097baaf308,2020-06-20,2,0,0,900,1,1,266,98,243,23,2,2,21,14,32,27,211,84,84.0,816.0
2864,1adee75d6c671cc8,31ef8b67e13495b3,b53c46f613f6f248,2020-06-20,0,0,0,900,3,0,160,42,157,3,0,0,3,2,33,32,124,40,16.1,771.0
2865,1adee75d6c671cc8,b53c46f613f6f248,31ef8b67e13495b3,2020-06-20,0,0,0,900,7,2,68,9,68,0,0,0,0,0,28,25,40,9,0.0,609.9
2866,0c3622569cd8062a,279566840aa55bf2,fa6796c55d6c5440,2020-06-20,0,0,0,1500,2,1,77,22,77,0,0,0,0,0,15,9,62,22,0.0,414.20000000000005
2867,0c3622569cd8062a,fa6796c55d6c5440,279566840aa55bf2,2020-06-20,0,0,0,1500,25,14,99,34,58,41,28,25,13,8,11,10,47,26,1039.8,308.0
2868,088b47d890b389e9,4498b382c65a7faa,729d4bd5a6cd0a97,2020-06-20,0,0,0,900,1,0,174,34,174,0,0,0,0,0,22,10,152,34,0.0,618.9
2869,088b47d890b389e9,729d4bd5a6cd0a97,4498b382c65a7faa,2020-06-20,0,0,0,900,3,2,158,46,153,5,0,0,5,4,31,26,122,42,33.1,847.0
2870,e857ca0bc3b9fdcd,37d5b176d438d2a5,7acbb0972e75281a,2020-06-13,0,0,0,257,0,0,16,4,16,0,0,0,0,0,0,0,16,4,0.0,113.0
2871,e857ca0bc3b9fdcd,7acbb0972e75281a,37d5b176d438d2a5,2020-06-13,0,2,1,257,3,2,64,45,12,52,0,0,52,43,0,0,12,2,125.0,132.0
2872,e36b8b88646f72f8,215a70f073a7b726,f57dd0bfa8c17813,2020-06-13,0,0,0,900,3,2,185,93,163,22,3,2,19,16,33,31,130,77,45.9,758.0
2873,e36b8b88646f72f8,f57dd0bfa8c17813,215a70f073a7b726,2020-06-13,0,0,0,900,3,0,118,14,118,0,0,0,0,0,38,23,80,14,0.0,625.1
2874,dfbb110855354039,6e00cfffd54653c4,79cb2a690b9ba5e8,2020-06-13,1,0,0,32,0,0,3,2,2,1,0,0,1,1,0,0,2,1,2.0,30.0
2875,dfbb110855354039,79cb2a690b9ba5e8,6e00cfffd54653c4,2020-06-13,0,0,0,32,0,0,6,1,6,0,0,0,0,0,1,1,5,1,0.0,30.0
2876,cab532b4544580bd,8fd808923cffff82,f1d64ae34e088832,2020-06-13,0,0,0,900,6,5,171,36,166,5,0,0,5,2,14,8,152,34,88.3,785.6
2877,cab532b4544580bd,f1d64ae34e088832,8fd808923cffff82,2020-06-13,1,0,0,900,0,0,138,26,135,3,0,0,3,1,53,36,82,25,8.4,797.7
2878,b8b692aa2aae3310,98215d037be5bcb7,f72465a784c1b084,2020-06-13,0,0,0,1500,7,4,237,77,226,11,0,0,11,7,52,36,174,70,427.2,1034.0
2879,b8b692aa2aae3310,f72465a784c1b084,98215d037be5bcb7,2020-06-13,0,0,0,1500,0,0,280,59,280,0,0,0,0,0,19,11,261,59,0.0,1072.8
2880,97125cd6a94b6394,016a8d958883167c,86d9dbe1bfcbade7,2020-06-13,0,0,0,22,1,0,4,2,4,0,0,0,0,0,0,0,4,2,0.0,22.0
2881,97125cd6a94b6394,86d9dbe1bfcbade7,016a8d958883167c,2020-06-13,1,0,0,22,0,0,20,10,20,0,0,0,0,0,1,1,19,10,0.0,17.0
2882,7606d2f8d8b0e889,2244d9a2b64b8c3b,a08ddd04eaffd81d,2020-06-13,0,0,0,162,0,0,32,4,32,0,0,0,0,0,11,7,21,4,0.0,132.0
2883,7606d2f8d8b0e889,a08ddd04eaffd81d,2244d9a2b64b8c3b,2020-06-13,1,1,1,162,0,0,52,20,52,0,0,0,0,0,11,9,41,20,0.0,138.0
2884,58e72b1a38880ba9,3c5005b66696d790,ae071698e1a3ccd4,2020-06-13,0,0,0,59,0,0,11,0,11,0,0,0,0,0,4,4,7,0,0.0,59.0
2885,58e72b1a38880ba9,ae071698e1a3ccd4,3c5005b66696d790,2020-06-13,1,0,0,59,0,0,23,9,23,0,0,0,0,0,1,1,22,9,0.0,59.0
2886,1109a8f2adc81ce0,40093d1d2d78394e,cf946e03ba2e7666,2020-06-13,0,0,0,900,1,0,173,33,173,0,0,0,0,0,54,36,119,33,0.0,900.0
2887,1109a8f2adc81ce0,cf946e03ba2e7666,40093d1d2d78394e,2020-06-13,0,0,0,900,2,0,135,34,135,0,0,0,0,0,26,19,109,34,0.0,896.0
2888,f2cd665eab69876a,7aa3d6964eff4877,971246648e162f0d,2020-06-06,1,0,0,900,1,1,164,79,146,18,5,4,13,10,23,20,123,69,113.2,661.0
2889,f2cd665eab69876a,971246648e162f0d,7aa3d6964eff4877,2020-06-06,0,0,0,900,2,0,187,38,183,4,1,1,3,2,19,14,164,36,88.0,610.8
2890,de4c4997f1429dd1,ab2b4ff41d6ebe0f,b102c26727306ab6,2020-06-06,2,0,0,246,0,0,61,12,61,0,0,0,0,0,22,17,39,12,0.0,242.0
2891,de4c4997f1429dd1,b102c26727306ab6,ab2b4ff41d6ebe0f,2020-06-06,0,0,0,246,0,0,41,17,41,0,0,0,0,0,3,1,38,17,0.0,246.0
2892,dc38c78358e053c3,39d91e95949de3d9,80fa8218c99f9c58,2020-06-06,0,0,0,1500,7,0,130,24,127,3,1,1,2,1,23,17,104,23,2.2,1021.7
2893,dc38c78358e053c3,80fa8218c99f9c58,39d91e95949de3d9,2020-06-06,0,1,0,1500,7,6,214,90,174,40,4,4,36,28,40,30,134,62,469.3,1016.8
2894,c6ca435e24c5f4e4,7be14eaed4c74856,bf7ad5628363eec9,2020-06-06,0,0,0,900,3,1,177,26,176,1,0,0,1,1,49,31,127,25,6.3,815.5
2895,c6ca435e24c5f4e4,bf7ad5628363eec9,7be14eaed4c74856,2020-06-06,0,0,0,900,4,2,179,68,173,6,2,2,4,3,24,19,149,65,40.5,785.7
2896,c03b6b6ce5d03276,65f09bacd3957381,cb696ebfb6598724,2020-06-06,0,0,0,88,0,0,2,0,2,0,0,0,0,0,1,1,1,0,0.0,88.0
2897,c03b6b6ce5d03276,cb696ebfb6598724,65f09bacd3957381,2020-06-06,0,2,1,88,1,0,3,0,3,0,0,0,0,0,3,2,0,0,0.0,15.0
2898,8bede5047e97d602,5331b25a60417ffb,84b3e7d38f2d2ec5,2020-06-06,0,0,0,900,2,1,82,26,82,0,0,0,0,0,12,11,70,26,0.0,603.0
2899,8bede5047e97d602,84b3e7d38f2d2ec5,5331b25a60417ffb,2020-06-06,0,0,0,900,6,0,110,30,110,0,0,0,0,0,40,34,70,30,0.0,761.0
2900,6fe8bce03a46350b,2e585c701f72fe55,6ac9bc2953c47345,2020-06-06,1,0,0,74,0,0,25,17,5,20,0,0,20,15,3,3,2,2,13.0,61.0
2901,6fe8bce03a46350b,6ac9bc2953c47345,2e585c701f72fe55,2020-06-06,0,0,0,74,0,0,10,1,10,0,0,0,0,0,2,2,8,1,0.0,61.0
2902,5fdf6611815efdfb,a495f599e787614f,cc7040fe76f0ef91,2020-06-06,0,0,0,900,2,0,85,31,85,0,0,0,0,0,10,8,75,31,0.0,375.5
2903,5fdf6611815efdfb,cc7040fe76f0ef91,a495f599e787614f,2020-06-06,0,0,0,900,10,1,124,23,123,1,0,0,1,1,57,56,66,22,2.5,742.0
2904,58584ccd0f63e3f3,b50a426a33da0012,fc9a9559a05f2704,2020-06-06,1,0,0,114,0,0,20,5,20,0,0,0,0,0,10,8,10,5,0.0,114.0
2905,58584ccd0f63e3f3,fc9a9559a05f2704,b50a426a33da0012,2020-06-06,0,0,0,114,0,0,7,3,7,0,0,0,0,0,2,1,5,3,0.0,114.0
2906,1c7ea3928c7d0ad8,76ee3d666c648f6b,c549573c0df4d676,2020-06-06,0,0,0,370,2,1,25,10,17,8,0,0,8,4,1,1,16,6,174.0,112.0
2907,1c7ea3928c7d0ad8,c549573c0df4d676,76ee3d666c648f6b,2020-06-06,1,0,0,370,3,3,59,20,44,15,1,1,14,7,10,8,34,13,84.0,84.0
2908,0ddf834a47533d15,2f13e4020cea5b38,d8c7c61b176e3994,2020-06-06,0,0,0,599,0,0,52,4,52,0,0,0,0,0,27,13,25,4,0.0,599.0
2909,0ddf834a47533d15,d8c7c61b176e3994,2f13e4020cea5b38,2020-06-06,1,0,0,599,0,0,43,7,43,0,0,0,0,0,19,12,24,7,0.0,596.0
2910,e9eab0fa03eecd9b,23024fdfc966410a,effd9de9937996f8,2020-05-30,0,1,0,1500,8,2,138,41,118,20,1,1,19,18,55,41,63,23,265.6,1022.0
2911,e9eab0fa03eecd9b,effd9de9937996f8,23024fdfc966410a,2020-05-30,0,0,0,1500,2,0,64,14,64,0,0,0,0,0,20,14,44,14,0.0,1067.4
2912,a6743d41b0b95271,1788eee370f077b7,441eacbe20e0e80b,2020-05-30,0,0,0,900,3,1,125,47,122,3,0,0,3,2,20,19,102,45,11.3,819.5
2913,a6743d41b0b95271,441eacbe20e0e80b,1788eee370f077b7,2020-05-30,0,0,0,900,0,0,161,35,159,2,0,0,2,2,56,43,103,33,12.5,782.7
2914,a41384da70013373,d7338bcb141abd2c,e872e9a9a902c045,2020-05-30,0,0,0,900,0,0,64,14,64,0,0,0,0,0,14,11,50,14,0.0,307.1
2915,a41384da70013373,e872e9a9a902c045,d7338bcb141abd2c,2020-05-30,0,4,0,900,3,3,108,55,53,55,2,2,53,45,25,16,28,10,592.9,264.0
2916,767819f321431bed,5eb50529a8418b77,8a1f3b5c526cd6e6,2020-05-30,0,0,0,900,0,0,273,61,273,0,0,0,0,0,75,66,198,61,0.0,881.3
2917,767819f321431bed,8a1f3b5c526cd6e6,5eb50529a8418b77,2020-05-30,0,0,0,900,1,1,344,139,342,2,0,0,2,2,42,36,300,137,7.7,873.0
2918,57dec2b07b75dada,d2bc285ead803db0,e7bba7ce4d6c7b07,2020-05-30,0,0,0,183,1,0,43,4,43,0,0,0,0,0,27,14,16,4,0.0,183.0
2919,57dec2b07b75dada,e7bba7ce4d6c7b07,d2bc285ead803db0,2020-05-30,0,1,1,183,0,0,52,15,52,0,0,0,0,0,18,17,34,15,0.0,174.0
2920,3640defb8294bd37,2244d9a2b64b8c3b,7447e9f28508106a,2020-05-30,0,0,0,156,0,0,26,3,24,2,0,0,2,0,7,4,17,3,6.9,132.0
2921,3640defb8294bd37,7447e9f28508106a,2244d9a2b64b8c3b,2020-05-30,0,1,1,156,1,0,21,2,21,0,0,0,0,0,3,3,18,2,0.0,149.1
2922,2300ad7f87080ad7,37098a6e6c27fb66,45f0cc9d18f35137,2020-05-30,0,0,0,567,0,0,27,4,27,0,0,0,0,0,6,4,21,4,0.0,558.0
2923,2300ad7f87080ad7,45f0cc9d18f35137,37098a6e6c27fb66,2020-05-30,2,0,0,567,0,0,94,20,90,4,1,1,3,3,50,39,40,17,9.0,558.0
2924,0fcf42b68f2f0fa3,5444c5a201d3ee5a,7279654c7674cd24,2020-05-30,2,0,0,111,0,0,24,9,20,4,0,0,4,3,5,5,15,6,1.3,109.0
2925,0fcf42b68f2f0fa3,7279654c7674cd24,5444c5a201d3ee5a,2020-05-30,0,0,0,111,0,0,7,0,7,0,0,0,0,0,5,5,2,0,0.0,109.7
2926,03e5127d4832750c,37c5366d18ed6c05,7c9f96f9a6a5cd50,2020-05-30,0,3,1,506,3,1,61,27,48,13,1,1,12,12,15,12,33,15,159.5,322.0
2927,03e5127d4832750c,7c9f96f9a6a5cd50,37c5366d18ed6c05,2020-05-30,0,0,0,506,0,0,48,5,48,0,0,0,0,0,13,9,35,5,0.0,206.5
2928,0170db5fad04e4d0,6e15f63b6c2e2c15,c96d9178c9ed9e62,2020-05-30,0,2,1,498,1,1,33,9,30,3,1,1,2,2,6,6,24,7,93.0,283.6
2929,0170db5fad04e4d0,c96d9178c9ed9e62,6e15f63b6c2e2c15,2020-05-30,0,0,0,498,10,4,32,6,29,3,0,0,3,3,14,11,15,3,90.4,164.0
2930,f039c93516e48253,583ee11abddfc581,92a9aa9c93192871,2020-05-16,0,0,0,900,0,0,234,96,234,0,0,0,0,0,23,22,211,96,0.0,868.1
2931,f039c93516e48253,92a9aa9c93192871,583ee11abddfc581,2020-05-16,0,0,0,900,13,1,253,101,252,1,0,0,1,1,24,20,228,100,2.9,816.0
2932,ebe122e962d26fa4,1a9480fc288e55d7,d31a5546c0e9b213,2020-05-16,0,0,0,425,0,0,48,10,48,0,0,0,0,0,18,17,30,10,0.0,250.3
2933,ebe122e962d26fa4,d31a5546c0e9b213,1a9480fc288e55d7,2020-05-16,0,1,1,425,2,2,52,14,48,4,0,0,4,3,19,18,29,11,81.7,282.0
2934,ce0748519d5ea5c6,03f982ca3735070c,b4ad3a06ee4d660c,2020-05-16,1,0,0,480,0,0,48,19,22,26,4,4,22,14,3,2,19,5,42.1,174.5
2935,ce0748519d5ea5c6,b4ad3a06ee4d660c,03f982ca3735070c,2020-05-16,1,0,0,480,1,1,85,58,11,74,4,4,70,56,6,6,5,2,258.5,175.9
2936,b1e66cea3a4d4709,06a80a685ea98573,9560ff14eb3129f7,2020-05-16,0,0,0,900,4,0,94,20,94,0,0,0,0,0,23,14,71,20,0.0,892.8
2937,b1e66cea3a4d4709,9560ff14eb3129f7,06a80a685ea98573,2020-05-16,1,0,0,900,1,1,135,33,126,9,1,1,8,3,34,27,92,30,4.2,894.0
2938,adac148ee6fa3bf7,31123249b0bbf52e,82d4c957649faf9b,2020-05-16,0,0,0,318,0,0,61,25,61,0,0,0,0,0,10,8,51,25,0.0,261.4
2939,adac148ee6fa3bf7,82d4c957649faf9b,31123249b0bbf52e,2020-05-16,2,0,0,318,0,0,73,21,64,9,2,2,7,5,17,14,47,16,46.6,261.0
2940,906283a2adcbc3e0,5f179af5fffeb9f6,82cbb809d5ee565c,2020-05-16,0,2,1,216,0,0,12,4,9,3,0,0,3,3,4,2,5,1,0.0,157.7
2941,906283a2adcbc3e0,82cbb809d5ee565c,5f179af5fffeb9f6,2020-05-16,0,0,0,216,2,1,7,2,6,1,0,0,1,1,3,3,3,1,58.3,41.0
2942,821a1c6f5d7fab14,4e06913c91da5200,cad24459b28592ca,2020-05-16,0,0,0,900,5,0,116,47,116,0,0,0,0,0,24,19,92,47,0.0,854.0
2943,821a1c6f5d7fab14,cad24459b28592ca,4e06913c91da5200,2020-05-16,0,0,0,900,5,0,97,19,97,0,0,0,0,0,29,22,68,19,0.0,549.0
2944,81f2f2d4b0302590,7c7332319c14094c,efb96bf3e9ada36f,2020-05-16,0,0,0,900,3,2,164,41,156,8,1,1,7,3,65,50,91,38,42.2,703.1
2945,81f2f2d4b0302590,efb96bf3e9ada36f,7c7332319c14094c,2020-05-16,0,0,0,900,1,0,201,79,200,1,0,0,1,1,28,22,172,78,1.9,797.8
2946,58540b24ed77d31b,64a50dad704d1d49,82a5152216251682,2020-05-16,1,0,0,900,0,0,144,40,116,28,3,2,25,16,55,38,61,24,87.0,726.2
2947,58540b24ed77d31b,82a5152216251682,64a50dad704d1d49,2020-05-16,0,0,0,900,4,1,164,54,157,7,0,0,7,7,32,25,125,47,58.8,687.0
2948,51461da4ba467901,093e1f5bb73850be,3a46b268013afede,2020-05-16,0,0,0,39,0,0,3,0,3,0,0,0,0,0,0,0,3,0,0.0,36.8
2949,51461da4ba467901,3a46b268013afede,093e1f5bb73850be,2020-05-16,1,0,0,39,0,0,18,9,12,6,0,0,6,5,5,5,7,4,2.2,35.0
2950,27bfb9205119f23b,ec34349e7dffcde7,f0feeb2192937424,2020-05-16,0,0,0,900,4,1,210,61,206,4,1,1,3,3,30,22,176,58,83.5,720.7
2951,27bfb9205119f23b,f0feeb2192937424,ec34349e7dffcde7,2020-05-16,1,0,0,900,0,0,176,60,174,2,0,0,2,0,40,30,134,60,12.3,779.5
2952,fbbba3da4438cb04,4234f0097c83fa62,539ed332b3078821,2020-05-13,0,0,0,900,2,2,171,69,143,28,0,0,28,18,21,16,122,51,203.2,646.0
2953,fbbba3da4438cb04,539ed332b3078821,4234f0097c83fa62,2020-05-13,0,0,0,900,1,0,138,22,138,0,0,0,0,0,34,22,104,22,0.0,696.8
2954,b2ca310c9d0037d3,01b352b6a9074d5c,f9d0cae37dabfafc,2020-05-13,1,0,0,349,0,0,87,27,86,1,0,0,1,1,30,24,56,26,0.0,349.0
2955,b2ca310c9d0037d3,f9d0cae37dabfafc,01b352b6a9074d5c,2020-05-13,0,0,0,349,0,0,54,13,54,0,0,0,0,0,4,3,50,13,0.0,349.0
2956,918103d82ecbed75,436f970c9ea9169c,a0e6753c42698f13,2020-05-13,0,0,0,900,1,0,179,17,179,0,0,0,0,0,46,33,133,17,0.0,900.0
2957,918103d82ecbed75,a0e6753c42698f13,436f970c9ea9169c,2020-05-13,0,0,0,900,0,0,215,36,215,0,0,0,0,0,37,27,178,36,0.0,900.0
2958,87f58feac6b50367,511e82663651438d,d945aae53e3e54e6,2020-05-13,0,0,0,325,0,0,60,8,59,1,0,0,1,1,36,19,23,7,21.0,304.0
2959,87f58feac6b50367,d945aae53e3e54e6,511e82663651438d,2020-05-13,0,1,1,325,3,0,16,0,16,0,0,0,0,0,3,1,13,0,0.0,304.0
2960,8539c4b795d33a92,7ff97850e8c32bda,d4c9dcd330403612,2020-05-13,1,0,0,1264,2,1,226,112,150,76,6,6,70,57,28,20,122,55,374.5,786.0
2961,8539c4b795d33a92,d4c9dcd330403612,7ff97850e8c32bda,2020-05-13,0,0,0,1264,3,1,210,63,210,0,0,0,0,0,39,23,171,63,0.0,882.5
2962,46c050a827ee83d6,262a7d06203657e6,519e4fe37ce9ff75,2020-05-13,0,0,0,565,5,3,108,22,107,1,0,0,1,1,20,12,87,21,8.4,498.0
2963,46c050a827ee83d6,519e4fe37ce9ff75,262a7d06203657e6,2020-05-13,1,0,0,565,0,0,145,48,145,0,0,0,0,0,19,13,126,48,0.0,545.6
2964,3ce634d03af7e14c,2af2f2e26c4c0402,7be14eaed4c74856,2020-05-13,0,0,0,520,0,0,132,37,132,0,0,0,0,0,34,25,98,37,0.0,470.0
2965,3ce634d03af7e14c,7be14eaed4c74856,2af2f2e26c4c0402,2020-05-13,1,0,0,520,4,0,99,18,97,2,0,0,2,2,31,11,66,16,29.0,491.0
2966,394ae51820bedd4c,50db8711c70196cd,bd58d34e39b7b12a,2020-05-13,1,0,0,900,0,0,82,27,82,0,0,0,0,0,20,15,62,27,0.0,855.5
2967,394ae51820bedd4c,bd58d34e39b7b12a,50db8711c70196cd,2020-05-13,0,0,0,900,3,1,110,37,108,2,2,2,0,0,19,17,89,37,22.5,551.0
2968,312946f6b72ebd51,3738e68d2261e60f,53c943c873cffe90,2020-05-13,0,0,0,900,0,0,107,22,107,0,0,0,0,0,38,28,69,22,0.0,900.0
2969,312946f6b72ebd51,53c943c873cffe90,3738e68d2261e60f,2020-05-13,0,0,0,900,0,0,99,26,99,0,0,0,0,0,28,15,71,26,0.0,893.0
2970,3094e82731ec55e7,5987b2458f4b5290,a4de54ea806fb525,2020-05-13,0,0,0,900,11,7,144,44,136,8,4,4,4,4,25,19,111,40,172.3,577.0
2971,3094e82731ec55e7,a4de54ea806fb525,5987b2458f4b5290,2020-05-13,0,0,0,900,2,0,91,33,91,0,0,0,0,0,20,14,71,33,0.0,697.7
2972,fcfaa28ed6888088,2cd428e9606856fd,8d03ce87ca14e778,2020-05-09,0,0,0,20,0,0,5,3,5,0,0,0,0,0,2,2,3,3,0.0,18.0
2973,fcfaa28ed6888088,8d03ce87ca14e778,2cd428e9606856fd,2020-05-09,1,0,0,20,0,0,13,5,9,4,0,0,4,3,2,1,7,2,2.0,18.0
2974,f2520dd5457ab293,d910665038efc639,eb04b9d31e938edb,2020-05-09,0,0,0,900,10,1,103,34,102,1,0,0,1,1,15,11,87,33,5.1,854.0
2975,f2520dd5457ab293,eb04b9d31e938edb,d910665038efc639,2020-05-09,0,0,0,900,0,0,98,15,98,0,0,0,0,0,38,29,60,15,0.0,894.9
2976,f0d4652f8edfbe6d,1eff7bc0f815b270,85073dbd1be65ed9,2020-05-09,0,0,0,900,0,0,69,6,69,0,0,0,0,0,25,18,44,6,0.0,900.0
2977,f0d4652f8edfbe6d,85073dbd1be65ed9,1eff7bc0f815b270,2020-05-09,0,0,0,900,0,0,124,21,124,0,0,0,0,0,44,34,80,21,0.0,847.0
2978,d395828f5cb045a5,22a92d7f62195791,9e8f6c728eb01124,2020-05-09,0,0,0,1419,0,0,296,64,296,0,0,0,0,0,84,72,212,64,0.0,1419.0
2979,d395828f5cb045a5,9e8f6c728eb01124,22a92d7f62195791,2020-05-09,1,0,0,1419,0,0,197,100,197,0,0,0,0,0,44,43,153,100,0.0,1419.0
2980,b9abcce29378e5cc,1d00756835ca67c9,cbb682f5fcc44bfc,2020-05-09,0,0,0,900,8,2,148,31,148,0,0,0,0,0,36,31,112,31,0.0,794.0
2981,b9abcce29378e5cc,cbb682f5fcc44bfc,1d00756835ca67c9,2020-05-09,0,0,0,900,1,0,113,44,111,2,0,0,2,2,29,19,82,42,0.0,900.0
2982,b70dfff154b135bf,a67f5afa8d6a1b80,d156513a19acf856,2020-05-09,0,1,0,900,7,2,115,41,115,0,0,0,0,0,13,10,102,41,0.0,719.0
2983,b70dfff154b135bf,d156513a19acf856,a67f5afa8d6a1b80,2020-05-09,0,0,0,900,0,0,108,40,108,0,0,0,0,0,18,17,90,40,0.0,871.0
2984,593f3b051aa82b0f,492b202d2064e7a9,98c23cb6da5b3352,2020-05-09,0,1,0,900,7,3,83,27,80,3,1,1,2,2,30,25,50,25,30.7,658.1
2985,593f3b051aa82b0f,98c23cb6da5b3352,492b202d2064e7a9,2020-05-09,0,0,0,900,0,0,183,79,182,1,0,0,1,0,16,15,166,79,6.9,636.3
2986,4e77cc2c8d604241,056c493bbd76a918,10f3ba6cd2f44a97,2020-05-09,1,0,0,598,5,1,83,24,72,11,0,0,11,9,33,29,39,15,11.8,584.0
2987,4e77cc2c8d604241,10f3ba6cd2f44a97,056c493bbd76a918,2020-05-09,0,0,0,598,4,0,81,15,81,0,0,0,0,0,23,18,58,15,0.0,586.2
2988,3f810c3433dddb80,6d4b63c767106d3a,d8da10db80131bec,2020-05-09,1,0,0,817,0,0,237,85,233,4,1,1,3,2,50,44,183,83,12.5,773.0
2989,3f810c3433dddb80,d8da10db80131bec,6d4b63c767106d3a,2020-05-09,0,0,0,817,4,1,291,81,287,4,1,1,3,3,60,47,227,78,19.0,695.5
2990,08244974cf39ae38,40093d1d2d78394e,d9c6f19f958643e9,2020-05-09,0,0,0,900,0,0,10,2,8,2,0,0,2,1,3,3,5,1,0.0,129.0
2991,08244974cf39ae38,d9c6f19f958643e9,40093d1d2d78394e,2020-05-09,0,5,0,900,3,3,49,27,3,46,13,13,33,27,0,0,3,0,771.0,129.0
2992,02f5621f480ad1d4,18968f97ad34f15c,751de04455cfaac0,2020-05-09,0,0,0,469,0,0,104,24,104,0,0,0,0,0,38,33,66,24,0.0,459.4
2993,02f5621f480ad1d4,751de04455cfaac0,18968f97ad34f15c,2020-05-09,1,0,0,469,1,0,113,32,107,6,0,0,6,4,21,20,86,28,3.6,463.0
2994,ef526567c4dcf371,4798e823ada58fe9,b60c980f79b87ce8,2020-03-14,0,0,0,900,9,0,258,67,258,0,0,0,0,0,45,26,213,67,0.0,764.4
2995,ef526567c4dcf371,b60c980f79b87ce8,4798e823ada58fe9,2020-03-14,0,0,0,900,0,0,247,92,227,20,0,0,20,12,56,38,171,80,123.6,696.0
2996,ea303a8e6e31f264,4a57ebb14315b251,beecb672a279223e,2020-03-14,0,0,0,900,1,1,77,22,77,0,0,0,0,0,19,14,58,22,0.0,478.4
2997,ea303a8e6e31f264,beecb672a279223e,4a57ebb14315b251,2020-03-14,0,2,0,900,3,1,159,57,120,39,3,3,36,29,31,25,89,28,361.6,455.0
2998,e2503ed6a1f9257d,94527830000ab715,be0b310a12eb80b4,2020-03-14,0,0,0,900,5,2,45,12,40,5,2,2,3,2,13,10,27,10,205.7,211.2
2999,e2503ed6a1f9257d,be0b310a12eb80b4,94527830000ab715,2020-03-14,0,1,0,900,2,1,86,39,37,49,12,11,37,35,9,7,28,4,400.8,285.3
3000,e0b323dae5bf4c90,07225ba28ae309b6,ee9ebceabfd16fa7,2020-03-14,0,2,1,628,1,0,65,28,58,7,2,2,5,4,14,13,44,24,8.6,227.0
3001,e0b323dae5bf4c90,ee9ebceabfd16fa7,07225ba28ae309b6,2020-03-14,0,0,0,628,3,2,80,35,65,15,1,1,14,9,5,5,60,26,390.0,229.4
3002,dc45c8d70e256749,a8283a4f415e1eb9,c21a036b4e012f1c,2020-03-14,0,0,0,900,1,0,126,34,126,0,0,0,0,0,26,21,100,34,0.0,900.0
3003,dc45c8d70e256749,c21a036b4e012f1c,a8283a4f415e1eb9,2020-03-14,0,0,0,900,0,0,123,15,123,0,0,0,0,0,69,52,54,15,0.0,900.0
3004,c26a3f4c08333886,38c626ca912c7bac,b6452706b373eea1,2020-03-14,0,0,0,44,0,0,5,0,5,0,0,0,0,0,1,1,4,0,0.0,44.0
3005,c26a3f4c08333886,b6452706b373eea1,38c626ca912c7bac,2020-03-14,0,1,1,44,1,1,2,1,2,0,0,0,0,0,0,0,2,1,0.0,19.0
3006,b3c74554c871fbf8,792be9a24df82ed6,b102c26727306ab6,2020-03-14,0,0,0,900,2,0,82,29,70,12,0,0,12,9,6,4,64,20,128.6,485.2
3007,b3c74554c871fbf8,b102c26727306ab6,792be9a24df82ed6,2020-03-14,0,1,0,900,9,1,32,9,29,3,0,0,3,3,8,6,21,6,189.8,518.4
3008,9fc6aba53508dc48,8adcbd525fab8d9b,e2ccd9a9ace60de7,2020-03-14,0,0,0,900,4,2,156,25,154,2,2,2,0,0,59,35,95,25,42.9,747.8
3009,9fc6aba53508dc48,e2ccd9a9ace60de7,8adcbd525fab8d9b,2020-03-14,0,0,0,900,0,0,112,29,111,1,0,0,1,1,40,28,71,28,2.2,833.1
3010,5cee1d8f1e43d6f5,23024fdfc966410a,427b5953ac8e3a27,2020-03-14,1,0,0,154,0,0,16,10,7,9,0,0,9,8,3,3,4,2,4.0,150.0
3011,5cee1d8f1e43d6f5,427b5953ac8e3a27,23024fdfc966410a,2020-03-14,0,0,0,154,2,2,7,4,7,0,0,0,0,0,0,0,7,4,0.0,67.0
3012,5bba49d88db7430f,1091d4d957141094,c21f26bbde777573,2020-03-14,0,0,0,900,8,3,58,38,21,37,3,3,34,30,6,4,15,8,629.0,111.2
3013,5bba49d88db7430f,c21f26bbde777573,1091d4d957141094,2020-03-14,0,0,0,900,0,0,50,33,23,27,2,1,25,18,3,3,20,15,108.8,126.0
3014,2a1826612a7d739c,b4192a975027aab6,cc8c623cca88f54f,2020-03-14,0,0,0,900,8,2,247,75,221,26,2,2,24,16,85,62,136,59,159.0,631.0
3015,2a1826612a7d739c,cc8c623cca88f54f,b4192a975027aab6,2020-03-14,0,0,0,900,0,0,146,45,146,0,0,0,0,0,54,43,92,45,0.0,696.0
3016,1a2d13834696c4ab,294aa73dbf37d281,9ada30894bf04e19,2020-03-14,0,0,0,900,11,3,97,25,92,5,0,0,5,2,28,20,64,23,30.3,803.4
3017,1a2d13834696c4ab,9ada30894bf04e19,294aa73dbf37d281,2020-03-14,0,0,0,900,1,0,133,35,131,2,0,0,2,2,47,32,84,33,5.6,796.7
3018,daa38964824f1b9f,9560ff14eb3129f7,e00a3dee329a51f7,2020-03-07,0,0,0,900,0,0,122,19,121,1,0,0,1,1,34,19,87,18,10.0,825.3
3019,daa38964824f1b9f,e00a3dee329a51f7,9560ff14eb3129f7,2020-03-07,0,0,0,900,6,2,127,32,123,4,0,0,4,3,33,22,90,29,54.7,767.0
3020,d671f436fab2a252,483a953b18d73bb3,6ac9bc2953c47345,2020-03-07,0,0,0,733,2,1,111,37,111,0,0,0,0,0,18,16,93,37,0.0,722.0
3021,d671f436fab2a252,6ac9bc2953c47345,483a953b18d73bb3,2020-03-07,1,1,1,733,1,1,187,66,187,0,0,0,0,0,21,20,166,66,0.0,712.0
3022,d66a8591af39ca7b,84b3e7d38f2d2ec5,e64b96c07d7ce999,2020-03-07,0,0,0,900,7,4,139,56,116,23,8,8,15,14,13,10,103,42,163.7,594.0
3023,d66a8591af39ca7b,e64b96c07d7ce999,84b3e7d38f2d2ec5,2020-03-07,0,0,0,900,3,2,62,11,62,0,0,0,0,0,12,5,50,11,0.0,517.3
3024,cf0a6466b762c668,1ebe20ebbfa15e29,3d6749c4267da18f,2020-03-07,0,0,0,1500,8,1,408,96,408,0,0,0,0,0,103,69,305,96,0.0,1426.0
3025,cf0a6466b762c668,3d6749c4267da18f,1ebe20ebbfa15e29,2020-03-07,0,0,0,1500,0,0,360,96,360,0,0,0,0,0,130,90,230,96,0.0,1440.0
3026,cd258394e8d58d04,36549928f90f1d36,b50a426a33da0012,2020-03-07,0,0,0,122,0,0,11,0,11,0,0,0,0,0,4,0,7,0,0.0,120.0
3027,cd258394e8d58d04,b50a426a33da0012,36549928f90f1d36,2020-03-07,1,0,0,122,0,0,22,9,17,5,0,0,5,5,11,9,6,4,2.0,120.0
3028,b46f2f007b622bce,1338e2c7480bdf9e,f77c68bb4be8516d,2020-03-07,0,0,0,1500,0,0,132,14,132,0,0,0,0,0,51,34,81,14,0.0,1500.0
3029,b46f2f007b622bce,f77c68bb4be8516d,1338e2c7480bdf9e,2020-03-07,0,0,0,1500,3,0,89,20,89,0,0,0,0,0,31,20,58,20,0.0,1500.0
3030,a70c43cafabc73c3,260e9e0d4954aea6,88d7b6d8230e1f3f,2020-03-07,0,1,1,178,2,2,10,5,3,7,0,0,7,5,0,0,3,0,114.0,64.0
3031,a70c43cafabc73c3,88d7b6d8230e1f3f,260e9e0d4954aea6,2020-03-07,0,0,0,178,0,0,10,2,10,0,0,0,0,0,3,3,7,2,0.0,64.0
3032,891470d896b1de5a,08af939f41b5a57b,7cbf7c78d3b34218,2020-03-07,1,2,0,360,3,1,20,8,20,0,0,0,0,0,4,4,16,8,0.0,99.0
3033,891470d896b1de5a,7cbf7c78d3b34218,08af939f41b5a57b,2020-03-07,0,0,0,360,0,0,25,12,25,0,0,0,0,0,3,3,22,12,0.0,360.0
3034,60c441c5838dfac2,d2cd7a69cc55e7ed,da0995f19b749cfa,2020-03-07,0,0,0,900,0,0,75,25,75,0,0,0,0,0,27,16,48,25,0.0,569.3
3035,60c441c5838dfac2,da0995f19b749cfa,d2cd7a69cc55e7ed,2020-03-07,0,0,0,900,12,8,58,14,47,11,1,1,10,6,0,0,47,8,330.7,419.0
3036,4d607b6ddc77a34c,57b10fca4f9c9a7a,b0d6a1d8ac3d563d,2020-03-07,0,0,0,900,5,1,77,21,75,2,0,0,2,2,21,19,54,19,42.0,690.0
3037,4d607b6ddc77a34c,b0d6a1d8ac3d563d,57b10fca4f9c9a7a,2020-03-07,0,0,0,900,3,2,50,17,50,0,0,0,0,0,10,6,40,17,0.0,525.0
3038,467e08195b29e857,3b0a516d2921e0d6,d05412b513b19621,2020-03-07,1,0,0,181,0,0,33,16,28,5,0,0,5,5,4,1,24,11,2.5,178.0
3039,467e08195b29e857,d05412b513b19621,3b0a516d2921e0d6,2020-03-07,0,0,0,181,0,0,23,0,23,0,0,0,0,0,16,11,7,0,0.0,178.5
3040,f5b49f4c5a27e53b,cd13728ae1151f46,d802174b0c0c1f4e,2020-02-29,0,0,0,38,0,0,11,3,11,0,0,0,0,0,3,2,8,3,0.0,38.0
3041,f5b49f4c5a27e53b,d802174b0c0c1f4e,cd13728ae1151f46,2020-02-29,1,0,0,38,0,0,12,6,12,0,0,0,0,0,2,2,10,6,0.0,38.0
3042,eba6055d217d5b99,34e516ab361afb1c,99bd51917728c25d,2020-02-29,0,2,0,398,1,1,7,1,6,1,0,0,1,1,4,3,2,0,13.0,57.0
3043,eba6055d217d5b99,99bd51917728c25d,34e516ab361afb1c,2020-02-29,0,2,1,398,3,2,22,14,2,20,0,0,20,14,1,1,1,0,315.0,70.0
3044,e8219ea7da46f67f,80eacd4da0617c57,aa72b0f831d0bfe5,2020-02-29,0,0,0,414,2,0,94,28,94,0,0,0,0,0,31,18,63,28,0.0,387.8
3045,e8219ea7da46f67f,aa72b0f831d0bfe5,80eacd4da0617c57,2020-02-29,1,1,0,414,1,1,49,18,46,3,0,0,3,3,10,7,36,15,16.2,387.0
3046,e30b9829e42aa4ca,c9cf753cfdf77fc2,e2f6b2769aaedd6c,2020-02-29,0,0,0,900,8,2,106,36,71,35,2,2,33,21,14,5,57,15,408.6,398.0
3047,e30b9829e42aa4ca,e2f6b2769aaedd6c,c9cf753cfdf77fc2,2020-02-29,0,0,0,900,1,0,83,23,83,0,0,0,0,0,3,3,80,23,0.0,491.4
3048,d9a218ac3e148541,1588b787bda7b540,2f181c0467965b98,2020-02-29,0,0,0,287,1,0,5,0,5,0,0,0,0,0,5,4,0,0,0.0,50.30000000000001
3049,d9a218ac3e148541,2f181c0467965b98,1588b787bda7b540,2020-02-29,1,0,0,287,1,0,29,17,6,23,1,1,22,15,2,2,4,2,224.7,33.0
3050,9d2f7d29bb9c9034,2844b047183a1adb,97cf1a2c7c5e7889,2020-02-29,0,1,0,900,1,0,42,24,18,24,1,1,23,18,3,2,15,6,748.4,45.2
3051,9d2f7d29bb9c9034,97cf1a2c7c5e7889,2844b047183a1adb,2020-02-29,0,1,0,900,1,1,39,15,28,11,0,0,11,6,7,6,21,9,12.8,137.60000000000002
3052,8a85dffa80e6c7bd,39d91e95949de3d9,862b0b3375aa4b6e,2020-02-29,1,0,0,217,2,1,64,38,25,39,0,0,39,30,3,2,22,8,137.5,76.0
3053,8a85dffa80e6c7bd,862b0b3375aa4b6e,39d91e95949de3d9,2020-02-29,0,0,0,217,0,0,28,12,28,0,0,0,0,0,1,1,27,12,0.0,79.5
3054,671f42536454e541,a0e75f4a13eb73f1,d3f5d33d61cd00c9,2020-02-29,1,0,0,211,1,0,14,6,13,1,0,0,1,0,2,1,11,6,4.7,197.0
3055,671f42536454e541,d3f5d33d61cd00c9,a0e75f4a13eb73f1,2020-02-29,0,0,0,211,3,1,16,1,16,0,0,0,0,0,7,4,9,1,0.0,67.3
3056,59861c3d19eb46ef,d31cbcdd7d69536d,ebef46976554f975,2020-02-29,0,0,0,518,7,7,47,26,32,15,2,2,13,11,6,4,26,15,271.2,63.5
3057,59861c3d19eb46ef,ebef46976554f975,d31cbcdd7d69536d,2020-02-29,0,3,1,518,1,0,23,13,20,3,0,0,3,3,2,2,18,10,2.5,241.8
3058,533d0b5c0adfa15f,45f7cb591c3ab00b,6a96ad1bc34fb113,2020-02-29,0,1,0,900,9,4,91,30,74,17,4,4,13,10,16,13,58,20,451.4,422.0
3059,533d0b5c0adfa15f,6a96ad1bc34fb113,45f7cb591c3ab00b,2020-02-29,0,0,0,900,1,0,87,16,87,0,0,0,0,0,23,21,64,16,0.0,430.6
3060,0e3af9b5e1b3ae80,002ca196477ce572,60425d07ef4b91a7,2020-02-29,0,1,0,900,6,2,97,22,92,5,0,0,5,3,12,9,80,19,93.1,519.0
3061,0e3af9b5e1b3ae80,60425d07ef4b91a7,002ca196477ce572,2020-02-29,0,1,0,900,4,2,168,66,139,29,5,5,24,15,24,18,115,51,232.0,454.9
3062,0bcb04163f8d8ead,003d82fa384ca1d0,be68b375707dcb85,2020-02-29,0,0,0,85,1,0,12,2,12,0,0,0,0,0,8,0,4,2,0.0,74.5
3063,0bcb04163f8d8ead,be68b375707dcb85,003d82fa384ca1d0,2020-02-29,1,0,0,85,0,0,29,19,11,18,0,0,18,14,2,1,9,5,5.5,78.0
3064,f882cf76a8bce308,aceffa19749c4dc0,cf946e03ba2e7666,2020-02-22,2,0,0,201,0,0,36,26,22,14,0,0,14,13,2,2,20,13,9.0,192.0
3065,f882cf76a8bce308,cf946e03ba2e7666,aceffa19749c4dc0,2020-02-22,0,0,0,201,0,0,28,4,28,0,0,0,0,0,6,5,22,4,0.0,192.0
3066,ecc23234e820458d,6e00cfffd54653c4,853eb0dd5c0e2149,2020-02-22,0,0,0,900,4,0,153,34,153,0,0,0,0,0,22,16,131,34,0.0,843.9
3067,ecc23234e820458d,853eb0dd5c0e2149,6e00cfffd54653c4,2020-02-22,0,0,0,900,4,0,257,51,255,2,0,0,2,1,39,27,216,50,3.1,883.0
3068,af5b940f2c686524,4e30e4250cb08b61,f0feeb2192937424,2020-02-22,0,0,0,900,1,1,130,24,129,1,0,0,1,0,47,29,82,24,6.3,778.3
3069,af5b940f2c686524,f0feeb2192937424,4e30e4250cb08b61,2020-02-22,0,1,0,900,4,1,126,38,121,5,0,0,5,3,25,10,96,35,26.7,701.7
3070,9bc18b63b07bb328,326f94d6cfb1bf25,ab943cd2c3c17825,2020-02-22,0,0,0,88,0,0,17,4,17,0,0,0,0,0,1,1,16,4,0.0,86.0
3071,9bc18b63b07bb328,ab943cd2c3c17825,326f94d6cfb1bf25,2020-02-22,1,0,0,88,0,0,34,15,33,1,0,0,1,1,4,4,29,14,2.0,86.0
3072,6d48f75153e4ad6b,31d7446b184e3305,37ed1ab2f8b819f4,2020-02-22,0,0,0,900,11,8,46,10,37,9,7,7,2,1,16,11,21,9,200.4,368.6
3073,6d48f75153e4ad6b,37ed1ab2f8b819f4,31d7446b184e3305,2020-02-22,1,0,0,900,1,1,72,21,48,24,7,6,17,9,16,11,32,12,108.4,577.6
3074,5fceb95c29d929bc,193b9d1858bc4df3,e5010b1b94ca5755,2020-02-22,0,0,0,1500,5,1,221,72,221,0,0,0,0,0,60,50,161,72,0.0,1195.0
3075,5fceb95c29d929bc,e5010b1b94ca5755,193b9d1858bc4df3,2020-02-22,0,0,0,1500,1,0,230,64,230,0,0,0,0,0,60,46,170,64,0.0,1497.0
3076,3bd20b66b585d621,103b06d8707895a9,a845f0735bc67405,2020-02-22,0,0,0,900,1,0,118,35,107,11,1,1,10,9,22,14,85,26,1.1,619.5
3077,3bd20b66b585d621,a845f0735bc67405,103b06d8707895a9,2020-02-22,1,0,0,900,7,4,73,32,67,6,0,0,6,3,3,1,64,29,276.5,391.9
3078,2b417eb1ffa56ac1,0d65c432720accb9,70e1f8a821b72c8b,2020-02-22,0,0,0,209,0,0,6,3,6,0,0,0,0,0,0,0,6,3,0.0,209.0
3079,2b417eb1ffa56ac1,70e1f8a821b72c8b,0d65c432720accb9,2020-02-22,0,1,1,209,10,8,8,2,8,0,0,0,0,0,1,0,7,2,0.0,26.0
3080,102fb91414fd24ab,122ac9b816d8b71c,b1e5bcaad32a3cac,2020-02-22,0,0,0,40,0,0,11,4,11,0,0,0,0,0,2,1,9,4,0.0,38.0
3081,102fb91414fd24ab,b1e5bcaad32a3cac,122ac9b816d8b71c,2020-02-22,1,0,0,40,0,0,18,8,17,1,0,0,1,0,0,0,17,8,2.0,38.0
3082,060987bb3025a0a8,c41d426cc7326d1b,d7c3816669784109,2020-02-22,0,0,0,900,6,5,178,59,161,17,1,1,16,12,39,33,122,47,193.3,593.0
3083,060987bb3025a0a8,d7c3816669784109,c41d426cc7326d1b,2020-02-22,0,1,0,900,1,0,85,19,85,0,0,0,0,0,30,19,55,19,0.0,602.7
3084,03c2707563915d7d,32490e80ddab1e5a,8fc9ae9c7527dfcb,2020-02-22,1,0,0,140,0,0,35,12,34,1,0,0,1,1,6,5,28,11,1.2,133.0
3085,03c2707563915d7d,8fc9ae9c7527dfcb,32490e80ddab1e5a,2020-02-22,0,0,0,140,1,1,15,6,15,0,0,0,0,0,1,1,14,6,0.0,135.8
3086,02bdb7a5b2986571,4d8fa64202cee4c1,6751eacd16bd59bc,2020-02-22,1,3,0,481,1,0,91,38,52,39,1,1,38,31,25,16,27,7,188.5,220.0
3087,02bdb7a5b2986571,6751eacd16bd59bc,4d8fa64202cee4c1,2020-02-22,0,0,0,481,3,0,28,7,28,0,0,0,0,0,7,5,21,7,0.0,282.5
3088,f3e2038bfb9b5d9d,d1941565abf50b16,df1eb4354d18a906,2020-02-15,0,0,0,900,2,0,121,33,118,3,0,0,3,3,28,25,90,30,4.8,745.7
3089,f3e2038bfb9b5d9d,df1eb4354d18a906,d1941565abf50b16,2020-02-15,0,0,0,900,1,1,197,77,185,12,0,0,12,8,17,11,168,69,127.3,598.2
3090,eab100e978c730c5,813550bc53b15fb0,f9b200db02b488d9,2020-02-15,0,0,0,900,1,0,193,42,193,0,0,0,0,0,30,26,163,42,0.0,900.0
3091,eab100e978c730c5,f9b200db02b488d9,813550bc53b15fb0,2020-02-15,0,0,0,900,3,0,188,36,188,0,0,0,0,0,81,63,107,36,0.0,896.0
3092,d629aa5eb31a1e38,568bbad0eaced57c,9cdd2da1a9104a0b,2020-02-15,0,0,0,900,1,0,71,32,71,0,0,0,0,0,14,8,57,32,0.0,632.5
3093,d629aa5eb31a1e38,9cdd2da1a9104a0b,568bbad0eaced57c,2020-02-15,0,0,0,900,8,3,166,48,110,56,1,1,55,24,45,37,65,24,245.5,387.0
3094,b41e3be867afd6fa,07a2bdaa0afdd831,a4de54ea806fb525,2020-02-15,0,0,0,900,2,0,20,3,19,1,0,0,1,1,6,6,13,2,14.7,401.6
3095,b41e3be867afd6fa,a4de54ea806fb525,07a2bdaa0afdd831,2020-02-15,0,0,0,900,19,10,45,35,23,22,0,0,22,21,1,0,22,14,395.4,202.3
3096,a02ffaf1fe462d28,595db60957de51d3,82e7929bf6c2b689,2020-02-15,1,0,0,789,2,2,91,20,86,5,0,0,5,4,39,33,47,16,15.3,736.7
3097,a02ffaf1fe462d28,82e7929bf6c2b689,595db60957de51d3,2020-02-15,0,0,0,789,6,0,64,6,63,1,0,0,1,1,30,19,33,5,3.3,763.7
3098,9d98e1c0d62213cf,7c9f96f9a6a5cd50,ec18eb918121787c,2020-02-15,0,1,0,242,0,0,9,3,8,1,0,0,1,1,3,2,5,2,0.0,171.5
3099,9d98e1c0d62213cf,ec18eb918121787c,7c9f96f9a6a5cd50,2020-02-15,0,0,0,242,2,1,29,6,26,3,0,0,3,3,15,9,11,3,70.5,54.0
3100,96919cf8d3e988ff,80d8aed0ca9b00f3,82cbb809d5ee565c,2020-02-15,1,1,0,900,3,1,67,15,57,10,2,2,8,7,14,10,43,8,318.8,354.0
3101,96919cf8d3e988ff,82cbb809d5ee565c,80d8aed0ca9b00f3,2020-02-15,0,0,0,900,2,1,53,15,50,3,2,2,1,1,7,6,43,14,36.0,473.2
3102,94c0819fde11364d,3f7dab21b6c971bc,cc7040fe76f0ef91,2020-02-15,0,0,0,900,0,0,36,4,36,0,0,0,0,0,3,2,33,4,0.0,365.29999999999995
3103,94c0819fde11364d,cc7040fe76f0ef91,3f7dab21b6c971bc,2020-02-15,0,0,0,900,4,3,54,19,24,30,12,12,18,15,10,8,14,4,534.7,294.0
3104,8725dc88f2e0a6f3,82b4e942781b1046,f57dd0bfa8c17813,2020-02-15,1,0,0,582,0,0,126,33,125,1,0,0,1,1,28,21,97,32,10.8,474.0
3105,8725dc88f2e0a6f3,f57dd0bfa8c17813,82b4e942781b1046,2020-02-15,0,0,0,582,2,0,124,21,124,0,0,0,0,0,33,24,91,21,0.0,571.2
3106,801b3f24c670f19a,5e4eec08896c9423,99df7d0a2a08a8a8,2020-02-15,0,0,0,188,0,0,27,4,27,0,0,0,0,0,8,7,19,4,0.0,184.0
3107,801b3f24c670f19a,99df7d0a2a08a8a8,5e4eec08896c9423,2020-02-15,1,0,0,188,0,0,31,11,30,1,0,0,1,1,4,2,26,10,1.0,186.0
3108,51218519be104794,c03520b5c88ed6b4,e7bba7ce4d6c7b07,2020-02-15,0,0,0,900,24,12,181,30,164,17,4,3,13,10,40,30,124,20,231.2,560.0
3109,51218519be104794,e7bba7ce4d6c7b07,c03520b5c88ed6b4,2020-02-15,0,0,0,900,0,0,118,22,118,0,0,0,0,0,31,23,87,22,0.0,663.8
3110,2dc48a745d6c662b,4b47e71384a9522f,8a1f3b5c526cd6e6,2020-02-15,0,0,0,517,3,1,95,19,95,0,0,0,0,0,34,22,61,19,0.0,506.0
3111,2dc48a745d6c662b,8a1f3b5c526cd6e6,4b47e71384a9522f,2020-02-15,1,1,1,517,0,0,121,37,121,0,0,0,0,0,14,12,107,37,0.0,513.0
3112,08426f06239d903c,329e403448756217,99506df1af6c8b3b,2020-02-15,0,0,0,616,1,1,99,24,98,1,0,0,1,1,36,22,62,23,6.9,508.5
3113,08426f06239d903c,99506df1af6c8b3b,329e403448756217,2020-02-15,1,0,0,616,0,0,72,31,67,5,0,0,5,4,8,8,59,27,59.5,490.1
3114,fae99a4089f8abb0,07f72a2a7591b409,2e19380f34871c6a,2020-02-08,0,0,0,1500,9,2,166,31,166,0,0,0,0,0,92,73,74,31,0.0,1399.0
3115,fae99a4089f8abb0,2e19380f34871c6a,07f72a2a7591b409,2020-02-08,0,0,0,1500,0,0,259,41,259,0,0,0,0,0,90,75,169,41,0.0,1500.0
3116,ed499508be1e5532,2558ae2e5671e318,cdb96af67d096b1e,2020-02-08,1,0,0,27,1,0,17,6,14,3,0,0,3,2,5,4,9,4,2.1,22.0
3117,ed499508be1e5532,cdb96af67d096b1e,2558ae2e5671e318,2020-02-08,0,0,0,27,0,0,4,1,4,0,0,0,0,0,1,0,3,1,0.0,24.9
3118,d3f44fedc561d2d5,46e0d677f91bacc0,bc711b6dd95c1af6,2020-02-08,0,0,0,401,0,0,44,11,44,0,0,0,0,0,2,2,42,11,0.0,397.0
3119,d3f44fedc561d2d5,bc711b6dd95c1af6,46e0d677f91bacc0,2020-02-08,1,0,0,401,0,0,67,18,57,10,0,0,10,9,3,0,54,9,4.0,397.0
3120,cefb47bcc04f540e,d3df1add9d9a7efb,e9a3aeb207578eea,2020-02-08,0,0,0,900,1,0,50,12,50,0,0,0,0,0,11,8,39,12,0.0,859.0
3121,cefb47bcc04f540e,e9a3aeb207578eea,d3df1add9d9a7efb,2020-02-08,0,0,0,900,7,3,12,2,12,0,0,0,0,0,4,3,8,2,0.0,372.0
3122,cb56e868deaddac4,05fa626cb33d15b8,729d4bd5a6cd0a97,2020-02-08,0,1,0,900,3,0,267,51,266,1,1,1,0,0,72,52,194,51,6.2,863.0
3123,cb56e868deaddac4,729d4bd5a6cd0a97,05fa626cb33d15b8,2020-02-08,0,0,0,900,4,2,197,70,197,0,0,0,0,0,16,10,181,70,0.0,742.8
3124,be822403f364fff3,82a5152216251682,cbd3e590a85b18c5,2020-02-08,0,0,0,900,2,1,88,27,84,4,0,0,4,3,18,16,66,24,10.8,846.0
3125,be822403f364fff3,cbd3e590a85b18c5,82a5152216251682,2020-02-08,0,1,0,900,10,3,60,14,60,0,0,0,0,0,4,3,56,14,0.0,496.2
3126,a6441acec6718f03,305d73ede05e31ad,52c2ae6d2f2d2613,2020-02-08,0,0,0,900,1,1,61,5,61,0,0,0,0,0,14,7,47,5,0.0,616.0
3127,a6441acec6718f03,52c2ae6d2f2d2613,305d73ede05e31ad,2020-02-08,0,2,0,900,12,6,55,16,53,2,0,0,2,1,18,15,35,15,199.0,502.0
3128,5ab2a4fec735e0b2,4bf6b225ff6099c4,78f485f851891d68,2020-02-08,0,0,0,38,0,0,4,0,4,0,0,0,0,0,1,1,3,0,0.0,33.0
3129,5ab2a4fec735e0b2,78f485f851891d68,4bf6b225ff6099c4,2020-02-08,1,0,0,38,0,0,10,6,5,5,0,0,5,5,0,0,5,1,5.0,33.0
3130,57961c6adebfb13d,83b00f7597e5ac83,e13abac8089a801a,2020-02-08,0,0,0,119,0,0,11,3,11,0,0,0,0,0,7,4,4,3,0.0,117.5
3131,57961c6adebfb13d,e13abac8089a801a,83b00f7597e5ac83,2020-02-08,1,0,0,119,0,0,15,5,12,3,0,0,3,1,6,5,6,4,1.5,117.0
3132,326b843cb2b7fd94,5f6f049d54728e88,f2477cf43c4975cc,2020-02-08,0,0,0,900,0,0,177,32,177,0,0,0,0,0,54,48,123,32,0.0,898.0
3133,326b843cb2b7fd94,f2477cf43c4975cc,5f6f049d54728e88,2020-02-08,0,0,0,900,3,0,142,30,142,0,0,0,0,0,54,36,88,30,0.0,810.0
3134,11f7bac5037a184c,8f6a18831a120817,b27a1fcb56a3035a,2020-02-08,0,4,0,900,4,1,80,18,80,0,0,0,0,0,31,26,49,18,0.0,511.6
3135,11f7bac5037a184c,b27a1fcb56a3035a,8f6a18831a120817,2020-02-08,0,1,0,900,0,0,148,63,108,40,2,2,38,26,7,6,101,37,156.4,681.0
3136,05cceae674c81b86,132deb59abae64b1,e872e9a9a902c045,2020-02-08,1,0,0,663,3,3,65,26,48,17,0,0,17,17,17,14,31,9,212.0,451.0
3137,05cceae674c81b86,e872e9a9a902c045,132deb59abae64b1,2020-02-08,0,0,0,663,0,0,56,0,56,0,0,0,0,0,28,17,28,0,0.0,451.0
3138,ed94cdc0f2b97e15,040a74bb0a465c54,6fb1ba67bef41b37,2020-01-25,0,0,0,900,1,0,131,58,131,0,0,0,0,0,7,5,124,58,0.0,819.0
3139,ed94cdc0f2b97e15,6fb1ba67bef41b37,040a74bb0a465c54,2020-01-25,0,0,0,900,9,0,172,25,172,0,0,0,0,0,32,24,140,25,0.0,823.0
3140,b88b170a7fe40544,2244d9a2b64b8c3b,f0feeb2192937424,2020-01-25,0,0,0,566,0,0,108,16,108,0,0,0,0,0,41,30,67,16,0.0,402.8
3141,b88b170a7fe40544,f0feeb2192937424,2244d9a2b64b8c3b,2020-01-25,1,0,0,566,1,1,155,57,112,43,0,0,43,29,19,13,93,28,163.2,380.0
3142,918c2efc59c1952e,601964f9654f911a,ec52462a1b41f714,2020-01-25,0,0,0,773,7,5,44,9,44,0,0,0,0,0,19,17,25,9,0.0,181.0
3143,918c2efc59c1952e,ec52462a1b41f714,601964f9654f911a,2020-01-25,0,3,1,773,9,6,47,33,19,28,1,1,27,24,3,2,16,9,343.0,332.0
3144,901dbd1e6463c4ba,4f140403000158b5,583ee11abddfc581,2020-01-25,1,1,0,163,1,1,17,2,15,2,0,0,2,0,7,5,8,2,38.0,68.0
3145,901dbd1e6463c4ba,583ee11abddfc581,4f140403000158b5,2020-01-25,0,0,0,163,0,0,9,3,9,0,0,0,0,0,1,1,8,3,0.0,92.0
3146,7dcd5d8a44a284e5,215a70f073a7b726,ab2b4ff41d6ebe0f,2020-01-25,0,0,0,153,0,0,13,1,13,0,0,0,0,0,4,1,9,1,0.0,153.0
3147,7dcd5d8a44a284e5,ab2b4ff41d6ebe0f,215a70f073a7b726,2020-01-25,0,1,1,153,1,1,9,0,9,0,0,0,0,0,3,2,6,0,0.0,60.0
3148,79161bde28636128,2eeaefbfc7f9fcff,7be74a12d7352df2,2020-01-25,0,0,0,900,0,0,5,0,5,0,0,0,0,0,1,1,4,0,0.0,115.10000000000002
3149,79161bde28636128,7be74a12d7352df2,2eeaefbfc7f9fcff,2020-01-25,0,1,0,900,5,3,50,22,9,41,16,15,25,21,2,1,7,1,784.9,96.0
3150,737e2781e4a7db5c,cc1a8b4b38b92c6d,dbac0a413af64bbe,2020-01-25,1,0,0,900,15,11,103,64,102,1,0,0,1,0,12,11,90,64,11.4,263.0
3151,737e2781e4a7db5c,dbac0a413af64bbe,cc1a8b4b38b92c6d,2020-01-25,0,3,0,900,8,1,28,2,28,0,0,0,0,0,11,5,17,2,0.0,806.6
3152,6195d3e7c412c8a2,025f0b1b58fbad01,5444c5a201d3ee5a,2020-01-25,0,0,0,900,9,6,72,20,60,12,2,1,10,5,14,10,46,15,128.3,761.0
3153,6195d3e7c412c8a2,5444c5a201d3ee5a,025f0b1b58fbad01,2020-01-25,0,0,0,900,0,0,233,49,233,0,0,0,0,0,66,52,167,49,0.0,769.7
3154,3fd3b871e83434c5,3f7dab21b6c971bc,899923ff6ab13917,2020-01-25,0,0,0,900,0,0,65,7,65,0,0,0,0,0,23,21,42,7,0.0,896.0
3155,3fd3b871e83434c5,899923ff6ab13917,3f7dab21b6c971bc,2020-01-25,0,0,0,900,3,0,82,16,82,0,0,0,0,0,26,20,56,16,0.0,398.0
3156,2ef54419defb2364,6a2f7c151031653d,c58f51dedb310998,2020-01-25,0,0,0,900,1,0,36,2,36,0,0,0,0,0,13,12,23,2,0.0,552.5
3157,2ef54419defb2364,c58f51dedb310998,6a2f7c151031653d,2020-01-25,0,0,0,900,8,6,51,6,50,1,0,0,1,0,6,3,44,6,306.5,287.0
3158,151c2bd6dfefb4b5,3cf66c62d9069f43,928ae2e5b5f7a9ec,2020-01-25,0,0,0,900,0,0,143,22,143,0,0,0,0,0,12,7,131,22,0.0,879.3
3159,151c2bd6dfefb4b5,928ae2e5b5f7a9ec,3cf66c62d9069f43,2020-01-25,0,0,0,900,1,1,129,17,122,7,3,1,4,1,56,44,66,16,11.7,865.0
3160,037d2f426c916ffc,63def5a5662a6917,fa6796c55d6c5440,2020-01-25,0,0,0,366,0,0,30,3,30,0,0,0,0,0,7,4,23,3,0.0,366.0
3161,037d2f426c916ffc,fa6796c55d6c5440,63def5a5662a6917,2020-01-25,1,0,0,366,6,0,60,20,60,0,0,0,0,0,9,8,51,20,0.0,347.0
3162,ff467a5f06a91a0f,b1d19449397541dc,c96d9178c9ed9e62,2020-01-18,0,0,0,900,7,0,150,57,136,14,0,0,14,8,19,16,117,49,149.1,655.0
3163,ff467a5f06a91a0f,c96d9178c9ed9e62,b1d19449397541dc,2020-01-18,0,0,0,900,11,3,111,15,111,0,0,0,0,0,44,32,67,15,0.0,628.9
3164,eed6c9aff2234b7a,1d00756835ca67c9,f4c49976c75c5ab2,2020-01-18,0,0,0,40,0,0,1,0,1,0,0,0,0,0,1,0,0,0,0.0,29.1
3165,eed6c9aff2234b7a,f4c49976c75c5ab2,1d00756835ca67c9,2020-01-18,1,0,0,40,0,0,26,19,10,16,0,0,16,13,1,0,9,6,10.9,27.0
3166,96fe84d051847591,6fd953151d981979,70d2329a92864fdb,2020-01-18,0,0,0,900,0,0,144,45,144,0,0,0,0,0,19,13,125,45,0.0,897.0
3167,96fe84d051847591,70d2329a92864fdb,6fd953151d981979,2020-01-18,0,0,0,900,0,0,323,66,323,0,0,0,0,0,65,52,258,66,0.0,779.0
3168,760b5b16b4931a77,4498b382c65a7faa,6a740daf1b279661,2020-01-18,1,0,0,900,1,1,43,17,32,11,2,2,9,5,0,0,32,12,577.5,134.0
3169,760b5b16b4931a77,6a740daf1b279661,4498b382c65a7faa,2020-01-18,0,1,0,900,0,0,31,15,19,12,2,1,10,6,0,0,19,9,136.0,186.5
3170,702759500d47a059,068f8a189a47fea6,98c23cb6da5b3352,2020-01-18,0,0,0,578,0,0,29,10,29,0,0,0,0,0,4,3,25,10,0.0,80.0
3171,702759500d47a059,98c23cb6da5b3352,068f8a189a47fea6,2020-01-18,0,3,1,578,3,3,22,4,16,6,0,0,6,3,3,3,13,1,444.0,134.0
3172,63dd38f0dcc2ee88,519e4fe37ce9ff75,b7b84ccd221be298,2020-01-18,1,0,0,70,0,0,26,12,15,11,1,1,10,10,1,0,14,2,6.0,64.0
3173,63dd38f0dcc2ee88,b7b84ccd221be298,519e4fe37ce9ff75,2020-01-18,0,0,0,70,0,0,11,3,11,0,0,0,0,0,4,4,7,3,0.0,64.0
3174,6087c50c5f95a677,ba1e6cb3d43f7430,c2a670b22d2e196f,2020-01-18,0,0,0,900,0,0,131,34,131,0,0,0,0,0,14,10,117,34,0.0,826.0
3175,6087c50c5f95a677,c2a670b22d2e196f,ba1e6cb3d43f7430,2020-01-18,0,0,0,900,2,1,165,40,164,1,0,0,1,1,61,40,103,39,0.0,900.0
3176,5868c154789648f0,8fd808923cffff82,94426bb170c88115,2020-01-18,0,0,0,900,7,3,145,36,144,1,0,0,1,0,16,13,128,36,24.6,558.4
3177,5868c154789648f0,94426bb170c88115,8fd808923cffff82,2020-01-18,0,1,0,900,0,0,155,54,125,30,5,5,25,15,19,14,106,39,218.6,620.4
3178,4eff0432bd364a23,6d68c1afe954f121,7be14eaed4c74856,2020-01-18,0,0,0,169,0,0,14,9,9,5,0,0,5,5,0,0,9,4,3.3,47.0
3179,4eff0432bd364a23,7be14eaed4c74856,6d68c1afe954f121,2020-01-18,0,1,1,169,2,1,12,5,5,7,0,0,7,4,3,2,2,1,118.0,47.7
3180,36032308b7e86fd0,634e2fb70bde3fd5,fc169c387b4b465d,2020-01-18,0,0,0,900,3,0,62,12,62,0,0,0,0,0,29,18,33,12,0.0,465.0
3181,36032308b7e86fd0,fc169c387b4b465d,634e2fb70bde3fd5,2020-01-18,0,0,0,900,2,1,78,9,78,0,0,0,0,0,35,29,43,9,0.0,839.0
3182,32a8f38bd1d46e3e,cbb682f5fcc44bfc,f53d4f21d1b5f2dc,2020-01-18,0,0,0,406,0,0,45,12,44,1,0,0,1,1,12,10,32,11,0.0,238.9
3183,32a8f38bd1d46e3e,f53d4f21d1b5f2dc,cbb682f5fcc44bfc,2020-01-18,0,1,1,406,7,3,53,18,43,10,1,1,9,5,9,6,34,13,167.1,172.0
3184,f93f794247af708a,31bbd39c0a075d4e,a7897d200692ab64,2019-12-21,0,0,0,900,0,0,53,16,33,20,2,2,18,15,9,7,24,1,17.0,140.0
3185,f93f794247af708a,a7897d200692ab64,31bbd39c0a075d4e,2019-12-21,0,0,0,900,7,3,40,17,26,14,0,0,14,12,3,3,23,5,743.0,140.0
3186,b3bd27affa038e9c,285ae0b4a68221f4,8e9eb3fc86db0f7d,2019-12-21,0,0,0,900,10,5,187,59,187,0,0,0,0,0,21,18,166,59,0.0,692.0
3187,b3bd27affa038e9c,8e9eb3fc86db0f7d,285ae0b4a68221f4,2019-12-21,0,0,0,900,2,0,160,22,160,0,0,0,0,0,41,29,119,22,0.0,893.0
3188,997ab1ea9fab5643,e93b04e308913c2e,f1d64ae34e088832,2019-12-21,1,0,0,572,0,0,94,30,88,6,0,0,6,3,14,12,74,27,29.1,489.0
3189,997ab1ea9fab5643,f1d64ae34e088832,e93b04e308913c2e,2019-12-21,2,0,0,572,0,0,129,38,119,10,0,0,10,8,45,26,74,30,15.0,521.9
3190,9140e6fdeaa7cd3f,98a6b2361045898f,a0e6753c42698f13,2019-12-21,0,0,0,900,0,0,56,6,56,0,0,0,0,0,13,9,43,6,0.0,535.0
3191,9140e6fdeaa7cd3f,a0e6753c42698f13,98a6b2361045898f,2019-12-21,1,0,0,900,1,1,89,22,69,20,3,3,17,9,8,7,61,13,365.0,535.0
3192,75523d31940c9344,0fd5f4b838e890cc,b9f28e7045fdfce7,2019-12-21,0,0,0,900,2,0,172,24,167,5,0,0,5,4,41,31,126,20,7.0,822.4
3193,75523d31940c9344,b9f28e7045fdfce7,0fd5f4b838e890cc,2019-12-21,0,0,0,900,5,2,100,16,94,6,1,1,5,4,38,25,56,12,63.6,734.0
3194,6ea23c2c30f85a89,192520689012c7e4,a68575214ecad140,2019-12-21,0,0,0,900,1,0,79,14,77,2,0,0,2,2,32,19,45,12,11.6,674.7
3195,6ea23c2c30f85a89,a68575214ecad140,192520689012c7e4,2019-12-21,1,0,0,900,0,0,187,66,151,36,1,1,35,21,35,28,116,45,196.3,479.4
3196,60e1b3ac3182f5b3,3df5493bb279226f,7559395ad833c074,2019-12-21,0,1,1,223,1,1,12,6,5,7,0,0,7,5,3,2,2,1,140.0,83.0
3197,60e1b3ac3182f5b3,7559395ad833c074,3df5493bb279226f,2019-12-21,0,0,0,223,0,0,8,1,8,0,0,0,0,0,5,3,3,1,0.0,77.0
3198,5a5a65d8df176506,67c1d46f4ed16f9e,a0f0004aadf10b71,2019-12-21,0,0,0,257,1,0,52,16,50,2,0,0,2,2,9,4,41,14,0.0,183.0
3199,5a5a65d8df176506,a0f0004aadf10b71,67c1d46f4ed16f9e,2019-12-21,1,0,0,257,1,1,62,32,54,8,0,0,8,7,2,2,52,25,74.0,183.0
3200,47e49e04e32be7e9,18b602842a24f7c5,74f9448b97bf8bec,2019-12-21,0,0,0,64,0,0,8,0,8,0,0,0,0,0,7,4,1,0,0.0,62.0
3201,47e49e04e32be7e9,74f9448b97bf8bec,18b602842a24f7c5,2019-12-21,1,0,0,64,0,0,10,5,6,4,0,0,4,4,0,0,6,1,2.0,62.0
3202,3637e661b6854b49,04c8b08b16a5b99e,787bb1f087ccff8a,2019-12-21,0,0,0,900,0,0,104,13,104,0,0,0,0,0,21,19,83,13,0.0,900.0
3203,3637e661b6854b49,787bb1f087ccff8a,04c8b08b16a5b99e,2019-12-21,0,0,0,900,1,0,160,36,160,0,0,0,0,0,35,29,125,36,0.0,900.0
3204,2b8cae68963a40a9,0845c81e37d3bcb3,333b9e5c723ac873,2019-12-21,0,0,0,900,0,0,144,28,144,0,0,0,0,0,39,35,105,28,0.0,868.0
3205,2b8cae68963a40a9,333b9e5c723ac873,0845c81e37d3bcb3,2019-12-21,0,1,0,900,9,1,147,49,147,0,0,0,0,0,31,26,116,49,0.0,742.0
3206,15aa55a91cf848cf,1897b7b913736a7c,20999e27ddd94bda,2019-12-21,0,0,0,900,13,4,131,27,131,0,0,0,0,0,23,20,108,27,0.0,700.0
3207,15aa55a91cf848cf,20999e27ddd94bda,1897b7b913736a7c,2019-12-21,0,0,0,900,1,0,128,45,128,0,0,0,0,0,27,23,101,45,0.0,900.0
3208,06f37329b223b451,c451d67c09c55418,f2688492b9a525a3,2019-12-21,1,0,0,198,0,0,60,46,18,42,0,0,42,38,0,0,18,8,0.0,198.0
3209,06f37329b223b451,f2688492b9a525a3,c451d67c09c55418,2019-12-21,0,0,0,198,2,0,14,6,14,0,0,0,0,0,3,3,11,6,0.0,66.0
3210,efc40ec41114d8fa,150ff4cc642270b9,e1248941344b3288,2019-12-14,0,0,0,1500,0,0,303,85,303,0,0,0,0,0,70,49,233,85,0.0,1498.0
3211,efc40ec41114d8fa,e1248941344b3288,150ff4cc642270b9,2019-12-14,0,0,0,1500,4,0,303,67,303,0,0,0,0,0,125,90,178,67,0.0,1455.0
3212,dd88960598219eba,16690d100f995f8f,2e585c701f72fe55,2019-12-14,0,0,0,900,4,2,166,41,166,0,0,0,0,0,27,14,139,41,0.0,757.0
3213,dd88960598219eba,2e585c701f72fe55,16690d100f995f8f,2019-12-14,0,0,0,900,10,3,103,26,100,3,0,0,3,3,41,27,59,23,50.0,750.0
3214,d42410f6f1039ab5,971246648e162f0d,fbf0537e420e698e,2019-12-14,1,2,0,274,3,1,36,17,5,31,0,0,31,16,4,3,1,1,187.9,40.0
3215,d42410f6f1039ab5,fbf0537e420e698e,971246648e162f0d,2019-12-14,0,1,0,274,0,0,6,2,4,2,0,0,2,0,0,0,4,2,40.0,46.099999999999994
3216,c4eaeec8ac778b27,578ef12674df1e6a,b9706f80d005036c,2019-12-14,1,0,0,291,0,0,71,13,69,2,0,0,2,2,19,13,50,11,2.0,289.0
3217,c4eaeec8ac778b27,b9706f80d005036c,578ef12674df1e6a,2019-12-14,0,0,0,291,0,0,76,19,76,0,0,0,0,0,1,1,75,19,0.0,289.0
3218,b5ec939fd1edf048,d0f3959b4a9747e6,fea79f9bc8c68769,2019-12-14,0,0,0,900,0,0,147,39,147,0,0,0,0,0,38,19,109,39,0.0,900.0
3219,b5ec939fd1edf048,fea79f9bc8c68769,d0f3959b4a9747e6,2019-12-14,0,0,0,900,2,1,137,48,137,0,0,0,0,0,13,11,124,48,0.0,879.0
3220,ad5ef8d8678ff97f,b997be68943010fc,f2b6fdb20675b11c,2019-12-14,1,0,0,90,0,0,23,12,20,3,0,0,3,3,5,3,15,9,2.0,88.0
3221,ad5ef8d8678ff97f,f2b6fdb20675b11c,b997be68943010fc,2019-12-14,0,0,0,90,0,0,10,1,10,0,0,0,0,0,7,4,3,1,0.0,88.0
3222,a0c82ba11a373008,78114b7199cef90c,d661ce4da776fc20,2019-12-14,0,0,0,643,3,0,76,14,76,0,0,0,0,0,12,4,64,14,0.0,582.8
3223,a0c82ba11a373008,d661ce4da776fc20,78114b7199cef90c,2019-12-14,3,0,0,643,2,2,108,40,90,18,1,1,17,13,17,13,73,27,44.2,557.0
3224,98dd88d83f57c17a,31123249b0bbf52e,484acc7b0f856ce9,2019-12-14,1,0,0,595,3,2,47,27,22,25,0,0,25,18,4,3,18,9,419.4,132.0
3225,98dd88d83f57c17a,484acc7b0f856ce9,31123249b0bbf52e,2019-12-14,0,4,0,595,0,0,23,10,15,8,0,0,8,7,6,2,9,3,10.0,165.60000000000002
3226,82177c0f91d9618a,dc9572dd6ec74859,f1b2aa7853d1ed6e,2019-12-14,0,0,0,1450,0,0,395,103,395,0,0,0,0,0,54,40,341,103,0.0,1441.8
3227,82177c0f91d9618a,f1b2aa7853d1ed6e,dc9572dd6ec74859,2019-12-14,2,0,0,1450,0,0,360,116,345,15,2,2,13,12,79,57,266,104,8.2,1439.0
3228,36fcfd186a8d6df7,1d239d571e342453,80fa8218c99f9c58,2019-12-14,0,1,0,1500,0,0,73,19,55,18,7,3,11,6,18,18,37,13,57.5,315.0999999999999
3229,36fcfd186a8d6df7,80fa8218c99f9c58,1d239d571e342453,2019-12-14,0,2,0,1500,11,8,184,63,49,135,1,1,134,61,21,15,28,2,1085.9,332.5
3230,35d0ef51fede263c,36541f1e6c5d4955,f72465a784c1b084,2019-12-14,0,0,0,900,7,2,122,39,118,4,0,0,4,3,19,17,99,36,51.5,797.0
3231,35d0ef51fede263c,f72465a784c1b084,36541f1e6c5d4955,2019-12-14,0,0,0,900,1,0,196,40,196,0,0,0,0,0,75,58,121,40,0.0,835.5
3232,30523303e8d85c25,1cf7ccf64a5bf24e,64facb6cc564262d,2019-12-14,0,0,0,197,0,0,17,4,16,1,1,1,0,0,5,3,11,4,3.6,113.9
3233,30523303e8d85c25,64facb6cc564262d,1cf7ccf64a5bf24e,2019-12-14,2,0,0,197,1,1,44,20,22,22,3,3,19,11,4,3,18,9,65.1,119.4
3234,1881b1e85cceee13,792be9a24df82ed6,853eb0dd5c0e2149,2019-12-14,0,0,0,900,0,0,276,78,276,0,0,0,0,0,15,13,261,78,0.0,900.0
3235,1881b1e85cceee13,853eb0dd5c0e2149,792be9a24df82ed6,2019-12-14,0,0,0,900,0,0,231,57,231,0,0,0,0,0,37,25,194,57,0.0,900.0
3236,fa3f04be9344804b,5b8ba8f5512893b1,d9c6f19f958643e9,2019-12-07,0,0,0,260,0,0,4,2,2,2,0,0,2,2,1,0,1,0,0.0,20.0
3237,fa3f04be9344804b,d9c6f19f958643e9,5b8ba8f5512893b1,2019-12-07,0,1,1,260,1,1,7,5,1,6,0,0,6,5,1,1,0,0,240.0,20.0
3238,e91f289f1b9f9519,2cd428e9606856fd,b4ad3a06ee4d660c,2019-12-07,1,0,0,1496,0,0,209,57,207,2,0,0,2,2,40,32,167,55,0.4,1144.5
3239,e91f289f1b9f9519,b4ad3a06ee4d660c,2cd428e9606856fd,2019-12-07,0,0,0,1496,10,2,105,48,85,20,1,1,19,18,28,25,57,30,345.5,994.6
3240,d9501c6985c1b38d,637bd06c32219f0b,aa171d55d4b5208f,2019-12-07,0,0,0,498,0,0,6,0,6,0,0,0,0,0,4,3,2,0,0.0,61.19999999999999
3241,d9501c6985c1b38d,aa171d55d4b5208f,637bd06c32219f0b,2019-12-07,0,5,1,498,1,1,86,63,6,80,7,6,73,62,5,5,1,1,423.8,53.0
3242,bbc8e8a69e9bd106,bd58d34e39b7b12a,ebc1f40e00e0c481,2019-12-07,1,0,0,597,1,0,101,41,95,6,0,0,6,5,18,17,77,36,47.7,319.0
3243,bbc8e8a69e9bd106,ebc1f40e00e0c481,bd58d34e39b7b12a,2019-12-07,0,0,0,597,1,0,77,18,77,0,0,0,0,0,38,35,39,18,0.0,546.3
3244,b9ff9ebe19ae6358,05339613bf8e9808,5987b2458f4b5290,2019-12-07,0,0,0,900,1,1,202,78,202,0,0,0,0,0,14,12,188,78,0.0,858.5
3245,b9ff9ebe19ae6358,5987b2458f4b5290,05339613bf8e9808,2019-12-07,0,0,0,900,16,6,154,45,152,2,0,0,2,2,18,14,134,43,30.5,702.0
3246,b87863a2de433824,bf7ad5628363eec9,efb96bf3e9ada36f,2019-12-07,0,0,0,900,12,5,67,34,47,20,1,1,19,17,9,6,38,17,396.0,466.0
3247,b87863a2de433824,efb96bf3e9ada36f,bf7ad5628363eec9,2019-12-07,0,0,0,900,0,0,105,21,101,4,0,0,4,2,11,9,90,19,38.0,447.0
3248,b5365d22172e414b,3143bf892608139a,d4691518d012b9e7,2019-12-07,0,0,0,633,0,0,81,10,80,1,0,0,1,0,43,37,37,10,7.0,187.4
3249,b5365d22172e414b,d4691518d012b9e7,3143bf892608139a,2019-12-07,1,0,0,633,3,2,85,40,53,32,2,2,30,23,6,5,47,17,213.6,379.0
3250,a3f89ad71e1caa81,af65aa688d13eedf,eb29176b03dfa888,2019-12-07,0,0,0,900,5,4,70,50,9,61,5,4,56,44,2,2,7,6,736.9,145.9
3251,a3f89ad71e1caa81,eb29176b03dfa888,af65aa688d13eedf,2019-12-07,0,0,0,900,0,0,22,7,16,6,0,0,6,6,3,3,13,1,5.1,157.10000000000002
3252,81af3b60203d92df,ea7e5bc78d9de658,f797f0c57a83353e,2019-12-07,1,1,0,849,1,1,183,59,183,0,0,0,0,0,40,32,143,59,0.0,842.0
3253,81af3b60203d92df,f797f0c57a83353e,ea7e5bc78d9de658,2019-12-07,0,0,0,849,1,0,96,20,96,0,0,0,0,0,25,19,71,20,0.0,843.0
3254,652a956adab8ad0e,19b7738321cfae42,7dda2cf308f24a02,2019-12-07,0,0,0,376,0,0,30,6,30,0,0,0,0,0,3,3,27,6,0.0,346.0
3255,652a956adab8ad0e,7dda2cf308f24a02,19b7738321cfae42,2019-12-07,0,3,1,376,4,3,20,4,20,0,0,0,0,0,5,3,15,4,0.0,154.0
3256,57d04160f5438654,31ee470ef5dc8d7f,4b47e71384a9522f,2019-12-07,0,0,0,158,0,0,26,7,26,0,0,0,0,0,6,6,20,7,0.0,124.4
3257,57d04160f5438654,4b47e71384a9522f,31ee470ef5dc8d7f,2019-12-07,1,1,1,158,3,0,41,14,29,12,0,0,12,9,10,9,19,5,33.6,116.0
3258,3b8cac9910af1c61,98215d037be5bcb7,cd2c4d30c6e13b47,2019-12-07,0,0,0,900,4,3,130,51,74,56,8,8,48,38,32,19,42,13,293.5,596.0
3259,3b8cac9910af1c61,cd2c4d30c6e13b47,98215d037be5bcb7,2019-12-07,0,0,0,900,0,0,140,30,140,0,0,0,0,0,30,26,110,30,0.0,604.5
3260,e6a0f19af995c432,c6aee362c7a7d482,d317a5e2b3f88c5f,2019-11-16,0,1,1,382,1,1,30,11,23,7,0,0,7,4,7,5,16,7,42.0,52.0
3261,e6a0f19af995c432,d317a5e2b3f88c5f,c6aee362c7a7d482,2019-11-16,0,2,0,382,3,3,11,1,9,2,1,1,1,1,2,1,7,0,258.0,82.0
3262,c63edd25d2201a46,140745cbbcb023ac,eabf206b162b3b83,2019-11-16,0,0,0,900,3,1,66,19,49,17,3,2,14,6,6,4,43,13,471.3,382.9
3263,c63edd25d2201a46,eabf206b162b3b83,140745cbbcb023ac,2019-11-16,0,1,0,900,4,1,99,30,95,4,0,0,4,3,28,21,67,27,18.1,351.7
3264,c04274c8caa505dd,7a703c565ccaa18f,99df7d0a2a08a8a8,2019-11-16,0,0,0,1500,5,0,48,8,48,0,0,0,0,0,20,12,28,8,0.0,995.0
3265,c04274c8caa505dd,99df7d0a2a08a8a8,7a703c565ccaa18f,2019-11-16,0,0,0,1500,0,0,170,38,170,0,0,0,0,0,49,33,121,38,0.0,1496.0
3266,aa232e53d285cc6d,1bcaac2d99b90fce,8f6a18831a120817,2019-11-16,0,0,0,859,4,1,99,36,99,0,0,0,0,0,8,5,91,36,0.0,591.0
3267,aa232e53d285cc6d,8f6a18831a120817,1bcaac2d99b90fce,2019-11-16,3,0,0,859,0,0,174,79,166,8,1,1,7,4,25,22,141,75,131.0,728.0
3268,9e1ecdb9a8856a8c,2ac4628c08ec5125,4dcfb28c011c11b2,2019-11-16,0,0,0,900,1,0,96,33,93,3,0,0,3,2,24,16,69,31,8.4,708.4
3269,9e1ecdb9a8856a8c,4dcfb28c011c11b2,2ac4628c08ec5125,2019-11-16,0,0,0,900,9,2,120,35,112,8,1,1,7,5,16,12,96,30,110.6,490.6
3270,80ce8f7d988d5e57,2c99576fefe53c7c,3a314d9fa7c6825d,2019-11-16,0,0,0,900,9,2,158,31,155,3,0,0,3,2,43,27,112,29,54.5,688.0
3271,80ce8f7d988d5e57,3a314d9fa7c6825d,2c99576fefe53c7c,2019-11-16,0,0,0,900,0,0,163,51,160,3,0,0,3,2,36,23,124,49,12.0,817.5
3272,7afe2a15ae7359e9,07225ba28ae309b6,7026eca45f65377b,2019-11-16,1,0,0,86,1,0,16,5,14,2,0,0,2,2,7,5,7,3,2.0,84.0
3273,7afe2a15ae7359e9,7026eca45f65377b,07225ba28ae309b6,2019-11-16,0,0,0,86,0,0,18,7,18,0,0,0,0,0,2,0,16,7,0.0,79.0
3274,57b111b54a2d2323,61fb8098ccf81c7f,886264a0c9f4ea5e,2019-11-16,0,0,0,900,1,1,47,20,36,11,1,1,10,7,11,8,25,13,303.0,436.5
3275,57b111b54a2d2323,886264a0c9f4ea5e,61fb8098ccf81c7f,2019-11-16,0,2,0,900,7,3,42,12,41,1,0,0,1,1,12,10,29,11,160.5,276.0
3276,22307b580e0c8d0d,887961364be5ceb3,a8283a4f415e1eb9,2019-11-16,0,0,0,900,2,2,115,27,108,7,2,2,5,4,36,21,72,23,173.4,677.0
3277,22307b580e0c8d0d,a8283a4f415e1eb9,887961364be5ceb3,2019-11-16,0,1,0,900,2,1,122,20,122,0,0,0,0,0,22,11,100,20,0.0,662.6
3278,18e1b0df8da7010e,68d4a891e5cf2029,9b7dfb3b7d99926a,2019-11-16,0,0,0,900,9,2,140,53,115,25,5,5,20,16,26,21,89,37,356.1,372.5
3279,18e1b0df8da7010e,9b7dfb3b7d99926a,68d4a891e5cf2029,2019-11-16,0,0,0,900,0,0,125,32,123,2,0,0,2,2,9,8,114,30,0.5,541.9
3280,1800ffbb34ac7ed8,6551c64fbcd1a467,e0f959f65d0406b4,2019-11-16,1,1,0,900,0,0,63,27,45,18,2,1,16,12,3,3,42,15,528.0,93.0
3281,1800ffbb34ac7ed8,e0f959f65d0406b4,6551c64fbcd1a467,2019-11-16,0,1,0,900,3,2,42,15,26,16,0,0,16,9,0,0,26,6,279.0,93.0
3282,094790e50afae55e,1ae8f3c723aacff4,7bde387d50829adf,2019-11-16,0,1,1,237,3,2,34,3,33,1,1,1,0,0,10,6,23,3,66.0,171.0
3283,094790e50afae55e,7bde387d50829adf,1ae8f3c723aacff4,2019-11-16,0,0,0,237,0,0,16,3,16,0,0,0,0,0,5,3,11,3,0.0,168.0
3284,f820c6292e19d854,0d980975001ae3d8,7279654c7674cd24,2019-11-09,0,0,0,900,1,0,138,10,138,0,0,0,0,0,79,54,59,10,0.0,836.0
3285,f820c6292e19d854,7279654c7674cd24,0d980975001ae3d8,2019-11-09,0,0,0,900,2,1,78,11,77,1,0,0,1,0,30,21,47,11,53.0,794.0
3286,f0418c2c989a5cde,113df4fde64735c6,d3fa5c5955397532,2019-11-09,0,0,0,900,9,6,63,8,54,9,0,0,9,3,31,22,23,5,296.2,492.6
3287,f0418c2c989a5cde,d3fa5c5955397532,113df4fde64735c6,2019-11-09,0,0,0,900,0,0,88,16,70,18,0,0,18,6,31,19,39,10,45.4,545.8
3288,c8dfcbee63266273,90da09db03e41748,9b7694d064a8a0ad,2019-11-09,0,0,0,900,0,0,51,12,51,0,0,0,0,0,18,13,33,12,0.0,258.0
3289,c8dfcbee63266273,9b7694d064a8a0ad,90da09db03e41748,2019-11-09,0,0,0,900,12,4,28,6,23,5,3,3,2,1,4,3,19,5,635.0,265.0
3290,c814ef3b3a26e2fe,6c8072b61c276e67,91dac5e69e28d5b5,2019-11-09,0,0,0,900,2,0,157,37,157,0,0,0,0,0,40,28,117,37,0.0,882.0
3291,c814ef3b3a26e2fe,91dac5e69e28d5b5,6c8072b61c276e67,2019-11-09,0,0,0,900,1,0,238,71,238,0,0,0,0,0,44,27,194,71,0.0,851.0
3292,c3bb60dc82345a9f,751de04455cfaac0,87aa9fb63d6b51a1,2019-11-09,0,0,0,900,0,0,213,61,204,9,0,0,9,9,29,19,175,52,0.0,848.0
3293,c3bb60dc82345a9f,87aa9fb63d6b51a1,751de04455cfaac0,2019-11-09,0,0,0,900,4,1,250,46,249,1,0,0,1,1,69,50,180,45,52.0,848.0
3294,a7807ab56cb49cad,37c5366d18ed6c05,d06f8869449ba7bd,2019-11-09,0,0,0,900,0,0,98,22,98,0,0,0,0,0,8,6,90,22,0.0,440.5
3295,a7807ab56cb49cad,d06f8869449ba7bd,37c5366d18ed6c05,2019-11-09,0,0,0,900,8,3,49,8,39,10,3,2,7,5,12,10,27,3,344.5,521.0
3296,495e64df4c4ce7a7,37d5b176d438d2a5,9d83f6da776ff7d6,2019-11-09,0,1,1,841,3,1,117,14,117,0,0,0,0,0,40,29,77,14,0.0,785.0
3297,495e64df4c4ce7a7,9d83f6da776ff7d6,37d5b176d438d2a5,2019-11-09,0,0,0,841,1,0,95,19,95,0,0,0,0,0,23,18,72,19,0.0,839.0
3298,408fc024d3e91b0e,06f36cf4bd97ec77,c3218c810959d279,2019-11-09,0,0,0,900,4,0,140,49,138,2,0,0,2,2,37,32,101,47,4.6,760.0
3299,408fc024d3e91b0e,c3218c810959d279,06f36cf4bd97ec77,2019-11-09,0,0,0,900,4,2,102,48,102,0,0,0,0,0,7,5,95,48,0.0,521.4
3300,3cd1f2c31b4e325a,279566840aa55bf2,85073dbd1be65ed9,2019-11-09,0,0,0,900,0,0,152,44,152,0,0,0,0,0,51,42,101,44,0.0,900.0
3301,3cd1f2c31b4e325a,85073dbd1be65ed9,279566840aa55bf2,2019-11-09,0,0,0,900,2,0,135,23,135,0,0,0,0,0,43,23,92,23,0.0,900.0
3302,343749a2f7c5d78b,ce632027bf2a871b,d802174b0c0c1f4e,2019-11-09,0,0,0,629,2,0,26,4,26,0,0,0,0,0,3,2,23,4,0.0,347.6
3303,343749a2f7c5d78b,d802174b0c0c1f4e,ce632027bf2a871b,2019-11-09,1,0,0,629,3,1,67,28,49,18,2,2,16,15,20,14,29,13,261.4,295.0
3304,1af574c0814429ac,029e1293e609fd74,3bb2dc8e87b10a46,2019-11-09,0,0,0,170,1,1,9,3,9,0,0,0,0,0,1,1,8,3,0.0,60.0
3305,1af574c0814429ac,3bb2dc8e87b10a46,029e1293e609fd74,2019-11-09,0,2,1,170,0,0,11,0,11,0,0,0,0,0,4,2,7,0,0.0,170.0
3306,1317d7cd79495a0e,5331b25a60417ffb,abd5fb12437eda21,2019-11-09,0,2,0,900,0,0,140,22,140,0,0,0,0,0,21,19,119,22,0.0,889.0
3307,1317d7cd79495a0e,abd5fb12437eda21,5331b25a60417ffb,2019-11-09,0,0,0,900,9,0,92,26,92,0,0,0,0,0,8,4,84,26,0.0,736.0
3308,071a1cd551b7b4d5,7f0f171414d0a287,a6cba6bb66c1a8c9,2019-11-09,0,0,0,594,1,1,71,15,69,2,0,0,2,0,17,13,52,15,23.1,444.0
3309,071a1cd551b7b4d5,a6cba6bb66c1a8c9,7f0f171414d0a287,2019-11-09,1,0,0,594,8,1,61,10,61,0,0,0,0,0,27,27,34,10,0.0,431.9
3310,f870cacadb058733,1788eee370f077b7,d3df1add9d9a7efb,2019-11-02,0,1,0,900,6,3,38,12,38,0,0,0,0,0,11,8,27,12,0.0,700.0
3311,f870cacadb058733,d3df1add9d9a7efb,1788eee370f077b7,2019-11-02,0,0,0,900,3,1,68,21,68,0,0,0,0,0,14,10,54,21,0.0,773.0
3312,d7cbe2f23d75afd1,1291edf2d566a71a,2c9d00968f818270,2019-11-02,0,0,0,900,3,1,124,21,124,0,0,0,0,0,23,11,101,21,0.0,795.3
3313,d7cbe2f23d75afd1,2c9d00968f818270,1291edf2d566a71a,2019-11-02,0,0,0,900,0,0,139,15,135,4,4,4,0,0,56,36,79,15,48.7,681.0
3314,d5955b81c26230ff,84ff027394f7e470,ee9ebceabfd16fa7,2019-11-02,0,0,0,167,1,0,46,8,46,0,0,0,0,0,1,1,45,8,0.0,166.7
3315,d5955b81c26230ff,ee9ebceabfd16fa7,84ff027394f7e470,2019-11-02,1,0,0,167,0,0,59,19,58,1,0,0,1,1,4,2,54,18,0.3,166.0
3316,ac0a63ad13897564,47b9e0e7703a4868,8355922d564b152c,2019-11-02,2,0,0,900,1,1,179,78,117,62,15,10,47,30,28,24,89,48,296.5,484.0
3317,ac0a63ad13897564,8355922d564b152c,47b9e0e7703a4868,2019-11-02,0,0,0,900,2,0,104,23,104,0,0,0,0,0,30,20,74,23,0.0,559.5
3318,a6c29d2cb319d923,1ddb480b601cefb1,4e0692ad070976e4,2019-11-02,0,0,0,723,1,0,83,6,83,0,0,0,0,0,29,17,54,6,0.0,698.0
3319,a6c29d2cb319d923,4e0692ad070976e4,1ddb480b601cefb1,2019-11-02,1,0,0,723,0,0,134,52,133,1,0,0,1,1,21,16,112,51,1.0,713.0
3320,a3e8ef1ce72a7d02,0c6d9ea8306c029e,4144798612ef96e5,2019-11-02,0,0,0,147,0,0,23,1,23,0,0,0,0,0,4,2,19,1,0.0,145.7
3321,a3e8ef1ce72a7d02,4144798612ef96e5,0c6d9ea8306c029e,2019-11-02,2,0,0,147,0,0,38,12,36,2,0,0,2,2,2,2,34,10,1.3,143.0
3322,a2af14e9dba37b03,5e4eec08896c9423,c21f26bbde777573,2019-11-02,1,0,0,127,2,1,39,21,28,11,0,0,11,7,1,1,27,14,10.1,105.0
3323,a2af14e9dba37b03,c21f26bbde777573,5e4eec08896c9423,2019-11-02,0,0,0,127,0,0,3,0,3,0,0,0,0,0,1,1,2,0,0.0,97.9
3324,83f7c3b91a402306,2cd428e9606856fd,3738e68d2261e60f,2019-11-02,1,0,0,29,0,0,9,4,9,0,0,0,0,0,1,1,8,4,0.0,27.0
3325,83f7c3b91a402306,3738e68d2261e60f,2cd428e9606856fd,2019-11-02,0,0,0,29,0,0,9,1,9,0,0,0,0,0,3,3,6,1,0.0,29.0
3326,7c40aa2cb6883a91,8c0580d4fff106c1,9ce6d5a03af801b7,2019-11-02,0,0,0,900,4,1,81,8,81,0,0,0,0,0,40,32,41,8,0.0,737.0
3327,7c40aa2cb6883a91,9ce6d5a03af801b7,8c0580d4fff106c1,2019-11-02,0,0,0,900,2,1,67,19,67,0,0,0,0,0,19,17,48,19,0.0,862.0
3328,515ecc54219bcc4c,8e1f36476ef02a6a,e872e9a9a902c045,2019-11-02,0,0,0,900,2,1,231,31,230,1,0,0,1,0,38,27,192,31,50.3,749.0
3329,515ecc54219bcc4c,e872e9a9a902c045,8e1f36476ef02a6a,2019-11-02,0,0,0,900,1,0,180,45,180,0,0,0,0,0,38,28,142,45,0.0,849.7
3330,28deed0ab55ca350,4a28cb716c19157a,6d4b63c767106d3a,2019-11-02,1,0,0,900,0,0,242,111,230,12,0,0,12,9,30,27,200,102,8.8,889.0
3331,28deed0ab55ca350,6d4b63c767106d3a,4a28cb716c19157a,2019-11-02,0,0,0,900,0,0,175,26,175,0,0,0,0,0,68,51,107,26,0.0,890.2
3332,216fddf542707629,87a1dc546b1c5caf,98d961097baaf308,2019-11-02,0,1,0,872,19,3,48,21,47,1,0,0,1,1,2,1,45,20,259.0,448.6
3333,216fddf542707629,98d961097baaf308,87a1dc546b1c5caf,2019-11-02,1,0,0,872,0,0,155,61,95,60,13,11,47,40,34,33,61,21,164.4,402.0
3334,cc477d322638ba30,068f8a189a47fea6,f14cf73e51b29254,2019-10-26,0,0,0,131,0,0,22,1,22,0,0,0,0,0,11,7,11,1,0.0,122.6
3335,cc477d322638ba30,f14cf73e51b29254,068f8a189a47fea6,2019-10-26,1,0,0,131,0,0,37,20,25,12,0,0,12,8,1,0,24,12,8.4,117.0
3336,b2d05ae88f820421,08af939f41b5a57b,764342d39cdaa54a,2019-10-26,0,1,1,122,2,2,18,8,18,0,0,0,0,0,5,5,13,8,0.0,77.0
3337,b2d05ae88f820421,764342d39cdaa54a,08af939f41b5a57b,2019-10-26,0,0,0,122,0,0,9,1,9,0,0,0,0,0,2,2,7,1,0.0,122.0
3338,a4527094aa107b55,76e2870ffafbe38f,be0b310a12eb80b4,2019-10-26,0,0,0,900,11,4,233,63,231,2,2,1,0,0,11,7,220,63,22.0,742.1
3339,a4527094aa107b55,be0b310a12eb80b4,76e2870ffafbe38f,2019-10-26,0,0,0,900,5,1,234,48,219,15,2,1,13,7,43,29,176,41,25.9,840.0
3340,89266a872e1f92d9,447f9858ae78f921,a12a8314adc1c1c9,2019-10-26,0,0,0,900,5,3,132,41,127,5,0,0,5,3,27,22,100,38,6.5,870.0
3341,89266a872e1f92d9,a12a8314adc1c1c9,447f9858ae78f921,2019-10-26,0,0,0,900,3,0,138,26,138,0,0,0,0,0,28,16,110,26,0.0,893.5
3342,4ea4d0a73a90bfb0,4e30e4250cb08b61,e76d9f656ceb82ab,2019-10-26,0,0,0,900,6,1,151,31,151,0,0,0,0,0,85,68,66,31,0.0,865.7
3343,4ea4d0a73a90bfb0,e76d9f656ceb82ab,4e30e4250cb08b61,2019-10-26,0,0,0,900,3,1,157,42,153,4,0,0,4,2,29,23,124,40,11.3,778.0
3344,41b75c9222c33cdf,1a9480fc288e55d7,787bb1f087ccff8a,2019-10-26,0,0,0,886,0,0,121,14,121,0,0,0,0,0,31,18,90,14,0.0,846.3
3345,41b75c9222c33cdf,787bb1f087ccff8a,1a9480fc288e55d7,2019-10-26,1,1,1,886,3,3,168,50,157,11,0,0,11,4,56,44,101,46,37.7,749.0
3346,3d9aeef58dd0b51b,41f90012b86a11bf,6a11e325aa60ad02,2019-10-26,1,0,0,900,0,0,138,22,138,0,0,0,0,0,26,17,112,22,0.0,851.8
3347,3d9aeef58dd0b51b,6a11e325aa60ad02,41f90012b86a11bf,2019-10-26,0,0,0,900,0,0,77,10,72,5,2,2,3,1,29,22,43,9,42.2,824.0
3348,3162ae3ccbf785ac,31a13532e724ca2b,511e82663651438d,2019-10-26,0,0,0,900,4,1,188,59,142,46,7,4,39,24,25,22,117,35,174.0,726.0
3349,3162ae3ccbf785ac,511e82663651438d,31a13532e724ca2b,2019-10-26,0,0,0,900,0,0,173,46,173,0,0,0,0,0,39,32,134,46,0.0,726.0
3350,241a0833e1c76804,0b31f87be71ebbb1,427b5953ac8e3a27,2019-10-26,0,0,0,834,7,4,127,54,121,6,1,1,5,5,10,8,111,49,36.0,708.3
3351,241a0833e1c76804,427b5953ac8e3a27,0b31f87be71ebbb1,2019-10-26,0,1,1,834,0,0,122,44,119,3,0,0,3,3,34,25,85,41,11.7,708.0
3352,1f9a6f2120835615,4a57ebb14315b251,b4c6c904a9ffc5e8,2019-10-26,0,0,0,900,1,0,140,58,126,14,2,2,12,8,22,18,104,50,55.1,502.8
3353,1f9a6f2120835615,b4c6c904a9ffc5e8,4a57ebb14315b251,2019-10-26,0,0,0,900,6,2,107,30,90,17,3,3,14,12,20,11,70,18,212.2,507.9
3354,1c91deb42b991d18,c17041f1bb5768d8,c814b4c899793af6,2019-10-26,0,0,0,900,11,0,133,37,132,1,0,0,1,1,31,18,101,36,2.3,839.0
3355,1c91deb42b991d18,c814b4c899793af6,c17041f1bb5768d8,2019-10-26,0,0,0,900,1,1,131,40,131,0,0,0,0,0,45,26,86,40,0.0,803.7
3356,d2dc6fb05ad78d80,18968f97ad34f15c,cbf5e6f231b55443,2019-10-18,0,0,0,900,4,3,95,35,62,33,4,3,29,22,15,12,47,13,250.5,403.1
3357,d2dc6fb05ad78d80,cbf5e6f231b55443,18968f97ad34f15c,2019-10-18,0,0,0,900,3,0,170,65,110,60,0,0,60,36,43,31,67,29,162.9,459.5
3358,baf17e5e1fe1c744,51018a31ddf31eb2,d7e40dca3ae125be,2019-10-18,0,1,0,900,14,5,238,86,191,47,0,0,47,32,39,27,152,54,168.7,670.6
3359,baf17e5e1fe1c744,d7e40dca3ae125be,51018a31ddf31eb2,2019-10-18,0,0,0,900,1,1,252,58,248,4,0,0,4,4,51,40,197,54,10.4,645.3
3360,9c3fb95a1558b38d,4682bc59d5f55145,c5af5750e8bae4f0,2019-10-18,0,0,0,900,0,0,251,93,251,0,0,0,0,0,20,18,231,93,0.0,900.0
3361,9c3fb95a1558b38d,c5af5750e8bae4f0,4682bc59d5f55145,2019-10-18,0,0,0,900,15,1,151,17,151,0,0,0,0,0,38,25,113,17,0.0,632.0
3362,93f3e9b9f093ad57,483a953b18d73bb3,a17ad5a5048e8c3f,2019-10-18,0,0,0,900,15,6,53,25,42,11,3,3,8,8,1,1,41,17,241.0,404.5
3363,93f3e9b9f093ad57,a17ad5a5048e8c3f,483a953b18d73bb3,2019-10-18,0,0,0,900,1,1,119,54,105,14,0,0,14,12,4,3,101,42,13.5,629.0
3364,7510b0c96f5707ea,38c7f72747f4f712,6a740daf1b279661,2019-10-18,0,0,0,184,2,0,28,8,28,0,0,0,0,0,7,4,21,8,0.0,137.0
3365,7510b0c96f5707ea,6a740daf1b279661,38c7f72747f4f712,2019-10-18,1,0,0,184,0,0,68,31,65,3,0,0,3,3,3,3,62,28,3.0,162.0
3366,74b44635535cb290,2f181c0467965b98,3a46b268013afede,2019-10-18,0,4,1,518,3,2,22,7,15,7,0,0,7,4,3,3,12,3,151.4,62.0
3367,74b44635535cb290,3a46b268013afede,2f181c0467965b98,2019-10-18,0,1,0,518,1,1,38,14,26,12,3,3,9,7,8,5,18,7,283.0,83.6
3368,57d989702ae72dc1,3bad7ef643840f67,87c0b1c696ddfb43,2019-10-18,1,0,0,93,2,1,36,24,20,16,0,0,16,15,1,1,19,9,39.5,51.0
3369,57d989702ae72dc1,87c0b1c696ddfb43,3bad7ef643840f67,2019-10-18,0,0,0,93,0,0,19,4,19,0,0,0,0,0,5,4,14,4,0.0,53.5
3370,38d6c2538ce6ec4c,325ad0dd9126d3df,98e946879ba20c0f,2019-10-18,2,0,0,135,0,0,44,21,37,7,0,0,7,3,3,1,34,18,6.1,128.0
3371,38d6c2538ce6ec4c,98e946879ba20c0f,325ad0dd9126d3df,2019-10-18,0,0,0,135,1,0,22,4,22,0,0,0,0,0,9,8,13,4,0.0,85.9
3372,26d75187369ecf2c,45f7cb591c3ab00b,523fa774700d7d3f,2019-10-18,1,0,0,900,3,2,210,85,209,1,0,0,1,0,42,34,167,85,6.0,858.0
3373,26d75187369ecf2c,523fa774700d7d3f,45f7cb591c3ab00b,2019-10-18,0,0,0,900,6,0,291,71,291,0,0,0,0,0,55,36,236,71,0.0,810.0
3374,1e3d3545b6dd13a7,04c8b08b16a5b99e,f86cb5f25d545e0e,2019-10-18,0,0,0,900,0,0,151,33,151,0,0,0,0,0,65,60,86,33,0.0,900.0
3375,1e3d3545b6dd13a7,f86cb5f25d545e0e,04c8b08b16a5b99e,2019-10-18,0,0,0,900,0,0,108,20,108,0,0,0,0,0,25,12,83,20,0.0,900.0
3376,0d1d7cfb2a48d5ec,2e19380f34871c6a,3a8176e15b9887c1,2019-10-18,1,0,0,103,0,0,11,7,6,5,0,0,5,4,1,1,5,3,6.4,47.3
3377,0d1d7cfb2a48d5ec,3a8176e15b9887c1,2e19380f34871c6a,2019-10-18,0,0,0,103,4,1,6,1,4,2,0,0,2,1,2,2,2,0,46.7,26.6
3378,076c98ac0561521f,2dc1bc1a02961656,40093d1d2d78394e,2019-10-18,0,0,0,166,1,1,38,25,6,32,1,1,31,25,1,1,5,0,132.8,29.0
3379,076c98ac0561521f,40093d1d2d78394e,2dc1bc1a02961656,2019-10-18,0,1,1,166,0,0,8,1,8,0,0,0,0,0,5,5,3,1,0.0,33.19999999999999
3380,0019ec81fd706ade,326f94d6cfb1bf25,85073dbd1be65ed9,2019-10-18,0,0,0,900,0,0,97,15,97,0,0,0,0,0,19,11,78,15,0.0,900.0
3381,0019ec81fd706ade,85073dbd1be65ed9,326f94d6cfb1bf25,2019-10-18,0,0,0,900,0,0,105,22,105,0,0,0,0,0,33,32,72,22,0.0,900.0
3382,f61f5adf7e0a80c4,3d6749c4267da18f,eb04b9d31e938edb,2019-10-12,0,1,0,1500,5,3,300,48,300,0,0,0,0,0,164,132,136,48,0.0,1167.0
3383,f61f5adf7e0a80c4,eb04b9d31e938edb,3d6749c4267da18f,2019-10-12,0,1,0,1500,9,1,160,25,160,0,0,0,0,0,76,33,84,25,0.0,1201.0
3384,f3169b755afcdc5b,6256b2b1562cb8e1,d8da10db80131bec,2019-10-12,0,0,0,104,0,0,18,6,11,7,0,0,7,4,3,3,8,2,13.0,44.0
3385,f3169b755afcdc5b,d8da10db80131bec,6256b2b1562cb8e1,2019-10-12,1,0,0,104,1,0,22,10,9,13,0,0,13,9,1,1,8,1,47.0,44.0
3386,c5b8a996eff18540,b0d6a1d8ac3d563d,cdb96af67d096b1e,2019-10-12,0,0,0,900,5,4,166,37,165,1,0,0,1,1,51,38,114,36,15.5,742.1
3387,c5b8a996eff18540,cdb96af67d096b1e,b0d6a1d8ac3d563d,2019-10-12,1,0,0,900,1,0,255,60,253,2,0,0,2,1,26,21,227,59,2.9,858.5
3388,bed2710e06dabe6a,2844b047183a1adb,dccb63727f2f5f74,2019-10-12,0,2,0,900,2,1,120,43,111,9,0,0,9,6,16,8,95,37,30.8,835.0
3389,bed2710e06dabe6a,dccb63727f2f5f74,2844b047183a1adb,2019-10-12,0,0,0,900,7,4,110,27,110,0,0,0,0,0,28,21,82,27,0.0,696.2
3390,bac178dea57bd545,7acbb0972e75281a,fccf811c1e8b01c7,2019-10-12,0,0,0,900,0,0,205,72,205,0,0,0,0,0,18,13,187,72,0.0,880.0
3391,bac178dea57bd545,fccf811c1e8b01c7,7acbb0972e75281a,2019-10-12,0,0,0,900,2,0,185,21,185,0,0,0,0,0,39,18,146,21,0.0,900.0
3392,834f67e96612cd6f,6ac9bc2953c47345,cad24459b28592ca,2019-10-12,0,0,0,900,1,0,202,56,202,0,0,0,0,0,17,16,185,56,0.0,894.6
3393,834f67e96612cd6f,cad24459b28592ca,6ac9bc2953c47345,2019-10-12,0,0,0,900,0,0,178,31,175,3,0,0,3,1,46,33,129,30,5.4,891.0
3394,70f01e9ff0b4e519,5f6f049d54728e88,7c7332319c14094c,2019-10-12,0,0,0,797,1,0,131,38,130,1,0,0,1,0,19,12,111,38,21.9,611.8
3395,70f01e9ff0b4e519,7c7332319c14094c,5f6f049d54728e88,2019-10-12,1,2,0,797,1,0,133,41,116,17,0,0,17,14,50,39,66,27,32.2,703.1
3396,707ba52845d399c9,242d36d241b43c12,d247691a6c0e9034,2019-10-12,0,0,0,900,2,0,200,73,198,2,0,0,2,1,23,13,175,72,0.4,894.0
3397,707ba52845d399c9,d247691a6c0e9034,242d36d241b43c12,2019-10-12,0,0,0,900,0,0,288,84,286,2,1,1,1,0,72,50,214,84,2.0,863.6
3398,6a0217099efee13f,e7f51d9f9e9259e7,fb3e61720be4690c,2019-10-12,0,0,0,885,2,0,242,45,240,2,0,0,2,0,53,43,187,45,0.0,811.6
3399,6a0217099efee13f,fb3e61720be4690c,e7f51d9f9e9259e7,2019-10-12,2,0,0,885,2,2,222,96,191,31,0,0,31,24,56,43,135,72,73.4,769.0
3400,64bee58391921b4b,6fd953151d981979,f923e012414c883e,2019-10-12,0,0,0,900,2,1,160,59,160,0,0,0,0,0,18,15,142,59,0.0,788.0
3401,64bee58391921b4b,f923e012414c883e,6fd953151d981979,2019-10-12,0,0,0,900,1,1,147,34,147,0,0,0,0,0,30,20,117,34,0.0,879.0
3402,2d7f29ec900a8948,7447e9f28508106a,beecb672a279223e,2019-10-12,0,0,0,900,6,0,145,16,144,1,0,0,1,1,10,4,134,15,2.0,792.0
3403,2d7f29ec900a8948,beecb672a279223e,7447e9f28508106a,2019-10-12,0,0,0,900,2,2,206,40,203,3,0,0,3,2,43,34,160,38,106.0,792.0
3404,25548d526c3a7587,a67f5afa8d6a1b80,cc7040fe76f0ef91,2019-10-12,0,1,1,421,1,0,48,14,48,0,0,0,0,0,4,3,44,14,0.0,353.0
3405,25548d526c3a7587,cc7040fe76f0ef91,a67f5afa8d6a1b80,2019-10-12,0,0,0,421,3,2,37,8,37,0,0,0,0,0,10,9,27,8,0.0,383.0
3406,1d26ceb1c995655e,82d4c957649faf9b,c487223b0289bda9,2019-10-12,1,0,0,452,1,1,61,16,51,10,0,0,10,6,23,19,28,10,0.0,452.0
3407,1d26ceb1c995655e,c487223b0289bda9,82d4c957649faf9b,2019-10-12,0,0,0,452,0,0,42,2,42,0,0,0,0,0,12,6,30,2,0.0,443.0
3408,18dde81d45ac2232,aa72b0f831d0bfe5,c96d9178c9ed9e62,2019-10-12,0,1,1,188,1,0,13,8,13,0,0,0,0,0,0,0,13,8,0.0,188.0
3409,18dde81d45ac2232,c96d9178c9ed9e62,aa72b0f831d0bfe5,2019-10-12,0,0,0,188,3,1,38,10,38,0,0,0,0,0,22,16,16,10,0.0,184.0
3410,fd0fd9a2d6ef8c4f,4c288a2b250bb576,e9213f53ddeca978,2019-10-05,0,0,0,900,0,0,95,17,95,0,0,0,0,0,10,7,85,17,0.0,740.0
3411,fd0fd9a2d6ef8c4f,e9213f53ddeca978,4c288a2b250bb576,2019-10-05,0,0,0,900,6,2,105,15,99,6,0,0,6,2,33,17,66,13,160.0,740.0
3412,b8c21a311f3f7953,862b0b3375aa4b6e,a0e75f4a13eb73f1,2019-10-05,0,0,0,237,0,0,5,2,5,0,0,0,0,0,0,0,5,2,0.0,25.5
3413,b8c21a311f3f7953,a0e75f4a13eb73f1,862b0b3375aa4b6e,2019-10-05,0,1,1,237,2,1,18,10,5,13,0,0,13,10,1,0,4,0,188.5,34.0
3414,9dfac33cd3ae4afd,1eff7bc0f815b270,e13abac8089a801a,2019-10-05,1,0,0,130,0,0,12,2,12,0,0,0,0,0,2,2,10,2,0.0,118.0
3415,9dfac33cd3ae4afd,e13abac8089a801a,1eff7bc0f815b270,2019-10-05,0,0,0,130,0,0,9,5,9,0,0,0,0,0,1,1,8,5,0.0,61.0
3416,8cd7ca0e7b861b3d,c62fbc117d57b943,e2f6b2769aaedd6c,2019-10-05,0,0,0,494,0,0,50,8,48,2,1,0,1,0,17,13,31,8,0.9,245.4
3417,8cd7ca0e7b861b3d,e2f6b2769aaedd6c,c62fbc117d57b943,2019-10-05,0,1,1,494,8,6,42,22,28,14,0,0,14,14,1,1,27,8,243.6,232.1
3418,83d59f5e52e0ac46,37ed1ab2f8b819f4,af9f42e6894047fc,2019-10-05,0,0,0,900,1,1,153,70,124,29,0,0,29,25,24,21,100,45,162.2,518.0
3419,83d59f5e52e0ac46,af9f42e6894047fc,37ed1ab2f8b819f4,2019-10-05,0,1,0,900,15,3,95,25,93,2,0,0,2,1,12,11,81,24,203.0,534.8
3420,668d077ac9d7d3c9,6e7506127408aa9e,a20f234df70f2182,2019-10-05,0,0,0,599,2,1,131,9,127,4,1,0,3,1,63,36,64,8,21.0,532.7
3421,668d077ac9d7d3c9,a20f234df70f2182,6e7506127408aa9e,2019-10-05,1,0,0,599,0,0,179,64,175,4,4,1,0,0,24,15,151,64,3.3,568.0
3422,57ff0eb2351979c4,294aa73dbf37d281,b4537562f88ac582,2019-10-05,0,0,0,780,11,2,50,9,32,18,2,2,16,7,15,9,17,2,396.9,332.5
3423,57ff0eb2351979c4,b4537562f88ac582,294aa73dbf37d281,2019-10-05,1,1,0,780,1,0,88,29,69,19,1,0,18,13,18,9,51,16,28.5,344.1
3424,578987d534a0d205,8fc9ae9c7527dfcb,c549573c0df4d676,2019-10-05,0,0,0,900,4,3,96,44,93,3,0,0,3,3,5,4,88,41,216.4,395.0
3425,578987d534a0d205,c549573c0df4d676,8fc9ae9c7527dfcb,2019-10-05,0,1,0,900,2,0,155,49,155,0,0,0,0,0,13,11,142,49,0.0,589.6
3426,2556b7520536ce1d,1338e2c7480bdf9e,e1147d3d2dabe1ce,2019-10-05,2,0,0,513,0,0,95,27,91,4,0,0,4,3,15,13,76,24,4.0,509.0
3427,2556b7520536ce1d,e1147d3d2dabe1ce,1338e2c7480bdf9e,2019-10-05,0,0,0,513,0,0,116,20,116,0,0,0,0,0,19,12,97,20,0.0,509.0
3428,1cb7138b107b93b5,1fc64507a0cb38cf,a845f0735bc67405,2019-10-05,0,0,0,900,0,0,110,8,110,0,0,0,0,0,16,7,94,8,0.0,897.0
3429,1cb7138b107b93b5,a845f0735bc67405,1fc64507a0cb38cf,2019-10-05,0,0,0,900,2,0,133,19,133,0,0,0,0,0,57,40,76,19,0.0,851.0
3430,0697d5520b74a8df,193b9d1858bc4df3,59279a7c978f7da0,2019-10-05,1,0,0,900,1,0,207,68,182,25,1,1,24,21,38,29,144,47,149.0,751.0
3431,0697d5520b74a8df,59279a7c978f7da0,193b9d1858bc4df3,2019-10-05,0,0,0,900,3,0,116,21,116,0,0,0,0,0,23,16,93,21,0.0,727.0
3432,fc16ccf0994c6e50,b8a85389d115e35a,f97c5433c77522d3,2019-09-28,0,1,1,771,7,4,92,33,62,30,0,0,30,17,16,13,46,16,345.0,380.0
3433,fc16ccf0994c6e50,f97c5433c77522d3,b8a85389d115e35a,2019-09-28,0,0,0,771,0,0,36,5,36,0,0,0,0,0,2,1,34,5,0.0,386.0
3434,d5e927306f5d859b,77d7295d1b22c694,ea7e5bc78d9de658,2019-09-28,0,0,0,900,2,0,113,31,113,0,0,0,0,0,13,5,100,31,0.0,857.0
3435,d5e927306f5d859b,ea7e5bc78d9de658,77d7295d1b22c694,2019-09-28,0,0,0,900,3,0,169,32,169,0,0,0,0,0,36,22,133,32,0.0,862.0
3436,b6dad3a9bf911bfd,0d65c432720accb9,50db8711c70196cd,2019-09-28,0,0,0,466,0,0,78,23,73,5,0,0,5,3,19,14,54,20,64.3,376.0
3437,b6dad3a9bf911bfd,50db8711c70196cd,0d65c432720accb9,2019-09-28,0,1,1,466,2,1,48,5,48,0,0,0,0,0,12,9,36,5,0.0,351.7
3438,b44531903be4729a,749f572d1d3161fb,cd13728ae1151f46,2019-09-28,0,0,0,155,0,0,12,4,12,0,0,0,0,0,1,1,11,4,0.0,82.6
3439,b44531903be4729a,cd13728ae1151f46,749f572d1d3161fb,2019-09-28,1,0,0,155,5,4,26,14,7,19,0,0,19,13,1,1,6,1,72.4,75.0
3440,9fa3623172adb4cd,70fa1c64a2c439ef,e9ac7bfb65c25497,2019-09-28,0,0,0,17,0,0,11,2,11,0,0,0,0,0,0,0,11,2,0.0,15.0
3441,9fa3623172adb4cd,e9ac7bfb65c25497,70fa1c64a2c439ef,2019-09-28,1,0,0,17,0,0,8,4,6,2,0,0,2,2,1,1,5,2,2.0,15.0
3442,9c7b6a20f35fb708,57b10fca4f9c9a7a,9d19d9e4aa2662e8,2019-09-28,0,0,0,900,4,3,47,14,39,8,0,0,8,4,7,4,32,10,171.6,487.4
3443,9c7b6a20f35fb708,9d19d9e4aa2662e8,57b10fca4f9c9a7a,2019-09-28,0,0,0,900,4,1,84,19,63,21,0,0,21,11,20,12,43,8,176.6,400.4
3444,975840814b233bcd,c3f6db17cea09ca7,da0995f19b749cfa,2019-09-28,0,0,0,72,0,0,1,0,1,0,0,0,0,0,0,0,1,0,0.0,22.9
3445,975840814b233bcd,da0995f19b749cfa,c3f6db17cea09ca7,2019-09-28,1,0,0,72,2,1,29,22,3,26,0,0,26,21,0,0,3,1,49.1,21.0
3446,951968aa52a84928,32c355b04fc57f3a,f9b200db02b488d9,2019-09-28,0,0,0,900,7,4,99,16,87,12,0,0,12,7,47,24,40,9,246.4,592.0
3447,951968aa52a84928,f9b200db02b488d9,32c355b04fc57f3a,2019-09-28,0,0,0,900,1,0,70,4,70,0,0,0,0,0,34,21,36,4,0.0,647.6
3448,7410ac7e4e5acb74,23024fdfc966410a,fd55393021a8c255,2019-09-28,0,1,0,900,3,1,76,8,73,3,0,0,3,1,29,22,44,7,16.4,713.0
3449,7410ac7e4e5acb74,fd55393021a8c255,23024fdfc966410a,2019-09-28,0,0,0,900,2,0,36,9,35,1,0,0,1,0,13,11,22,9,72.0,595.6
3450,688908886d8ac900,9560ff14eb3129f7,cc351e408bbb7d43,2019-09-28,0,0,0,900,2,1,119,44,99,20,3,3,17,13,25,12,74,31,71.0,715.2
3451,688908886d8ac900,cc351e408bbb7d43,9560ff14eb3129f7,2019-09-28,0,0,0,900,7,3,99,20,94,5,3,3,2,2,19,11,75,18,113.8,647.0
3452,476c31184332698e,0a1942069c9ad6b6,13a0275fa13c4d26,2019-09-28,0,0,0,327,6,1,42,5,42,0,0,0,0,0,21,15,21,5,0.0,262.3
3453,476c31184332698e,13a0275fa13c4d26,0a1942069c9ad6b6,2019-09-28,1,0,0,327,0,0,53,21,36,17,1,1,16,16,9,6,27,5,19.7,305.0
3454,18d84b333b28de36,6a96ad1bc34fb113,aec185309b4843d0,2019-09-28,0,0,0,900,3,3,126,30,113,13,3,1,10,5,52,38,61,25,344.0,556.0
3455,18d84b333b28de36,aec185309b4843d0,6a96ad1bc34fb113,2019-09-28,0,0,0,900,0,0,96,10,96,0,0,0,0,0,7,2,89,10,0.0,556.0
3456,0a3df9b1918cfc2f,2eeaefbfc7f9fcff,9cdd2da1a9104a0b,2019-09-28,0,0,0,900,4,2,39,18,23,16,0,0,16,11,3,3,20,7,240.0,435.0
3457,0a3df9b1918cfc2f,9cdd2da1a9104a0b,2eeaefbfc7f9fcff,2019-09-28,0,0,0,900,4,0,47,4,47,0,0,0,0,0,25,22,22,4,0.0,313.0
3458,fd3e8f61d8fda839,792be9a24df82ed6,b1d19449397541dc,2019-09-21,1,0,0,900,1,1,82,28,57,25,1,1,24,13,12,5,45,15,355.6,316.8
3459,fd3e8f61d8fda839,b1d19449397541dc,792be9a24df82ed6,2019-09-21,0,0,0,900,11,4,63,24,43,20,0,0,20,17,7,6,36,7,199.2,305.4
3460,d9c0351cd21e40e0,6e00cfffd54653c4,de75d1c45a39e221,2019-09-21,0,0,0,900,0,0,170,28,170,0,0,0,0,0,21,12,149,28,0.0,853.8
3461,d9c0351cd21e40e0,de75d1c45a39e221,6e00cfffd54653c4,2019-09-21,0,0,0,900,0,0,253,76,252,1,0,0,1,1,29,20,223,75,0.2,898.0
3462,c2b842fae4e9f1dc,4234f0097c83fa62,673ea7dcc786b1b3,2019-09-21,0,0,0,900,5,1,169,58,150,19,1,1,18,13,30,18,120,45,95.0,755.0
3463,c2b842fae4e9f1dc,673ea7dcc786b1b3,4234f0097c83fa62,2019-09-21,0,0,0,900,1,0,127,42,127,0,0,0,0,0,26,17,101,42,0.0,721.0
3464,c163ed45c21c8548,578ef12674df1e6a,9b7dfb3b7d99926a,2019-09-21,0,0,0,900,0,0,333,79,333,0,0,0,0,0,62,46,271,79,0.0,900.0
3465,c163ed45c21c8548,9b7dfb3b7d99926a,578ef12674df1e6a,2019-09-21,0,0,0,900,1,0,250,48,250,0,0,0,0,0,43,20,207,48,0.0,887.0
3466,b2cdb4c34f37ad37,d910665038efc639,e8b731feff72294b,2019-09-21,0,0,0,900,11,4,80,27,68,12,0,0,12,10,20,17,48,17,246.3,458.2
3467,b2cdb4c34f37ad37,e8b731feff72294b,d910665038efc639,2019-09-21,0,1,0,900,1,0,103,41,94,9,0,0,9,8,6,4,88,33,10.8,635.7
3468,ad878cdd4fa36a3a,31f8081c7600da93,edd02825c29028fe,2019-09-21,1,0,0,96,2,0,16,8,16,0,0,0,0,0,4,4,12,8,0.0,46.0
3469,ad878cdd4fa36a3a,edd02825c29028fe,31f8081c7600da93,2019-09-21,0,0,0,96,0,0,10,0,10,0,0,0,0,0,7,6,3,0,0.0,96.0
3470,953c89aa931082e4,225def29ecfe0fc1,36549928f90f1d36,2019-09-21,0,0,0,900,0,0,115,22,111,4,0,0,4,2,31,10,80,20,0.0,657.1
3471,953c89aa931082e4,36549928f90f1d36,225def29ecfe0fc1,2019-09-21,1,0,0,900,5,2,117,36,93,24,4,3,20,17,33,21,60,19,242.9,647.0
3472,8cf6b22995c9efb8,acb36c908d415c4a,eabf206b162b3b83,2019-09-21,0,0,0,199,0,0,3,0,3,0,0,0,0,0,1,1,2,0,0.0,52.0
3473,8cf6b22995c9efb8,eabf206b162b3b83,acb36c908d415c4a,2019-09-21,1,1,1,199,1,1,27,16,9,18,0,0,18,11,2,2,7,5,96.0,71.0
3474,62acea88e628c3ca,18968f97ad34f15c,cbf5e6f231b55443,2019-09-21,0,0,0,15,0,0,1,0,1,0,0,0,0,0,0,0,1,0,0.0,15.0
3475,62acea88e628c3ca,cbf5e6f231b55443,18968f97ad34f15c,2019-09-21,0,0,0,15,0,0,2,0,2,0,0,0,0,0,2,2,0,0,0.0,15.0
3476,52311c2cd0c84d67,c0d5c0c95c59050b,f0feeb2192937424,2019-09-21,0,0,0,716,1,0,186,36,186,0,0,0,0,0,49,36,137,36,0.0,678.0
3477,52311c2cd0c84d67,f0feeb2192937424,c0d5c0c95c59050b,2019-09-21,1,0,0,716,0,0,184,60,184,0,0,0,0,0,47,32,137,60,0.0,657.0
3478,4f7ec66199bba232,72e5e5a6edfa8223,d747eb273a40a920,2019-09-21,0,0,0,900,0,0,9,0,8,1,0,0,1,0,3,2,5,0,48.0,52.0
3479,4f7ec66199bba232,d747eb273a40a920,72e5e5a6edfa8223,2019-09-21,0,2,0,900,6,4,34,21,5,29,0,0,29,21,2,1,3,0,800.0,52.0
3480,49b2a6a93d529981,9c44f290f5726d95,b93c06d09d1c4ac0,2019-09-21,0,0,0,391,5,2,199,60,199,0,0,0,0,0,42,26,157,60,0.0,352.3
3481,49b2a6a93d529981,b93c06d09d1c4ac0,9c44f290f5726d95,2019-09-21,1,0,0,391,0,0,105,33,100,5,0,0,5,2,21,16,79,31,0.7,390.0
3482,ece3a7a9e930ef9d,52e76bb4b3e852f3,65578a75fa7900e3,2019-09-14,0,0,0,900,8,3,69,16,67,2,0,0,2,2,6,6,61,14,321.0,234.4
3483,ece3a7a9e930ef9d,65578a75fa7900e3,52e76bb4b3e852f3,2019-09-14,1,0,0,900,0,0,79,31,62,17,1,1,16,10,3,2,59,21,23.6,554.0
3484,dadaee9624256e07,2ebfbe72ed703925,595db60957de51d3,2019-09-14,0,1,0,900,6,0,125,51,91,34,2,2,32,25,17,11,74,26,216.0,557.0
3485,dadaee9624256e07,595db60957de51d3,2ebfbe72ed703925,2019-09-14,0,0,0,900,5,2,75,13,75,0,0,0,0,0,31,19,44,13,0.0,501.0
3486,acf658afda38d8af,873626e5547b5235,d2cd7a69cc55e7ed,2019-09-14,0,0,0,900,1,0,122,23,122,0,0,0,0,0,34,21,88,23,0.0,510.0
3487,acf658afda38d8af,d2cd7a69cc55e7ed,873626e5547b5235,2019-09-14,0,0,0,900,5,3,112,20,100,12,2,2,10,8,42,29,58,12,342.0,558.0
3488,9de23eb1471e592b,46e0d677f91bacc0,56709e66f1c6008f,2019-09-14,0,0,0,900,2,1,65,29,60,5,3,2,2,2,0,0,60,27,71.7,728.0
3489,9de23eb1471e592b,56709e66f1c6008f,46e0d677f91bacc0,2019-09-14,0,0,0,900,6,1,57,4,57,0,0,0,0,0,15,7,42,4,0.0,317.3
3490,9d3a38cc18807e10,441eacbe20e0e80b,c9cf753cfdf77fc2,2019-09-14,1,0,0,59,0,0,27,13,25,2,0,0,2,2,2,2,23,11,0.7,56.0
3491,9d3a38cc18807e10,c9cf753cfdf77fc2,441eacbe20e0e80b,2019-09-14,0,0,0,59,0,0,7,1,7,0,0,0,0,0,5,5,2,1,0.0,58.3
3492,92b98afec5eb4e05,67f272324a030d00,70e1f8a821b72c8b,2019-09-14,0,1,1,218,2,1,10,4,6,4,0,0,4,3,2,2,4,1,85.7,30.9
3493,92b98afec5eb4e05,70e1f8a821b72c8b,67f272324a030d00,2019-09-14,0,0,0,218,0,0,35,19,8,27,0,0,27,15,2,2,6,4,37.1,88.3
3494,8ae79d7967681db8,6a11e325aa60ad02,bda04c573563cc2e,2019-09-14,0,0,0,243,0,0,29,12,29,0,0,0,0,0,5,4,24,12,0.0,204.8
3495,8ae79d7967681db8,bda04c573563cc2e,6a11e325aa60ad02,2019-09-14,1,0,0,243,3,1,66,25,63,3,0,0,3,2,6,5,57,23,23.2,127.0
3496,490724f8b3658f67,1d00756835ca67c9,9e8f6c728eb01124,2019-09-14,0,0,0,258,0,0,52,12,52,0,0,0,0,0,7,5,45,12,0.0,256.0
3497,490724f8b3658f67,9e8f6c728eb01124,1d00756835ca67c9,2019-09-14,1,0,0,258,0,0,61,27,58,3,0,0,3,2,17,13,41,25,2.0,254.0
3498,462a95890423d3c6,4bd6b4800070b069,ebef46976554f975,2019-09-14,0,3,0,900,3,1,59,20,58,1,0,0,1,1,7,1,51,19,514.0,210.0
3499,462a95890423d3c6,ebef46976554f975,4bd6b4800070b069,2019-09-14,0,2,0,900,1,1,87,36,81,6,0,0,6,5,3,1,78,31,176.0,210.0
3500,36d90f1812f0d432,1091d4d957141094,7ff97850e8c32bda,2019-09-14,0,1,0,900,4,2,95,20,88,7,0,0,7,7,29,27,59,13,195.3,459.8
3501,36d90f1812f0d432,7ff97850e8c32bda,1091d4d957141094,2019-09-14,0,2,0,900,6,1,71,39,55,16,0,0,16,11,4,4,51,28,161.2,442.7
3502,241687ff5fe92331,35e1f9984ed64206,d2bc285ead803db0,2019-09-14,0,0,0,283,0,0,80,20,80,0,0,0,0,0,15,10,65,20,0.0,278.0
3503,241687ff5fe92331,d2bc285ead803db0,35e1f9984ed64206,2019-09-14,1,0,0,283,0,0,115,27,115,0,0,0,0,0,54,32,61,27,0.0,274.0
3504,14176809bcdafd01,2af2f2e26c4c0402,7b433309b0fd12aa,2019-09-14,0,0,0,900,1,0,118,25,113,5,0,0,5,2,27,16,86,23,11.2,871.0
3505,14176809bcdafd01,7b433309b0fd12aa,2af2f2e26c4c0402,2019-09-14,0,0,0,900,12,3,60,18,60,0,0,0,0,0,9,3,51,18,0.0,506.8
3506,bef4df43d6052a02,396fe87b84ac2e1c,aceffa19749c4dc0,2019-09-07,0,2,0,900,0,0,78,12,75,3,0,0,3,3,23,16,52,9,341.4,323.9
3507,bef4df43d6052a02,aceffa19749c4dc0,396fe87b84ac2e1c,2019-09-07,1,0,0,900,8,6,58,20,48,10,1,0,9,5,4,2,44,15,7.1,543.6
3508,9a46f95c1c1e57f0,16690d100f995f8f,4ba8d454f762005d,2019-09-07,0,0,0,900,3,2,77,14,69,8,2,1,6,4,15,11,54,10,175.2,681.0
3509,9a46f95c1c1e57f0,4ba8d454f762005d,16690d100f995f8f,2019-09-07,0,0,0,900,0,0,69,6,69,0,0,0,0,0,18,11,51,6,0.0,724.8
3510,8e1ae2ae6694b131,539ed332b3078821,eebc23626e38f5dc,2019-09-07,1,1,0,746,0,0,88,35,53,35,3,3,32,24,7,6,46,11,373.6,246.0
3511,8e1ae2ae6694b131,eebc23626e38f5dc,539ed332b3078821,2019-09-07,0,0,0,746,3,2,45,12,42,3,0,0,3,2,7,7,35,10,105.0,232.39999999999998
3512,8accd04438b91262,8f5c8850b2484173,f53d4f21d1b5f2dc,2019-09-07,0,0,0,900,2,0,160,40,160,0,0,0,0,0,21,11,139,40,0.0,899.0
3513,8accd04438b91262,f53d4f21d1b5f2dc,8f5c8850b2484173,2019-09-07,0,0,0,900,2,0,326,77,326,0,0,0,0,0,55,32,271,77,0.0,881.0
3514,84d4b658851b7e0e,1e4f273069fb9e85,68c7ad953455c73f,2019-09-07,0,0,0,900,4,0,31,6,29,2,1,0,1,0,4,4,25,6,48.7,386.8
3515,84d4b658851b7e0e,68c7ad953455c73f,1e4f273069fb9e85,2019-09-07,0,0,0,900,12,3,49,11,35,14,3,2,11,8,10,8,25,3,367.2,274.3
3516,849eb47d349f3fe4,0052de90691d4a93,275aca31f61ba28c,2019-09-07,0,0,0,900,1,0,58,5,58,0,0,0,0,0,15,2,43,5,0.0,635.9
3517,849eb47d349f3fe4,275aca31f61ba28c,0052de90691d4a93,2019-09-07,1,0,0,900,1,0,95,32,77,18,0,0,18,11,14,11,63,21,239.1,621.0
3518,77f123712368bcbc,05fa626cb33d15b8,12f91bfa8f1f723b,2019-09-07,0,0,0,900,5,3,137,13,135,2,0,0,2,2,64,48,71,11,103.6,641.0
3519,77f123712368bcbc,12f91bfa8f1f723b,05fa626cb33d15b8,2019-09-07,0,0,0,900,4,2,230,40,230,0,0,0,0,0,92,61,138,40,0.0,663.4
3520,43496ff308e681a0,447f9858ae78f921,49858bf46dabf6fb,2019-09-07,1,0,0,266,0,0,23,1,23,0,0,0,0,0,13,9,10,1,0.0,264.0
3521,43496ff308e681a0,49858bf46dabf6fb,447f9858ae78f921,2019-09-07,0,0,0,266,0,0,26,3,25,1,0,0,1,0,10,3,15,3,0.0,266.0
3522,357a34207d70da69,64a50dad704d1d49,e5010b1b94ca5755,2019-09-07,0,0,0,900,3,1,114,27,109,5,1,1,4,4,39,32,70,23,109.0,685.6
3523,357a34207d70da69,e5010b1b94ca5755,64a50dad704d1d49,2019-09-07,0,0,0,900,2,0,154,41,148,6,0,0,6,4,17,15,131,37,105.4,668.0
3524,2c7b788effdc1b4c,8f4eeaf7a0df7c1a,ee18ff42063174df,2019-09-07,0,0,0,213,1,0,19,3,19,0,0,0,0,0,7,5,12,3,0.0,211.3
3525,2c7b788effdc1b4c,ee18ff42063174df,8f4eeaf7a0df7c1a,2019-09-07,1,0,0,213,0,0,53,22,51,2,0,0,2,1,9,5,42,21,1.7,202.0
3526,18aff757c54687f1,8abac218746e04ca,b1b0729d27936f2f,2019-09-07,0,0,0,715,2,1,89,23,89,0,0,0,0,0,10,6,79,23,0.0,601.5
3527,18aff757c54687f1,b1b0729d27936f2f,8abac218746e04ca,2019-09-07,0,1,1,715,9,2,106,40,102,4,0,0,4,4,21,9,81,36,75.5,564.0
3528,066756ea40b134a7,2f5cbecbbe18bac4,fa6796c55d6c5440,2019-09-07,0,0,0,442,0,0,8,3,8,0,0,0,0,0,1,0,7,3,0.0,75.0
3529,066756ea40b134a7,fa6796c55d6c5440,2f5cbecbbe18bac4,2019-09-07,1,0,0,442,5,5,43,23,10,33,1,1,32,22,1,1,9,1,367.0,75.0
3530,01a4827b3596d111,029eaff01e6bb8f0,032cc3922d871c7f,2019-09-07,0,1,0,726,0,0,39,5,39,0,0,0,0,0,13,7,26,5,0.0,232.0
3531,01a4827b3596d111,032cc3922d871c7f,029eaff01e6bb8f0,2019-09-07,0,2,1,726,8,7,41,16,28,13,3,3,10,8,3,3,25,8,494.0,194.0
3532,b07188063c49b755,853eb0dd5c0e2149,f57dd0bfa8c17813,2019-08-31,1,0,0,900,1,1,193,58,186,7,0,0,7,4,47,33,139,54,14.0,880.0
3533,b07188063c49b755,f57dd0bfa8c17813,853eb0dd5c0e2149,2019-08-31,0,0,0,900,7,1,195,51,195,0,0,0,0,0,21,9,174,51,0.0,814.0
3534,a072be4f806d360f,351c4ec637380ad5,e99821959a840bb8,2019-08-31,1,0,0,900,0,0,351,108,344,7,5,4,2,1,80,59,264,107,24.9,836.0
3535,a072be4f806d360f,e99821959a840bb8,351c4ec637380ad5,2019-08-31,0,0,0,900,5,0,290,122,290,0,0,0,0,0,46,43,244,122,0.0,853.1
3536,8182dbc752c71137,093e1f5bb73850be,285ae0b4a68221f4,2019-08-31,0,1,1,579,9,6,110,51,103,7,0,0,7,7,8,8,95,44,146.5,307.0
3537,8182dbc752c71137,285ae0b4a68221f4,093e1f5bb73850be,2019-08-31,0,0,0,579,0,0,148,76,148,0,0,0,0,0,6,5,142,76,0.0,416.5
3538,676561d9690ce31d,32490e80ddab1e5a,714e1e0681ddb703,2019-08-31,0,0,0,900,0,0,128,44,128,0,0,0,0,0,30,14,98,44,0.0,719.1
3539,676561d9690ce31d,714e1e0681ddb703,32490e80ddab1e5a,2019-08-31,0,1,0,900,6,3,85,23,82,3,0,0,3,2,11,10,71,21,144.9,562.0
3540,5ff390f7bbf2bec8,74f9448b97bf8bec,c3218c810959d279,2019-08-31,0,1,1,719,1,0,190,69,190,0,0,0,0,0,14,12,176,69,0.0,714.0
3541,5ff390f7bbf2bec8,c3218c810959d279,74f9448b97bf8bec,2019-08-31,0,0,0,719,6,1,167,83,167,0,0,0,0,0,6,5,161,83,0.0,529.0
3542,5f900e4437e079b3,43a59ce3bb40449e,fdbefee0827e1567,2019-08-31,0,0,0,900,4,0,204,86,204,0,0,0,0,0,9,7,195,86,0.0,864.0
3543,5f900e4437e079b3,fdbefee0827e1567,43a59ce3bb40449e,2019-08-31,0,0,0,900,4,0,270,65,270,0,0,0,0,0,72,58,198,65,0.0,871.0
3544,55480808b1fa1f9c,8adcbd525fab8d9b,e64b96c07d7ce999,2019-08-31,0,0,0,891,1,0,160,23,160,0,0,0,0,0,46,31,114,23,0.0,861.1
3545,55480808b1fa1f9c,e64b96c07d7ce999,8adcbd525fab8d9b,2019-08-31,3,0,0,891,3,2,128,45,124,4,1,1,3,3,19,13,105,42,5.9,869.0
3546,357cf8a9b6737625,1ebe20ebbfa15e29,6a1901c62ab3870f,2019-08-31,1,0,0,42,0,0,38,16,36,2,0,0,2,1,13,13,23,15,0.1,41.0
3547,357cf8a9b6737625,6a1901c62ab3870f,1ebe20ebbfa15e29,2019-08-31,0,0,0,42,0,0,12,2,12,0,0,0,0,0,3,2,9,2,0.0,36.9
3548,2e001d8c2f6106fc,1897b7b913736a7c,3b0a516d2921e0d6,2019-08-31,0,0,0,900,7,3,89,35,86,3,0,0,3,3,1,1,85,32,171.0,725.4
3549,2e001d8c2f6106fc,3b0a516d2921e0d6,1897b7b913736a7c,2019-08-31,0,0,0,900,1,0,230,74,213,17,0,0,17,12,28,11,185,62,3.6,723.0
3550,09b91014bd88f815,3cf18e01cb6cbde3,d0e50a3d1b250708,2019-08-31,0,0,0,900,1,1,157,72,114,43,3,3,40,23,27,18,87,49,203.8,638.5
3551,09b91014bd88f815,d0e50a3d1b250708,3cf18e01cb6cbde3,2019-08-31,0,0,0,900,3,0,72,13,68,4,0,0,4,1,17,10,51,12,43.5,609.2
3552,060dfbc982c6c4ef,135d124172a0bea3,d945aae53e3e54e6,2019-08-31,1,0,0,900,5,0,188,28,171,17,11,8,6,3,45,35,126,25,64.6,824.0
3553,060dfbc982c6c4ef,d945aae53e3e54e6,135d124172a0bea3,2019-08-31,0,0,0,900,3,0,114,16,114,0,0,0,0,0,26,20,88,16,0.0,811.4
3554,fba7d6a42f137938,2f13e4020cea5b38,65f09bacd3957381,2019-08-17,0,0,0,900,6,4,81,15,78,3,0,0,3,3,31,30,47,12,24.6,656.0
3555,fba7d6a42f137938,65f09bacd3957381,2f13e4020cea5b38,2019-08-17,0,0,0,900,1,0,116,23,112,4,3,3,1,1,46,36,66,22,113.0,649.4
3556,f2ce79565c0820dd,8355922d564b152c,cbb682f5fcc44bfc,2019-08-17,1,0,0,900,1,1,201,94,172,29,0,0,29,20,29,20,143,74,112.8,527.9
3557,f2ce79565c0820dd,cbb682f5fcc44bfc,8355922d564b152c,2019-08-17,0,1,0,900,0,0,133,54,129,4,0,0,4,3,22,15,107,51,14.1,678.2
3558,ea43a5fe4ff9a3c4,436f970c9ea9169c,94426bb170c88115,2019-08-17,0,0,0,254,0,0,72,11,72,0,0,0,0,0,17,13,55,11,0.0,250.5
3559,ea43a5fe4ff9a3c4,94426bb170c88115,436f970c9ea9169c,2019-08-17,1,0,0,254,0,0,79,25,72,7,0,0,7,4,9,9,63,21,3.5,250.0
3560,8ebd6e9d41a51e31,2244d9a2b64b8c3b,411539901068522f,2019-08-17,0,1,0,900,1,1,164,39,161,3,0,0,3,2,41,31,120,37,1.9,852.4
3561,8ebd6e9d41a51e31,411539901068522f,2244d9a2b64b8c3b,2019-08-17,0,0,0,900,8,3,130,29,127,3,0,0,3,2,20,14,107,27,36.6,703.1
3562,6921344f8e706d0f,d28dee5c705991df,d967f0128c323de6,2019-08-17,1,0,0,1149,3,1,229,86,223,6,0,0,6,2,41,37,182,84,16.1,967.5
3563,6921344f8e706d0f,d967f0128c323de6,d28dee5c705991df,2019-08-17,0,0,0,1149,3,1,263,162,236,27,5,5,22,16,15,14,221,146,90.5,951.9
3564,51f955029dbf6978,122ac9b816d8b71c,70d2329a92864fdb,2019-08-17,0,0,0,900,0,0,99,19,94,5,0,0,5,4,24,14,70,15,0.9,661.1
3565,51f955029dbf6978,70d2329a92864fdb,122ac9b816d8b71c,2019-08-17,0,0,0,900,4,4,171,49,140,31,11,11,20,15,62,48,78,34,233.9,250.1
3566,445d0d44091b902a,a7897d200692ab64,cc351e408bbb7d43,2019-08-17,1,0,0,900,6,3,101,46,89,12,0,0,12,8,5,4,84,38,381.0,501.0
3567,445d0d44091b902a,cc351e408bbb7d43,a7897d200692ab64,2019-08-17,0,0,0,900,1,1,187,32,169,18,0,0,18,11,61,45,108,21,18.0,495.0
3568,3e16a71836e85212,2e5c2aa8e4ab9d82,f77c68bb4be8516d,2019-08-17,1,0,0,900,0,0,213,67,207,6,0,0,6,3,65,51,142,64,3.3,894.0
3569,3e16a71836e85212,f77c68bb4be8516d,2e5c2aa8e4ab9d82,2019-08-17,1,0,0,900,4,1,284,96,284,0,0,0,0,0,40,29,244,96,0.0,883.7
3570,2eb56023c4a54504,2e585c701f72fe55,b1a3e0aca758b322,2019-08-17,0,0,0,900,8,0,143,37,142,1,0,0,1,1,29,21,113,36,0.0,847.2
3571,2eb56023c4a54504,b1a3e0aca758b322,2e585c701f72fe55,2019-08-17,0,0,0,900,10,2,185,51,179,6,0,0,6,5,43,30,136,46,52.8,768.0
3572,2671de30a1736f51,207773daeb4afa7b,78e501478a36a018,2019-08-17,0,0,0,255,0,0,27,3,27,0,0,0,0,0,14,12,13,3,0.0,253.0
3573,2671de30a1736f51,78e501478a36a018,207773daeb4afa7b,2019-08-17,1,0,0,255,0,0,51,9,46,5,0,0,5,3,21,12,25,6,2.0,253.0
3574,25e1d17d072227c6,7cbf7c78d3b34218,de45aaae23dfa392,2019-08-17,0,0,0,900,7,2,160,56,133,27,4,3,23,19,42,40,91,37,89.9,641.5
3575,25e1d17d072227c6,de45aaae23dfa392,7cbf7c78d3b34218,2019-08-17,0,1,0,900,5,2,155,55,150,5,0,0,5,2,38,32,112,53,35.5,611.1
3576,f7cce33f6563dd72,0845c81e37d3bcb3,e9a3aeb207578eea,2019-08-10,2,0,0,571,0,0,137,44,130,7,0,0,7,5,23,20,107,39,6.5,546.0
3577,f7cce33f6563dd72,e9a3aeb207578eea,0845c81e37d3bcb3,2019-08-10,0,0,0,571,5,1,60,16,60,0,0,0,0,0,6,2,54,16,0.0,498.5
3578,d93b589bcec80ffe,31ef8b67e13495b3,cd2c4d30c6e13b47,2019-08-10,0,0,0,900,7,0,108,17,108,0,0,0,0,0,38,24,70,17,0.0,808.7
3579,d93b589bcec80ffe,cd2c4d30c6e13b47,31ef8b67e13495b3,2019-08-10,0,1,0,900,4,1,167,31,166,1,1,1,0,0,75,52,91,31,3.3,756.0
3580,cb4dd24535ef2d94,07a2bdaa0afdd831,82b4e942781b1046,2019-08-10,1,0,0,176,5,2,15,6,15,0,0,0,0,0,2,2,13,6,0.0,97.0
3581,cb4dd24535ef2d94,82b4e942781b1046,07a2bdaa0afdd831,2019-08-10,0,0,0,176,0,0,15,3,15,0,0,0,0,0,1,0,14,3,0.0,176.0
3582,aef94727eb3897df,2c2caf2f2bab9df5,7bde387d50829adf,2019-08-10,0,0,0,900,10,4,71,23,71,0,0,0,0,0,9,9,62,23,0.0,638.6
3583,aef94727eb3897df,7bde387d50829adf,2c2caf2f2bab9df5,2019-08-10,0,0,0,900,1,1,115,46,109,6,1,1,5,5,30,18,79,41,48.4,771.0
3584,9d80bd1f92d23dfa,132deb59abae64b1,51a0c09cbe9b8472,2019-08-10,0,0,0,1500,1,1,115,16,107,8,5,2,3,1,37,24,70,15,417.8,1030.0
3585,9d80bd1f92d23dfa,51a0c09cbe9b8472,132deb59abae64b1,2019-08-10,0,0,0,1500,4,0,76,1,76,0,0,0,0,0,36,17,40,1,0.0,1082.2
3586,975159720cfd0103,c3ded6f7155f9ea4,ec18eb918121787c,2019-08-10,0,0,0,900,4,3,39,14,29,10,0,0,10,9,4,3,25,5,655.5,161.0
3587,975159720cfd0103,ec18eb918121787c,c3ded6f7155f9ea4,2019-08-10,0,0,0,900,1,0,42,16,34,8,0,0,8,7,5,4,29,9,18.0,226.5
3588,8da94b2c1c0443d4,1cf7ccf64a5bf24e,260e9e0d4954aea6,2019-08-10,0,0,0,566,0,0,43,19,41,2,0,0,2,2,7,3,34,17,0.0,250.3
3589,8da94b2c1c0443d4,260e9e0d4954aea6,1cf7ccf64a5bf24e,2019-08-10,0,1,1,566,7,3,39,16,17,22,1,1,21,11,2,1,15,5,315.7,236.0
3590,7feadf01c5920285,6d4b63c767106d3a,f2b6fdb20675b11c,2019-08-10,0,1,0,900,0,0,179,43,179,0,0,0,0,0,54,41,125,43,0.0,900.0
3591,7feadf01c5920285,f2b6fdb20675b11c,6d4b63c767106d3a,2019-08-10,0,0,0,900,2,0,175,56,175,0,0,0,0,0,40,31,135,56,0.0,700.0
3592,4dd3035430a5ed43,be0b310a12eb80b4,d76ad9a08c4408ff,2019-08-10,0,0,0,900,7,3,239,51,239,0,0,0,0,0,40,32,199,51,0.0,861.0
3593,4dd3035430a5ed43,d76ad9a08c4408ff,be0b310a12eb80b4,2019-08-10,0,0,0,900,1,0,236,56,236,0,0,0,0,0,48,34,188,56,0.0,876.0
3594,4c489b3c9d14cbc9,45f0cc9d18f35137,9cfbfae5fa1fdd93,2019-08-10,0,0,0,900,2,1,86,18,77,9,5,2,4,4,35,28,42,14,144.0,724.0
3595,4c489b3c9d14cbc9,9cfbfae5fa1fdd93,45f0cc9d18f35137,2019-08-10,0,0,0,900,7,2,112,26,112,0,0,0,0,0,17,14,95,26,0.0,628.0
3596,494042bf96730bc0,4798e823ada58fe9,9673a497a9da119a,2019-08-10,0,1,1,69,0,0,1,0,1,0,0,0,0,0,1,1,0,0,0.0,65.0
3597,494042bf96730bc0,9673a497a9da119a,4798e823ada58fe9,2019-08-10,0,0,0,69,1,1,3,0,3,0,0,0,0,0,2,1,1,0,0.0,26.0
3598,1d8a86d37c7ef3d3,41f90012b86a11bf,787bb1f087ccff8a,2019-08-10,0,0,0,252,2,0,41,5,41,0,0,0,0,0,5,2,36,5,0.0,229.0
3599,1d8a86d37c7ef3d3,787bb1f087ccff8a,41f90012b86a11bf,2019-08-10,0,1,1,252,1,0,22,7,20,2,0,0,2,0,9,8,11,7,22.0,219.0
3600,1019f2a9c012e949,23024fdfc966410a,e2ccd9a9ace60de7,2019-08-10,0,0,0,900,7,3,83,22,68,15,1,1,14,9,28,19,40,13,368.8,473.8
3601,1019f2a9c012e949,e2ccd9a9ace60de7,23024fdfc966410a,2019-08-10,0,0,0,900,1,0,102,20,97,5,0,0,5,3,39,27,58,17,8.2,503.2
3602,f6ab2eec90980ac0,6f7c616b98e18c29,f9a20a17d712ef7c,2019-08-03,0,1,1,155,1,1,37,25,13,24,0,0,24,23,8,7,5,2,80.6,71.0
3603,f6ab2eec90980ac0,f9a20a17d712ef7c,6f7c616b98e18c29,2019-08-03,0,0,0,155,0,0,6,2,6,0,0,0,0,0,1,0,5,2,0.0,74.4
3604,f4bd11655adeb078,9e50097a89442158,cbf1c7ba5408a66f,2019-08-03,0,0,0,900,7,1,117,41,108,9,0,0,9,8,14,9,94,33,77.4,550.7
3605,f4bd11655adeb078,cbf1c7ba5408a66f,9e50097a89442158,2019-08-03,0,0,0,900,3,0,96,23,83,13,1,1,12,6,31,24,52,17,48.3,718.6
3606,e96d929f8207a3e0,c47df9303d318c67,d1941565abf50b16,2019-08-03,0,0,0,58,0,0,5,1,5,0,0,0,0,0,1,1,4,1,0.0,47.0
3607,e96d929f8207a3e0,d1941565abf50b16,c47df9303d318c67,2019-08-03,0,1,1,58,0,0,8,1,8,0,0,0,0,0,1,1,7,1,0.0,58.0
3608,e3acb789f7dcd34c,729d4bd5a6cd0a97,82cbb809d5ee565c,2019-08-03,1,0,0,706,1,0,123,20,118,5,0,0,5,4,6,4,112,16,61.8,570.0
3609,e3acb789f7dcd34c,82cbb809d5ee565c,729d4bd5a6cd0a97,2019-08-03,0,0,0,706,3,1,72,16,72,0,0,0,0,0,10,6,62,16,0.0,598.2
3610,e139628170777bef,dc9572dd6ec74859,f2925e6db404bf1d,2019-08-03,0,0,0,1500,18,10,515,128,515,0,0,0,0,0,61,51,454,128,0.0,977.0
3611,e139628170777bef,f2925e6db404bf1d,dc9572dd6ec74859,2019-08-03,0,0,0,1500,0,0,167,61,167,0,0,0,0,0,23,17,144,61,0.0,1500.0
3612,dc49373c52eedaa3,6ac9bc2953c47345,b27a1fcb56a3035a,2019-08-03,0,1,1,709,3,1,19,3,13,6,0,0,6,2,3,3,10,1,330.0,165.7
3613,dc49373c52eedaa3,b27a1fcb56a3035a,6ac9bc2953c47345,2019-08-03,0,0,0,709,1,1,15,8,10,5,0,0,5,5,2,0,8,3,213.3,123.0
3614,dbbd17b6995f014b,ae7fe94f117f98cf,b7b84ccd221be298,2019-08-03,0,0,0,336,0,0,56,0,56,0,0,0,0,0,21,15,35,0,0.0,333.0
3615,dbbd17b6995f014b,b7b84ccd221be298,ae7fe94f117f98cf,2019-08-03,1,0,0,336,0,0,38,18,29,9,0,0,9,9,5,3,24,9,3.0,333.0
3616,cd6b799ec79c489a,025f0b1b58fbad01,8667caa0451d245b,2019-08-03,0,0,0,900,10,4,134,21,131,3,1,1,2,1,53,38,78,20,16.8,771.0
3617,cd6b799ec79c489a,8667caa0451d245b,025f0b1b58fbad01,2019-08-03,0,0,0,900,0,0,123,38,120,3,0,0,3,3,21,12,99,35,0.0,883.2
3618,94560d1dc6248347,26e3f3928b1891d9,7559395ad833c074,2019-08-03,0,0,0,900,0,0,166,20,166,0,0,0,0,0,64,35,102,20,0.0,810.0
3619,94560d1dc6248347,7559395ad833c074,26e3f3928b1891d9,2019-08-03,0,0,0,900,0,0,143,31,143,0,0,0,0,0,52,30,91,31,0.0,895.0
3620,60162c95d921d1ae,215a70f073a7b726,67c1d46f4ed16f9e,2019-08-03,0,0,0,83,1,0,6,2,6,0,0,0,0,0,3,3,3,2,0.0,58.0
3621,60162c95d921d1ae,67c1d46f4ed16f9e,215a70f073a7b726,2019-08-03,0,1,1,83,0,0,12,2,12,0,0,0,0,0,1,1,11,2,0.0,83.0
3622,326de7f7ec9e7035,3cf66c62d9069f43,d7338bcb141abd2c,2019-08-03,0,0,0,380,5,1,16,3,15,1,0,0,1,1,4,3,11,2,17.1,243.0
3623,326de7f7ec9e7035,d7338bcb141abd2c,3cf66c62d9069f43,2019-08-03,0,3,1,380,0,0,23,3,23,0,0,0,0,0,17,13,6,3,0.0,248.9
3624,1d9f862a47540785,98a6b2361045898f,df1eb4354d18a906,2019-08-03,0,0,0,600,3,1,58,13,58,0,0,0,0,0,4,3,54,13,0.0,344.5
3625,1d9f862a47540785,df1eb4354d18a906,98a6b2361045898f,2019-08-03,1,0,0,600,2,1,92,37,77,15,0,0,15,6,15,7,62,31,220.5,306.0
3626,e186bd5e556f1b5e,b997be68943010fc,d8da10db80131bec,2019-07-27,1,0,0,459,4,2,61,41,26,35,0,0,35,27,1,0,25,14,176.6,212.0
3627,e186bd5e556f1b5e,d8da10db80131bec,b997be68943010fc,2019-07-27,1,0,0,459,2,0,57,15,47,10,0,0,10,4,16,9,31,11,30.0,228.4
3628,dfa2fda311df08cf,36541f1e6c5d4955,4c2d90e335e6df19,2019-07-27,0,0,0,900,2,2,148,52,147,1,0,0,1,1,20,15,127,51,20.0,739.6
3629,dfa2fda311df08cf,4c2d90e335e6df19,36541f1e6c5d4955,2019-07-27,0,0,0,900,4,0,137,33,125,12,1,1,11,8,48,34,77,25,100.4,654.0
3630,dbca9f6bb7290c0d,4e06913c91da5200,8e9eb3fc86db0f7d,2019-07-27,0,0,0,900,7,1,117,20,117,0,0,0,0,0,25,20,92,20,0.0,611.0
3631,dbca9f6bb7290c0d,8e9eb3fc86db0f7d,4e06913c91da5200,2019-07-27,0,0,0,900,3,1,77,18,77,0,0,0,0,0,26,21,51,18,0.0,764.0
3632,d47fd8fc3886f86c,99bd87a300079ed9,bb61823f76361297,2019-07-27,0,0,0,900,11,4,63,30,44,19,2,1,17,15,8,6,36,15,394.6,360.0
3633,d47fd8fc3886f86c,bb61823f76361297,99bd87a300079ed9,2019-07-27,0,0,0,900,8,0,64,13,64,0,0,0,0,0,19,10,45,13,0.0,370.4
3634,c4704eab5e2f51b8,150ff4cc642270b9,f2688492b9a525a3,2019-07-27,0,0,0,1500,0,0,328,109,327,1,0,0,1,1,33,20,294,108,0.0,1482.3
3635,c4704eab5e2f51b8,f2688492b9a525a3,150ff4cc642270b9,2019-07-27,0,0,0,1500,15,1,264,57,262,2,0,0,2,1,69,39,193,56,17.7,1394.0
3636,bc1787883f9328be,a0f0004aadf10b71,aa72b0f831d0bfe5,2019-07-27,0,0,0,900,10,2,151,41,150,1,0,0,1,0,29,20,121,41,3.7,774.8
3637,bc1787883f9328be,aa72b0f831d0bfe5,a0f0004aadf10b71,2019-07-27,1,0,0,900,3,2,113,53,97,16,0,0,16,10,15,14,82,43,51.2,784.3
3638,7ed98f8d1ffae082,55ee431411ccf07a,eae48ff31db420c2,2019-07-27,0,0,0,900,3,0,48,14,42,6,0,0,6,5,14,9,28,9,52.3,468.3
3639,7ed98f8d1ffae082,eae48ff31db420c2,55ee431411ccf07a,2019-07-27,0,0,0,900,11,2,105,28,76,29,7,7,22,15,21,12,55,13,370.7,374.7
3640,68c77a11b2d308dd,1641ef250e9de19b,38c7f72747f4f712,2019-07-27,0,0,0,553,0,0,20,8,8,12,0,0,12,6,1,1,7,2,0.0,81.0
3641,68c77a11b2d308dd,38c7f72747f4f712,1641ef250e9de19b,2019-07-27,1,0,0,553,3,2,42,24,11,31,1,1,30,21,4,4,7,3,472.0,81.0
3642,25c4013fc187762a,a68575214ecad140,da816417a579a0bd,2019-07-27,0,0,0,797,2,2,96,11,96,0,0,0,0,0,22,12,74,11,0.0,533.3
3643,25c4013fc187762a,da816417a579a0bd,a68575214ecad140,2019-07-27,0,2,1,797,13,5,62,21,52,10,0,0,10,8,22,16,30,13,214.7,432.0
3644,240e9389cca3bd18,39d91e95949de3d9,634bb0de2eb043b4,2019-07-27,0,0,0,900,8,0,85,21,79,6,4,4,2,0,17,13,62,21,85.6,658.0
3645,240e9389cca3bd18,634bb0de2eb043b4,39d91e95949de3d9,2019-07-27,0,0,0,900,0,0,216,59,202,14,2,1,12,6,67,62,135,53,28.0,702.4
3646,10b31e991c2d0d4e,2c9d00968f818270,3fa7688bfe48a493,2019-07-27,1,0,0,849,0,0,154,42,154,0,0,0,0,0,59,38,95,42,0.0,770.0
3647,10b31e991c2d0d4e,3fa7688bfe48a493,2c9d00968f818270,2019-07-27,0,0,0,849,1,0,79,24,79,0,0,0,0,0,17,15,62,24,0.0,847.0
3648,f711b3ec6bc3c407,7279654c7674cd24,d156513a19acf856,2019-07-20,0,0,0,900,3,1,89,17,89,0,0,0,0,0,29,19,60,17,0.0,771.5
3649,f711b3ec6bc3c407,d156513a19acf856,7279654c7674cd24,2019-07-20,0,0,0,900,1,0,77,12,73,4,1,1,3,2,23,15,50,10,76.5,747.0
3650,f065dc596a08a258,3738e68d2261e60f,bd58d34e39b7b12a,2019-07-20,0,0,0,900,0,0,263,103,263,0,0,0,0,0,59,49,204,103,0.0,849.0
3651,f065dc596a08a258,bd58d34e39b7b12a,3738e68d2261e60f,2019-07-20,0,0,0,900,1,0,177,55,177,0,0,0,0,0,22,15,155,55,0.0,766.0
3652,dd51d1aed9536da6,4498b382c65a7faa,8e1f36476ef02a6a,2019-07-20,0,0,0,900,9,0,110,25,110,0,0,0,0,0,10,4,100,25,0.0,654.8
3653,dd51d1aed9536da6,8e1f36476ef02a6a,4498b382c65a7faa,2019-07-20,0,0,0,900,0,0,174,72,170,4,0,0,4,1,16,11,154,71,33.2,701.0
3654,c92308bbd6107b11,262a7d06203657e6,a8283a4f415e1eb9,2019-07-20,0,0,0,900,1,0,91,9,90,1,0,0,1,0,38,16,52,9,20.0,880.0
3655,c92308bbd6107b11,a8283a4f415e1eb9,262a7d06203657e6,2019-07-20,0,0,0,900,0,0,52,13,52,0,0,0,0,0,19,12,33,13,0.0,880.0
3656,c5259566abc552b1,4bf6b225ff6099c4,dbac0a413af64bbe,2019-07-20,0,1,0,900,5,2,21,5,21,0,0,0,0,0,9,6,12,5,0.0,331.0
3657,c5259566abc552b1,dbac0a413af64bbe,4bf6b225ff6099c4,2019-07-20,0,0,0,900,8,2,42,15,28,14,2,1,12,6,9,7,19,9,199.0,502.0
3658,bc01ce748a5723df,002ca196477ce572,a4de54ea806fb525,2019-07-20,0,0,0,900,6,1,16,7,16,0,0,0,0,0,2,1,14,7,0.0,279.5
3659,bc01ce748a5723df,a4de54ea806fb525,002ca196477ce572,2019-07-20,0,1,0,900,9,6,23,12,14,9,0,0,9,7,3,3,11,5,354.5,388.0
3660,9d6b46a3cf5ec494,193b9d1858bc4df3,6256b2b1562cb8e1,2019-07-20,1,0,0,153,0,0,41,13,38,3,0,0,3,3,17,9,21,10,3.0,150.0
3661,9d6b46a3cf5ec494,6256b2b1562cb8e1,193b9d1858bc4df3,2019-07-20,0,0,0,153,0,0,23,2,23,0,0,0,0,0,7,5,16,2,0.0,150.0
3662,96d33e46267d4eaf,7aa3d6964eff4877,b93c06d09d1c4ac0,2019-07-20,0,0,0,900,0,0,197,63,197,0,0,0,0,0,43,31,154,63,0.0,742.0
3663,96d33e46267d4eaf,b93c06d09d1c4ac0,7aa3d6964eff4877,2019-07-20,0,0,0,900,2,2,218,41,214,4,2,2,2,0,45,24,169,41,158.0,742.0
3664,88b1d4f951070f83,83b00f7597e5ac83,85073dbd1be65ed9,2019-07-20,0,0,0,45,1,0,7,3,7,0,0,0,0,0,0,0,7,3,0.0,28.0
3665,88b1d4f951070f83,85073dbd1be65ed9,83b00f7597e5ac83,2019-07-20,1,0,0,45,0,0,38,35,7,31,0,0,31,31,2,1,5,4,17.0,28.0
3666,816662e622987a14,6a2f7c151031653d,f1fac969a1d70b08,2019-07-20,0,0,0,1500,5,0,169,41,169,0,0,0,0,0,54,40,115,41,0.0,1225.9
3667,816662e622987a14,f1fac969a1d70b08,6a2f7c151031653d,2019-07-20,0,0,0,1500,10,3,215,72,209,6,1,1,5,2,25,19,184,70,131.1,1063.0
3668,24bcade0007c2246,7c9c6a884be167fe,bc711b6dd95c1af6,2019-07-20,0,0,0,900,5,2,200,74,200,0,0,0,0,0,28,21,172,74,0.0,802.0
3669,24bcade0007c2246,bc711b6dd95c1af6,7c9c6a884be167fe,2019-07-20,0,0,0,900,2,0,248,92,248,0,0,0,0,0,50,37,198,92,0.0,845.0
3670,15ce105716441c54,03f982ca3735070c,98c23cb6da5b3352,2019-07-20,1,0,0,12,0,0,7,2,5,2,1,1,1,1,1,1,4,1,1.0,11.0
3671,15ce105716441c54,98c23cb6da5b3352,03f982ca3735070c,2019-07-20,0,0,0,12,0,0,3,0,3,0,0,0,0,0,2,1,1,0,0.0,11.0
3672,017e0b7e864b0aa3,578ef12674df1e6a,fc169c387b4b465d,2019-07-20,0,0,0,900,0,0,184,32,184,0,0,0,0,0,45,20,139,32,0.0,710.6
3673,017e0b7e864b0aa3,fc169c387b4b465d,578ef12674df1e6a,2019-07-20,0,0,0,900,6,1,137,29,133,4,2,2,2,2,27,16,106,27,187.4,572.0
3674,edc87836fd998929,1d239d571e342453,d4691518d012b9e7,2019-07-13,1,0,0,16,0,0,5,3,4,1,1,1,0,0,0,0,4,3,1.0,15.0
3675,edc87836fd998929,d4691518d012b9e7,1d239d571e342453,2019-07-13,0,0,0,16,0,0,4,0,4,0,0,0,0,0,0,0,4,0,0.0,15.0
3676,b436dda934059631,0d62719b1dcf7c40,8fd808923cffff82,2019-07-13,0,0,0,187,0,0,22,2,22,0,0,0,0,0,11,9,11,2,0.0,182.0
3677,b436dda934059631,8fd808923cffff82,0d62719b1dcf7c40,2019-07-13,1,0,0,187,0,0,55,16,50,5,0,0,5,4,5,3,45,12,5.0,182.0
3678,ad63c30e22e63344,31bbd39c0a075d4e,f2477cf43c4975cc,2019-07-13,0,0,0,834,0,0,150,12,150,0,0,0,0,0,24,15,126,12,0.0,832.0
3679,ad63c30e22e63344,f2477cf43c4975cc,31bbd39c0a075d4e,2019-07-13,1,0,0,834,0,0,113,22,112,1,0,0,1,1,16,10,96,21,2.0,832.0
3680,aa6a9aeeb45577d4,18b602842a24f7c5,6ebe96a116e79e52,2019-07-13,0,0,0,900,0,0,161,29,157,4,0,0,4,1,56,41,101,28,90.3,613.5
3681,aa6a9aeeb45577d4,6ebe96a116e79e52,18b602842a24f7c5,2019-07-13,0,3,0,900,6,4,128,38,109,19,3,3,16,12,19,14,90,26,128.5,579.7
3682,a7cf716f5d73b558,37d5b176d438d2a5,4dcfb28c011c11b2,2019-07-13,0,0,0,900,0,0,80,35,48,32,3,3,29,24,13,12,35,11,277.6,243.2
3683,a7cf716f5d73b558,4dcfb28c011c11b2,37d5b176d438d2a5,2019-07-13,0,2,0,900,7,4,51,20,33,18,0,0,18,12,9,5,24,8,309.8,209.39999999999998
3684,9b0de83b4e504bf6,7acbb0972e75281a,dbc17725b887860a,2019-07-13,0,0,0,900,4,2,148,69,137,11,1,1,10,7,10,8,127,62,41.3,746.0
3685,9b0de83b4e504bf6,dbc17725b887860a,7acbb0972e75281a,2019-07-13,0,0,0,900,5,0,88,17,88,0,0,0,0,0,34,22,54,17,0.0,849.7
3686,75b1533cc3cafae9,5987b2458f4b5290,78114b7199cef90c,2019-07-13,0,0,0,46,0,0,8,2,8,0,0,0,0,0,3,2,5,2,0.0,38.0
3687,75b1533cc3cafae9,78114b7199cef90c,5987b2458f4b5290,2019-07-13,1,0,0,46,0,0,15,9,5,10,1,1,9,7,1,1,4,2,8.0,38.0
3688,60be02c5566c8348,1de9ad94de18eeaf,3253b16d38ae087d,2019-07-13,0,0,0,900,5,3,79,13,68,11,1,1,10,5,28,24,40,8,186.0,346.9
3689,60be02c5566c8348,3253b16d38ae087d,1de9ad94de18eeaf,2019-07-13,0,0,0,900,4,2,90,32,73,17,0,0,17,16,17,13,56,16,181.1,437.0
3690,37a8c442fb38db75,8866c6f509c19089,92a9aa9c93192871,2019-07-13,2,1,0,900,1,0,83,15,79,4,1,0,3,2,35,21,44,13,5.6,790.9
3691,37a8c442fb38db75,92a9aa9c93192871,8866c6f509c19089,2019-07-13,0,0,0,900,0,0,126,8,87,39,23,9,16,3,20,12,67,5,102.1,784.4
3692,358468724d7d4322,37098a6e6c27fb66,773f7feacf96153e,2019-07-13,1,0,0,900,0,0,147,46,139,8,0,0,8,6,25,18,114,40,17.8,871.0
3693,358468724d7d4322,773f7feacf96153e,37098a6e6c27fb66,2019-07-13,0,0,0,900,0,0,132,6,132,0,0,0,0,0,77,48,55,6,0.0,882.2
3694,2d42ef44ad2470e1,b53c46f613f6f248,dab8cfbb6b1db10a,2019-07-13,0,0,0,900,4,3,187,48,182,5,2,1,3,3,34,23,148,45,39.0,614.7
3695,2d42ef44ad2470e1,dab8cfbb6b1db10a,b53c46f613f6f248,2019-07-13,0,0,0,900,3,2,66,8,65,1,0,0,1,1,23,15,42,7,4.3,818.0
3696,138cb102906573f2,cbd3e590a85b18c5,fba03cd6cc28dc41,2019-07-13,0,0,0,265,0,0,65,8,65,0,0,0,0,0,3,2,62,8,0.0,236.0
3697,138cb102906573f2,fba03cd6cc28dc41,cbd3e590a85b18c5,2019-07-13,1,0,0,265,0,0,52,22,32,20,0,0,20,15,9,5,23,7,29.0,236.0
3698,feaffeb1af7e82ef,82e7929bf6c2b689,c58f51dedb310998,2019-07-06,0,0,0,900,2,1,11,1,7,4,3,3,1,1,4,3,3,0,72.0,141.5
3699,feaffeb1af7e82ef,c58f51dedb310998,82e7929bf6c2b689,2019-07-06,0,0,0,900,6,5,67,46,15,52,0,0,52,38,1,1,14,8,614.5,119.0
3700,f6a03399c7a721cd,1ddb480b601cefb1,6a96ad1bc34fb113,2019-07-06,0,0,0,900,8,2,24,1,19,5,0,0,5,0,7,3,12,1,562.5,223.0
3701,f6a03399c7a721cd,6a96ad1bc34fb113,1ddb480b601cefb1,2019-07-06,0,0,0,900,2,2,43,13,42,1,0,0,1,1,11,8,31,12,2.0,315.5
3702,e9f00c16810e0e61,045f25b3a4c08e81,4144798612ef96e5,2019-07-06,0,0,0,72,0,0,7,0,7,0,0,0,0,0,0,0,7,0,0.0,39.0
3703,e9f00c16810e0e61,4144798612ef96e5,045f25b3a4c08e81,2019-07-06,0,1,1,72,1,1,24,11,6,18,0,0,18,10,2,2,4,1,33.0,39.0
3704,c48af5eafb532d0a,040a74bb0a465c54,aa5b4eff51bdc7d1,2019-07-06,0,0,0,900,2,1,190,62,190,0,0,0,0,0,47,40,143,62,0.0,846.0
3705,c48af5eafb532d0a,aa5b4eff51bdc7d1,040a74bb0a465c54,2019-07-06,0,0,0,900,2,0,113,19,113,0,0,0,0,0,9,4,104,19,0.0,900.0
3706,934b44ddcb3d95e6,86d9dbe1bfcbade7,91dac5e69e28d5b5,2019-07-06,1,0,0,900,1,0,122,30,116,6,3,2,3,2,23,17,93,28,71.6,542.3
3707,934b44ddcb3d95e6,91dac5e69e28d5b5,86d9dbe1bfcbade7,2019-07-06,0,0,0,900,2,1,83,26,82,1,1,1,0,0,9,6,73,26,11.7,664.4
3708,8fcdfee81cc604e3,07f72a2a7591b409,dea070ed4a2a8281,2019-07-06,0,0,0,1500,1,0,90,11,90,0,0,0,0,0,58,48,32,11,0.0,1500.0
3709,8fcdfee81cc604e3,dea070ed4a2a8281,07f72a2a7591b409,2019-07-06,0,0,0,1500,0,0,166,9,166,0,0,0,0,0,74,34,92,9,0.0,1500.0
3710,7fe0cec2b0f1c146,4a57ebb14315b251,ec34349e7dffcde7,2019-07-06,0,0,0,900,0,0,109,19,109,0,0,0,0,0,10,6,99,19,0.0,900.0
3711,7fe0cec2b0f1c146,ec34349e7dffcde7,4a57ebb14315b251,2019-07-06,0,0,0,900,1,0,107,36,107,0,0,0,0,0,11,4,96,36,0.0,893.0
3712,7dc551f8153bd053,7c7332319c14094c,f97c5433c77522d3,2019-07-06,0,1,1,505,1,1,27,5,23,4,0,0,4,3,15,5,8,2,143.0,204.2
3713,7dc551f8153bd053,f97c5433c77522d3,7c7332319c14094c,2019-07-06,0,0,0,505,2,1,46,13,20,26,4,2,22,11,8,7,12,2,157.8,186.0
3714,70af72a72b31fe4d,0b31f87be71ebbb1,47b9e0e7703a4868,2019-07-06,0,0,0,5,0,0,0,0,0,0,0,0,0,0,0,0,0,0,0.0,3.0
3715,70af72a72b31fe4d,47b9e0e7703a4868,0b31f87be71ebbb1,2019-07-06,1,0,0,5,0,0,3,3,1,2,0,0,2,2,0,0,1,1,2.0,3.0
3716,69c06be4f87ccdab,634e2fb70bde3fd5,80fa8218c99f9c58,2019-07-06,0,0,0,250,0,0,14,3,14,0,0,0,0,0,10,8,4,3,0.0,247.5
3717,69c06be4f87ccdab,80fa8218c99f9c58,634e2fb70bde3fd5,2019-07-06,1,0,0,250,1,0,35,8,31,4,0,0,4,3,12,9,19,5,2.5,245.0
3718,531d9676d767da66,00e11b5c8b7bfeeb,99df7d0a2a08a8a8,2019-07-06,0,0,0,399,5,0,36,4,36,0,0,0,0,0,16,10,20,4,0.0,192.6
3719,531d9676d767da66,99df7d0a2a08a8a8,00e11b5c8b7bfeeb,2019-07-06,1,0,0,399,0,0,42,11,39,3,0,0,3,3,21,19,18,8,0.4,398.0
3720,00f4b6184f6315d0,80daefbed11ce998,efb96bf3e9ada36f,2019-07-06,0,0,0,124,0,0,14,0,14,0,0,0,0,0,3,1,11,0,0.0,123.0
3721,00f4b6184f6315d0,efb96bf3e9ada36f,80daefbed11ce998,2019-07-06,1,0,0,124,0,0,20,6,19,1,0,0,1,1,5,2,14,5,1.0,123.0
3722,e460bf4db340ca9e,b3d21b2610dcfaeb,beecb672a279223e,2019-06-29,0,0,0,430,0,0,25,4,23,2,0,0,2,1,4,3,19,3,47.0,135.6
3723,e460bf4db340ca9e,beecb672a279223e,b3d21b2610dcfaeb,2019-06-29,0,2,1,430,5,2,41,16,27,14,0,0,14,7,6,5,21,9,200.4,111.0
3724,c770192a9f3261cd,a495f599e787614f,eabf206b162b3b83,2019-06-29,1,0,0,199,0,0,22,6,18,4,0,0,4,4,2,2,16,2,65.6,117.0
3725,c770192a9f3261cd,eabf206b162b3b83,a495f599e787614f,2019-06-29,0,0,0,199,1,0,13,3,13,0,0,0,0,0,7,4,6,3,0.0,121.4
3726,c0982b3919cc74f0,acb36c908d415c4a,cad24459b28592ca,2019-06-29,0,0,0,78,5,0,3,0,3,0,0,0,0,0,3,2,0,0,0.0,31.3
3727,c0982b3919cc74f0,cad24459b28592ca,acb36c908d415c4a,2019-06-29,1,0,0,78,0,0,15,11,11,4,0,0,4,4,0,0,11,7,5.7,68.0
3728,9ba051e0f5674108,068f8a189a47fea6,c482c8605455a213,2019-06-29,2,0,0,218,0,0,83,17,76,7,1,0,6,2,25,20,51,15,14.8,182.0
3729,9ba051e0f5674108,c482c8605455a213,068f8a189a47fea6,2019-06-29,0,0,0,218,0,0,44,10,44,0,0,0,0,0,14,9,30,10,0.0,172.2
3730,966bf043577f8b6a,519e4fe37ce9ff75,edd02825c29028fe,2019-06-29,1,0,0,67,0,0,27,15,23,4,0,0,4,4,5,1,18,11,4.0,62.0
3731,966bf043577f8b6a,edd02825c29028fe,519e4fe37ce9ff75,2019-06-29,0,0,0,67,1,0,14,4,14,0,0,0,0,0,1,1,13,4,0.0,63.0
3732,8f5d5dd10a167cc0,1ae8f3c723aacff4,78f485f851891d68,2019-06-29,0,0,0,900,3,3,120,23,118,2,0,0,2,2,30,17,88,21,110.7,734.0
3733,8f5d5dd10a167cc0,78f485f851891d68,1ae8f3c723aacff4,2019-06-29,0,1,0,900,1,0,123,9,123,0,0,0,0,0,43,29,80,9,0.0,779.3
3734,7ce7075951c9aa31,3f7dab21b6c971bc,ce632027bf2a871b,2019-06-29,0,0,0,642,0,0,30,8,27,3,0,0,3,3,7,5,20,5,1.2,210.10000000000002
3735,7ce7075951c9aa31,ce632027bf2a871b,3f7dab21b6c971bc,2019-06-29,1,0,0,642,6,4,43,22,17,26,4,4,22,19,9,6,8,3,429.9,177.8
3736,5fcf65d4de66c970,427b5953ac8e3a27,5331b25a60417ffb,2019-06-29,0,0,0,900,9,3,12,3,11,1,0,0,1,1,0,0,11,2,363.0,473.9
3737,5fcf65d4de66c970,5331b25a60417ffb,427b5953ac8e3a27,2019-06-29,0,0,0,900,0,0,95,13,87,8,2,1,6,4,12,8,75,9,63.1,466.0
3738,4e71dbef18157288,63def5a5662a6917,8d03ce87ca14e778,2019-06-29,0,0,0,71,0,0,6,1,6,0,0,0,0,0,3,3,3,1,0.0,67.0
3739,4e71dbef18157288,8d03ce87ca14e778,63def5a5662a6917,2019-06-29,1,0,0,71,0,0,19,5,12,7,1,1,6,3,4,3,8,2,4.0,67.0
3740,3f8c6e31ebbe54bc,66e98b3bb5fc5250,7026eca45f65377b,2019-06-29,0,1,0,900,2,2,73,11,71,2,0,0,2,1,28,23,43,10,10.8,360.0
3741,3f8c6e31ebbe54bc,7026eca45f65377b,66e98b3bb5fc5250,2019-06-29,0,0,0,900,6,2,79,43,46,33,1,1,32,22,6,4,40,21,410.0,305.2
3742,2b01da1699f0305f,37c5366d18ed6c05,c77a953488e5607d,2019-06-29,0,0,0,900,3,2,87,22,86,1,0,0,1,0,12,9,74,22,22.1,532.1
3743,2b01da1699f0305f,c77a953488e5607d,37c5366d18ed6c05,2019-06-29,0,1,0,900,6,3,101,29,78,23,1,1,22,19,45,30,33,10,212.9,516.9
3744,2418af6da44fd361,80eacd4da0617c57,b102c26727306ab6,2019-06-29,1,0,0,587,0,0,115,27,111,4,0,0,4,3,38,23,73,24,61.5,464.0
3745,2418af6da44fd361,b102c26727306ab6,80eacd4da0617c57,2019-06-29,0,0,0,587,3,1,48,15,48,0,0,0,0,0,1,0,47,15,0.0,499.5
3746,fa98e2b8dceca9bb,51018a31ddf31eb2,6551c64fbcd1a467,2019-06-22,0,0,0,900,2,2,213,66,198,15,0,0,15,8,51,42,147,58,34.7,854.9
3747,fa98e2b8dceca9bb,6551c64fbcd1a467,51018a31ddf31eb2,2019-06-22,0,0,0,900,0,0,271,33,267,4,1,1,3,0,53,34,214,33,1.1,863.3
3748,f81f8cfe30e0a1e9,483a953b18d73bb3,b9664eae2ac75262,2019-06-22,0,0,0,900,3,0,367,125,367,0,0,0,0,0,51,44,316,125,0.0,822.0
3749,f81f8cfe30e0a1e9,b9664eae2ac75262,483a953b18d73bb3,2019-06-22,0,0,0,900,0,0,224,90,224,0,0,0,0,0,18,18,206,90,0.0,897.0
3750,f047e3605f8852d8,82a5152216251682,cf946e03ba2e7666,2019-06-22,1,0,0,900,4,1,125,52,98,27,1,1,26,20,22,18,76,32,185.2,563.1
3751,f047e3605f8852d8,cf946e03ba2e7666,82a5152216251682,2019-06-22,0,0,0,900,1,1,104,21,93,11,0,0,11,7,21,12,72,14,89.9,575.8
3752,e4559c3cce6edec1,2cd428e9606856fd,a9d6e047ce48ab63,2019-06-22,1,0,0,9,0,0,4,3,1,3,1,1,2,2,0,0,1,1,2.0,7.0
3753,e4559c3cce6edec1,a9d6e047ce48ab63,2cd428e9606856fd,2019-06-22,0,0,0,9,0,0,1,0,1,0,0,0,0,0,0,0,1,0,0.0,7.0
3754,b1da312483a974b3,3a46b268013afede,77d7295d1b22c694,2019-06-22,0,0,0,900,3,0,117,13,117,0,0,0,0,0,56,45,61,13,0.0,694.9
3755,b1da312483a974b3,77d7295d1b22c694,3a46b268013afede,2019-06-22,0,0,0,900,4,2,84,29,83,1,0,0,1,1,27,22,56,28,5.1,798.0
3756,aec1339028f3416c,b6452706b373eea1,c451d67c09c55418,2019-06-22,0,0,0,58,0,0,3,0,3,0,0,0,0,0,0,0,3,0,0.0,32.0
3757,aec1339028f3416c,c451d67c09c55418,b6452706b373eea1,2019-06-22,1,0,0,58,0,0,24,15,6,18,0,0,18,13,1,1,5,2,26.0,32.0
3758,ab4862ea4cbd0750,2844b047183a1adb,eb29176b03dfa888,2019-06-22,1,1,0,674,1,1,148,84,57,91,4,3,87,57,0,0,57,27,400.2,211.7
3759,ab4862ea4cbd0750,eb29176b03dfa888,2844b047183a1adb,2019-06-22,0,0,0,674,3,1,42,2,38,4,0,0,4,0,24,22,14,2,9.3,259.8
3760,8f1b727757a60c07,5f6f049d54728e88,bbc9ab95fa766493,2019-06-22,0,0,0,900,0,0,173,67,173,0,0,0,0,0,9,6,164,67,0.0,769.1
3761,8f1b727757a60c07,bbc9ab95fa766493,5f6f049d54728e88,2019-06-22,0,0,0,900,9,2,132,26,127,5,0,0,5,2,15,9,112,24,128.9,668.0
3762,6e9cf53cd87e1b7e,a851c35f58199231,b4c6c904a9ffc5e8,2019-06-22,0,1,0,900,0,0,40,17,37,3,0,0,3,3,7,6,30,14,3.2,156.29999999999995
3763,6e9cf53cd87e1b7e,b4c6c904a9ffc5e8,a851c35f58199231,2019-06-22,0,0,0,900,5,1,100,61,28,72,1,1,71,56,16,13,12,5,723.7,122.8
3764,4096b302747d47b3,a331233f597090a5,c6aee362c7a7d482,2019-06-22,0,0,0,774,0,0,101,15,97,4,0,0,4,3,46,32,51,12,9.8,715.0
3765,4096b302747d47b3,c6aee362c7a7d482,a331233f597090a5,2019-06-22,1,0,0,774,0,0,152,44,152,0,0,0,0,0,55,45,97,44,0.0,606.2
3766,13129c1f044fdd47,05fa626cb33d15b8,80d8aed0ca9b00f3,2019-06-22,0,0,0,900,3,1,126,38,108,18,2,2,16,11,40,33,68,27,70.6,717.1
3767,13129c1f044fdd47,80d8aed0ca9b00f3,05fa626cb33d15b8,2019-06-22,0,1,0,900,12,5,107,9,106,1,0,0,1,0,11,5,95,9,33.9,592.4
3768,fe0c844a671dd6d8,9c907996820d2d69,d661ce4da776fc20,2019-06-08,0,0,0,900,3,0,192,42,188,4,0,0,4,4,47,31,141,38,8.2,843.3
3769,fe0c844a671dd6d8,d661ce4da776fc20,9c907996820d2d69,2019-06-08,2,0,0,900,3,1,189,40,179,10,0,0,10,4,23,16,156,36,17.7,852.8
3770,cf4199c8517bc1fd,056c493bbd76a918,fea79f9bc8c68769,2019-06-08,1,1,0,891,4,1,171,73,141,30,0,0,30,26,21,17,120,47,90.6,731.0
3771,cf4199c8517bc1fd,fea79f9bc8c68769,056c493bbd76a918,2019-06-08,0,0,0,891,2,0,119,35,118,1,0,0,1,1,30,22,88,34,0.0,800.4
3772,cd2ceb5530529c9f,1788eee370f077b7,c62fbc117d57b943,2019-06-08,1,0,0,900,2,2,123,65,117,6,0,0,6,6,9,8,108,59,79.0,742.0
3773,cd2ceb5530529c9f,c62fbc117d57b943,1788eee370f077b7,2019-06-08,0,0,0,900,0,0,144,39,144,0,0,0,0,0,30,25,114,39,0.0,662.0
3774,bf2a9732af50c84c,3974fa35c917af1d,751de04455cfaac0,2019-06-08,0,0,0,246,1,0,29,2,29,0,0,0,0,0,17,10,12,2,0.0,244.6
3775,bf2a9732af50c84c,751de04455cfaac0,3974fa35c917af1d,2019-06-08,1,0,0,246,0,0,41,11,36,5,0,0,5,4,13,11,23,7,1.4,244.0
3776,aa430402314b4459,d3fa5c5955397532,fc9a9559a05f2704,2019-06-08,0,0,0,587,1,0,150,24,150,0,0,0,0,0,53,31,97,24,0.0,573.7
3777,aa430402314b4459,fc9a9559a05f2704,d3fa5c5955397532,2019-06-08,2,0,0,587,2,0,171,48,166,5,0,0,5,4,42,26,124,44,13.3,571.0
3778,a4446299c1f85d74,d7c3816669784109,e8b731feff72294b,2019-06-08,0,0,0,900,0,0,232,55,232,0,0,0,0,0,46,35,186,55,0.0,866.0
3779,a4446299c1f85d74,e8b731feff72294b,d7c3816669784109,2019-06-08,0,1,0,900,0,0,369,92,369,0,0,0,0,0,80,56,289,92,0.0,893.0
3780,a255ed658a2ac9bb,899923ff6ab13917,a17ad5a5048e8c3f,2019-06-08,0,0,0,900,5,0,84,13,84,0,0,0,0,0,35,18,49,13,0.0,678.0
3781,a255ed658a2ac9bb,a17ad5a5048e8c3f,899923ff6ab13917,2019-06-08,0,0,0,900,0,0,73,11,73,0,0,0,0,0,21,19,52,11,0.0,799.0
3782,97c76d44699f7c93,c41d426cc7326d1b,f0feeb2192937424,2019-06-08,0,0,0,900,1,1,249,64,246,3,1,1,2,2,49,29,197,62,16.6,782.5
3783,97c76d44699f7c93,f0feeb2192937424,c41d426cc7326d1b,2019-06-08,0,1,0,900,3,1,144,44,142,2,1,1,1,1,33,26,109,43,6.5,828.4
3784,82eb6fa58ae52428,12f91bfa8f1f723b,e872e9a9a902c045,2019-06-08,0,0,0,900,4,3,266,24,264,2,1,1,1,0,126,87,138,24,18.4,771.0
3785,82eb6fa58ae52428,e872e9a9a902c045,12f91bfa8f1f723b,2019-06-08,0,0,0,900,2,0,221,50,220,1,1,1,0,0,41,31,179,50,0.0,881.6
3786,56403d0fd259c5d9,b08012bbe542592a,d343df8ba11f4c4e,2019-06-08,0,0,0,900,13,4,142,29,107,35,7,7,28,19,50,39,57,10,414.2,403.0
3787,56403d0fd259c5d9,d343df8ba11f4c4e,b08012bbe542592a,2019-06-08,0,0,0,900,0,0,99,31,94,5,0,0,5,5,33,17,61,26,0.0,485.8
3788,4127b45c3d546eef,132deb59abae64b1,f72465a784c1b084,2019-06-08,1,1,0,326,2,2,11,4,10,1,0,0,1,1,6,4,4,3,85.3,70.0
3789,4127b45c3d546eef,f72465a784c1b084,132deb59abae64b1,2019-06-08,0,0,0,326,0,0,12,0,12,0,0,0,0,0,5,2,7,0,0.0,238.7
3790,323dc938d93a849b,1d00756835ca67c9,22a92d7f62195791,2019-06-08,0,0,0,600,1,1,185,43,185,0,0,0,0,0,33,25,152,43,0.0,593.0
3791,323dc938d93a849b,22a92d7f62195791,1d00756835ca67c9,2019-06-08,1,0,0,600,0,0,200,65,200,0,0,0,0,0,56,39,144,65,0.0,600.0
3792,17753b728e5404aa,6bd02119599741a4,cb696ebfb6598724,2019-06-08,0,0,0,900,0,0,265,44,265,0,0,0,0,0,106,61,159,44,0.0,895.0
3793,17753b728e5404aa,cb696ebfb6598724,6bd02119599741a4,2019-06-08,0,0,0,900,7,0,349,123,349,0,0,0,0,0,99,51,250,123,0.0,900.0
3794,fedb6a1b15b05694,2816ced060a21be3,764342d39cdaa54a,2019-06-01,0,0,0,596,3,1,79,20,79,0,0,0,0,0,27,17,52,20,0.0,575.0
3795,fedb6a1b15b05694,764342d39cdaa54a,2816ced060a21be3,2019-06-01,1,0,0,596,0,0,201,68,201,0,0,0,0,0,50,32,151,68,0.0,596.0
3796,f993be991eea6016,2eeaefbfc7f9fcff,b12a1d19ee383b7c,2019-06-01,0,0,0,900,2,1,68,45,14,54,0,0,54,42,6,5,8,3,403.3,249.0
3797,f993be991eea6016,b12a1d19ee383b7c,2eeaefbfc7f9fcff,2019-06-01,0,0,0,900,4,1,11,2,10,1,1,1,0,0,3,3,7,2,173.0,150.7
3798,e1bd72aba46f46a1,31a13532e724ca2b,9c65736747ca92ec,2019-06-01,0,0,0,137,0,0,11,0,11,0,0,0,0,0,3,2,8,0,0.0,137.0
3799,e1bd72aba46f46a1,9c65736747ca92ec,31a13532e724ca2b,2019-06-01,1,0,0,137,0,0,16,4,16,0,0,0,0,0,11,8,5,4,0.0,136.0
3800,c53cb796b4a4cdb8,6e0e977beb909837,fbf0537e420e698e,2019-06-01,0,1,0,900,3,1,63,13,62,1,0,0,1,1,10,8,52,12,0.8,754.8
3801,c53cb796b4a4cdb8,fbf0537e420e698e,6e0e977beb909837,2019-06-01,0,0,0,900,6,1,83,22,68,15,1,1,14,7,29,17,39,15,136.2,663.2
3802,b58972ad7dcf65e6,b60c980f79b87ce8,d6ead04919a894b1,2019-06-01,0,2,1,419,0,0,71,12,69,2,0,0,2,1,8,7,61,11,69.0,272.5
3803,b58972ad7dcf65e6,d6ead04919a894b1,b60c980f79b87ce8,2019-06-01,0,0,0,419,5,3,106,36,104,2,0,0,2,2,16,6,88,34,77.5,195.0
3804,a5acaa5f693529dd,38c626ca912c7bac,de45aaae23dfa392,2019-06-01,0,0,0,900,1,1,61,20,51,10,0,0,10,5,13,4,38,15,77.5,599.8
3805,a5acaa5f693529dd,de45aaae23dfa392,38c626ca912c7bac,2019-06-01,0,0,0,900,13,6,113,28,101,12,0,0,12,3,23,19,78,25,176.2,499.5
3806,a4e210bcdcc1bf5b,58bbef3770bb2dfc,c3f6db17cea09ca7,2019-06-01,1,0,0,442,0,0,41,16,24,17,0,0,17,13,9,3,15,3,16.1,163.0
3807,a4e210bcdcc1bf5b,c3f6db17cea09ca7,58bbef3770bb2dfc,2019-06-01,0,0,0,442,2,2,20,9,13,7,0,0,7,5,4,4,9,4,262.0,163.9
3808,a072481f307dc8aa,025f0b1b58fbad01,cc7040fe76f0ef91,2019-06-01,0,0,0,900,3,1,55,23,49,6,0,0,6,3,5,3,44,20,84.5,578.5
3809,a072481f307dc8aa,cc7040fe76f0ef91,025f0b1b58fbad01,2019-06-01,0,0,0,900,11,2,95,26,94,1,0,0,1,1,19,14,75,25,11.5,643.5
3810,93330422e1f2e0be,1fc64507a0cb38cf,90da09db03e41748,2019-06-01,0,0,0,900,5,2,100,30,100,0,0,0,0,0,9,9,91,30,0.0,700.0
3811,93330422e1f2e0be,90da09db03e41748,1fc64507a0cb38cf,2019-06-01,1,0,0,900,6,1,149,30,149,0,0,0,0,0,49,30,100,30,0.0,839.0
3812,4f9939af9a1d40a3,3c6976f8182d9527,d4c9dcd330403612,2019-06-01,0,0,0,1058,3,1,151,26,148,3,0,0,3,2,72,46,76,24,29.2,949.0
3813,4f9939af9a1d40a3,d4c9dcd330403612,3c6976f8182d9527,2019-06-01,0,1,1,1058,1,0,104,19,99,5,0,0,5,5,42,30,57,14,70.0,944.8
3814,2ca4a039c07acd38,87a1dc546b1c5caf,bebb4ae55ac2bf6f,2019-06-01,0,1,1,565,2,1,27,6,23,4,0,0,4,3,6,3,17,3,179.0,386.0
3815,2ca4a039c07acd38,bebb4ae55ac2bf6f,87a1dc546b1c5caf,2019-06-01,0,0,0,565,0,0,52,4,52,0,0,0,0,0,22,12,30,4,0.0,386.0
3816,138c8807fef52564,1e1dbd1cc5a7469e,333b9e5c723ac873,2019-06-01,0,0,0,47,0,0,3,1,3,0,0,0,0,0,1,1,2,1,0.0,47.0
3817,138c8807fef52564,333b9e5c723ac873,1e1dbd1cc5a7469e,2019-06-01,1,0,0,47,0,0,7,1,7,0,0,0,0,0,2,1,5,1,0.0,46.0
3818,f27e8d63f526d326,06f36cf4bd97ec77,e51e5cb722bd47a8,2019-05-18,1,0,0,219,0,0,35,11,32,3,0,0,3,2,1,0,31,9,1.7,215.0
3819,f27e8d63f526d326,e51e5cb722bd47a8,06f36cf4bd97ec77,2019-05-18,0,0,0,219,2,1,33,21,33,0,0,0,0,0,2,1,31,21,0.0,207.3
3820,d401522de73b7bee,6a2f7c151031653d,ee9ebceabfd16fa7,2019-05-18,0,1,1,1127,7,4,111,36,100,11,1,1,10,8,27,23,73,28,82.7,846.5
3821,d401522de73b7bee,ee9ebceabfd16fa7,6a2f7c151031653d,2019-05-18,0,0,0,1127,16,6,97,23,96,1,0,0,1,1,18,12,78,22,47.5,522.3
3822,9fb9af6599d67b1d,2e585c701f72fe55,52e76bb4b3e852f3,2019-05-18,0,0,0,900,1,1,67,26,38,29,3,3,26,18,16,10,22,8,227.2,387.6
3823,9fb9af6599d67b1d,52e76bb4b3e852f3,2e585c701f72fe55,2019-05-18,0,0,0,900,11,4,33,10,30,3,0,0,3,2,6,5,24,8,230.4,288.8
3824,65c1ca715dfdbe05,0052de90691d4a93,d2cd7a69cc55e7ed,2019-05-18,0,0,0,900,7,3,114,44,97,17,4,4,13,13,24,15,73,31,190.1,634.0
3825,65c1ca715dfdbe05,d2cd7a69cc55e7ed,0052de90691d4a93,2019-05-18,0,0,0,900,0,0,116,19,114,2,0,0,2,2,43,25,71,17,20.0,659.9
3826,5782666ca117fa5b,07225ba28ae309b6,6fb1ba67bef41b37,2019-05-18,1,1,0,431,0,0,59,23,51,8,0,0,8,8,21,15,30,15,31.0,314.0
3827,5782666ca117fa5b,6fb1ba67bef41b37,07225ba28ae309b6,2019-05-18,0,0,0,431,4,2,49,10,47,2,0,0,2,2,13,8,34,8,20.0,300.0
3828,4fe799b4fa1afb76,39d91e95949de3d9,a0e75f4a13eb73f1,2019-05-18,0,1,1,204,2,1,31,13,16,15,0,0,15,13,14,9,2,0,104.4,37.0
3829,4fe799b4fa1afb76,a0e75f4a13eb73f1,39d91e95949de3d9,2019-05-18,0,0,0,204,0,0,6,2,6,0,0,0,0,0,1,1,5,2,0.0,97.6
3830,476a6245b43f3119,5bf31a46becc1204,99bd51917728c25d,2019-05-18,0,0,0,447,0,0,41,10,41,0,0,0,0,0,11,10,30,10,0.0,365.6
3831,476a6245b43f3119,99bd51917728c25d,5bf31a46becc1204,2019-05-18,0,1,1,447,10,3,56,9,53,3,0,0,3,1,24,18,29,8,47.4,194.0
3832,35f80e003d16a439,4ba8d454f762005d,b27a1fcb56a3035a,2019-05-18,1,1,1,841,2,0,100,10,100,0,0,0,0,0,33,24,67,10,0.0,815.0
3833,35f80e003d16a439,b27a1fcb56a3035a,4ba8d454f762005d,2019-05-18,0,0,0,841,0,0,64,21,64,0,0,0,0,0,15,10,49,21,0.0,818.0
3834,1f5178fe56c5423f,4234f0097c83fa62,d4691518d012b9e7,2019-05-18,0,0,0,900,5,2,164,60,159,5,0,0,5,4,18,17,141,56,30.8,529.5
3835,1f5178fe56c5423f,d4691518d012b9e7,4234f0097c83fa62,2019-05-18,0,3,0,900,4,3,125,57,102,23,2,1,21,16,12,11,90,41,222.5,453.2
3836,115fa6f5f3e51bbb,1291edf2d566a71a,902ec2cc48c8ae8a,2019-05-18,1,0,0,709,1,1,160,61,159,1,0,0,1,1,18,13,141,60,2.6,696.0
3837,115fa6f5f3e51bbb,902ec2cc48c8ae8a,1291edf2d566a71a,2019-05-18,0,0,0,709,0,0,160,23,160,0,0,0,0,0,31,20,129,23,0.0,673.4
3838,083a6edd8bb21bc8,6d4b63c767106d3a,714e1e0681ddb703,2019-05-18,1,0,0,232,0,0,25,14,18,7,0,0,7,7,5,4,13,7,31.5,100.0
3839,083a6edd8bb21bc8,714e1e0681ddb703,6d4b63c767106d3a,2019-05-18,0,0,0,232,2,1,18,5,17,1,1,1,0,0,1,0,16,5,96.0,104.5
3840,04c9ebe419195f8b,595db60957de51d3,a6cba6bb66c1a8c9,2019-05-18,1,0,0,107,0,0,11,4,11,0,0,0,0,0,2,2,9,4,0.0,105.0
3841,04c9ebe419195f8b,a6cba6bb66c1a8c9,595db60957de51d3,2019-05-18,0,0,0,107,0,0,4,0,4,0,0,0,0,0,2,2,2,0,0.0,107.0
3842,031647c36d12788f,f046d724d2a84ac5,f1d64ae34e088832,2019-05-18,0,0,0,900,4,4,144,56,130,14,1,1,13,9,24,21,106,47,80.7,779.0
3843,031647c36d12788f,f1d64ae34e088832,f046d724d2a84ac5,2019-05-18,0,0,0,900,0,0,146,11,146,0,0,0,0,0,67,44,79,11,0.0,819.3
3844,e4bbec619aa04dea,36541f1e6c5d4955,5b2325cd70dbe2ea,2019-05-11,1,0,0,648,3,3,115,34,111,4,0,0,4,4,36,27,75,30,77.0,571.0
3845,e4bbec619aa04dea,5b2325cd70dbe2ea,36541f1e6c5d4955,2019-05-11,0,0,0,648,3,0,136,28,136,0,0,0,0,0,24,18,112,28,0.0,559.0
3846,a08dffad240dc3d4,13a0275fa13c4d26,1f454354805b6f75,2019-05-11,1,0,0,287,0,0,31,5,31,0,0,0,0,0,15,12,16,5,0.0,278.0
3847,a08dffad240dc3d4,1f454354805b6f75,13a0275fa13c4d26,2019-05-11,0,0,0,287,0,0,15,1,15,0,0,0,0,0,9,7,6,1,0.0,287.0
3848,8cf4836e2b43c241,578ef12674df1e6a,673ea7dcc786b1b3,2019-05-11,0,1,1,804,0,0,247,67,246,1,0,0,1,0,23,16,223,67,2.5,794.0
3849,8cf4836e2b43c241,673ea7dcc786b1b3,578ef12674df1e6a,2019-05-11,0,0,0,804,2,0,196,43,196,0,0,0,0,0,55,38,141,43,0.0,786.5
3850,7b53967f282a0d0a,d0f3959b4a9747e6,e1248941344b3288,2019-05-11,0,0,0,900,1,0,79,19,79,0,0,0,0,0,16,10,63,19,0.0,893.0
3851,7b53967f282a0d0a,e1248941344b3288,d0f3959b4a9747e6,2019-05-11,0,0,0,900,3,0,176,28,176,0,0,0,0,0,83,67,93,28,0.0,635.0
3852,707cb14717df5960,528b071cf3da7c56,b1e5bcaad32a3cac,2019-05-11,1,3,0,900,0,0,231,75,221,10,0,0,10,8,51,36,170,67,32.0,740.0
3853,707cb14717df5960,b1e5bcaad32a3cac,528b071cf3da7c56,2019-05-11,0,0,0,900,2,0,149,39,148,1,0,0,1,1,46,30,102,38,0.0,868.0
3854,413a4c217ee0193f,73e09f837f3b5ecc,a67f5afa8d6a1b80,2019-05-11,0,0,0,127,0,0,24,6,24,0,0,0,0,0,0,0,24,6,0.0,83.0
3855,413a4c217ee0193f,a67f5afa8d6a1b80,73e09f837f3b5ecc,2019-05-11,1,1,0,127,2,1,32,11,29,3,0,0,3,3,2,2,27,8,44.0,83.0
3856,3d941525f5c623e3,31ee470ef5dc8d7f,a12a8314adc1c1c9,2019-05-11,0,0,0,900,3,1,147,27,147,0,0,0,0,0,40,31,107,27,0.0,873.0
3857,3d941525f5c623e3,a12a8314adc1c1c9,31ee470ef5dc8d7f,2019-05-11,0,0,0,900,1,1,202,37,202,0,0,0,0,0,35,17,167,37,0.0,868.0
3858,2b038a467a89c73c,1bcaac2d99b90fce,d317a5e2b3f88c5f,2019-05-11,0,0,0,853,0,0,62,12,62,0,0,0,0,0,10,8,52,12,0.0,853.0
3859,2b038a467a89c73c,d317a5e2b3f88c5f,1bcaac2d99b90fce,2019-05-11,1,0,0,853,0,0,157,36,157,0,0,0,0,0,50,36,107,36,0.0,852.0
3860,1218cba28d4dce94,225def29ecfe0fc1,b9f28e7045fdfce7,2019-05-11,0,0,0,589,0,0,127,17,127,0,0,0,0,0,7,3,120,17,0.0,390.0
3861,1218cba28d4dce94,b9f28e7045fdfce7,225def29ecfe0fc1,2019-05-11,1,1,0,589,1,0,123,52,73,50,0,0,50,35,10,7,63,17,199.0,386.0
3862,0febad4c4a3d69fc,73c7cfa551289285,c47df9303d318c67,2019-05-11,0,0,0,900,0,0,177,56,177,0,0,0,0,0,13,8,164,56,0.0,900.0
3863,0febad4c4a3d69fc,c47df9303d318c67,73c7cfa551289285,2019-05-11,0,0,0,900,2,1,208,52,208,0,0,0,0,0,38,28,170,52,0.0,658.0
3864,07c00213ec388e07,47b63240018d5d86,6a1901c62ab3870f,2019-05-11,1,1,0,478,2,0,125,54,122,3,0,0,3,2,1,1,121,52,14.5,443.6
3865,07c00213ec388e07,6a1901c62ab3870f,47b63240018d5d86,2019-05-11,1,0,0,478,4,2,105,17,104,1,0,0,1,1,37,30,67,16,5.4,425.5
3866,017c090e9e8d2957,a7151778b3381036,d945aae53e3e54e6,2019-05-11,0,0,0,900,6,2,115,16,114,1,0,0,1,1,33,23,81,15,8.8,341.7
3867,017c090e9e8d2957,d945aae53e3e54e6,a7151778b3381036,2019-05-11,0,1,0,900,6,4,102,59,64,38,1,1,37,29,9,6,55,30,365.3,420.2
3868,feaf740e3ae53b7c,98d961097baaf308,d247691a6c0e9034,2019-05-04,0,0,0,900,0,0,268,82,268,0,0,0,0,0,60,52,208,82,0.0,871.5
3869,feaf740e3ae53b7c,d247691a6c0e9034,98d961097baaf308,2019-05-04,0,0,0,900,2,0,256,66,251,5,5,5,0,0,84,58,167,66,28.5,803.0
3870,e939acbd9894c686,03f982ca3735070c,e2f6b2769aaedd6c,2019-05-04,1,0,0,50,0,0,28,17,22,6,0,0,6,5,1,0,21,12,3.0,45.0
3871,e939acbd9894c686,e2f6b2769aaedd6c,03f982ca3735070c,2019-05-04,0,0,0,50,0,0,3,0,3,0,0,0,0,0,1,1,2,0,0.0,47.0
3872,e6b2d6d33968c66c,7b433309b0fd12aa,c03520b5c88ed6b4,2019-05-04,0,0,0,900,0,0,56,21,52,4,0,0,4,3,15,11,37,18,7.2,420.3
3873,e6b2d6d33968c66c,c03520b5c88ed6b4,7b433309b0fd12aa,2019-05-04,0,0,0,900,9,5,102,43,70,32,1,1,31,26,16,11,54,17,443.7,379.8
3874,c936527df280b8b4,24656ef4d605c96f,37098a6e6c27fb66,2019-05-04,0,0,0,900,5,1,82,14,82,0,0,0,0,0,20,14,62,14,0.0,862.0
3875,c936527df280b8b4,37098a6e6c27fb66,24656ef4d605c96f,2019-05-04,0,0,0,900,0,0,194,31,194,0,0,0,0,0,43,28,151,31,0.0,900.0
3876,ad59540382d5b7f6,34f88592c0ab7a54,b1a3e0aca758b322,2019-05-04,0,0,0,900,1,0,170,16,170,0,0,0,0,0,82,49,88,16,0.0,807.9
3877,ad59540382d5b7f6,b1a3e0aca758b322,34f88592c0ab7a54,2019-05-04,0,0,0,900,9,4,94,34,89,5,0,0,5,5,32,22,57,29,82.1,703.0
3878,a6cc776330194937,8e9eb3fc86db0f7d,fccf811c1e8b01c7,2019-05-04,0,0,0,900,1,0,130,55,125,5,2,2,3,3,14,12,111,52,0.6,780.0
3879,a6cc776330194937,fccf811c1e8b01c7,8e9eb3fc86db0f7d,2019-05-04,0,0,0,900,8,2,148,44,141,7,1,1,6,5,35,27,106,39,115.0,521.4
3880,a3731057c8775716,31f8081c7600da93,5b8ba8f5512893b1,2019-05-04,0,4,0,796,10,2,93,18,93,0,0,0,0,0,11,8,82,18,0.0,421.9
3881,a3731057c8775716,5b8ba8f5512893b1,31f8081c7600da93,2019-05-04,0,1,1,796,0,0,147,45,110,37,0,0,37,24,34,30,76,21,147.1,629.0
3882,73eff675e2aae30c,1d00756835ca67c9,59279a7c978f7da0,2019-05-04,2,0,0,1500,0,0,361,87,347,14,0,0,14,6,59,51,288,81,18.1,1478.0
3883,73eff675e2aae30c,59279a7c978f7da0,1d00756835ca67c9,2019-05-04,0,0,0,1500,5,0,223,49,223,0,0,0,0,0,58,41,165,49,0.0,1481.9
3884,3011439ecaf74180,539ed332b3078821,9cdd2da1a9104a0b,2019-05-04,0,1,0,442,3,1,11,9,1,10,0,0,10,8,0,0,1,1,226.0,19.0
3885,3011439ecaf74180,9cdd2da1a9104a0b,539ed332b3078821,2019-05-04,1,0,0,442,0,0,66,38,2,64,5,5,59,37,0,0,2,1,197.0,19.0
3886,16a05f3c4a765f65,56709e66f1c6008f,b8592b4a383696cd,2019-05-04,0,2,0,900,4,2,88,13,87,1,0,0,1,1,47,25,40,12,30.1,391.0
3887,16a05f3c4a765f65,b8592b4a383696cd,56709e66f1c6008f,2019-05-04,1,2,0,900,1,0,54,11,51,3,0,0,3,2,12,4,39,9,27.0,743.9
3888,0bc354fbb6e99ab6,7e511f8d842a109d,83b00f7597e5ac83,2019-05-04,0,0,0,900,2,2,62,32,58,4,0,0,4,4,9,9,49,28,50.9,579.7
3889,0bc354fbb6e99ab6,83b00f7597e5ac83,7e511f8d842a109d,2019-05-04,0,0,0,900,0,0,185,56,184,1,0,0,1,1,27,25,157,55,2.3,765.1
3890,003c84fc7c3fa028,49858bf46dabf6fb,873626e5547b5235,2019-05-04,0,0,0,900,0,0,201,32,199,2,0,0,2,1,76,58,123,31,3.0,897.0
3891,003c84fc7c3fa028,873626e5547b5235,49858bf46dabf6fb,2019-05-04,0,0,0,900,2,0,153,27,153,0,0,0,0,0,40,25,113,27,0.0,897.0
3892,f0ca713121289d24,0a1942069c9ad6b6,7a703c565ccaa18f,2019-04-27,0,1,0,1500,10,3,372,96,368,4,0,0,4,4,59,52,309,92,49.9,1086.6
3893,f0ca713121289d24,7a703c565ccaa18f,0a1942069c9ad6b6,2019-04-27,0,0,0,1500,3,0,175,65,174,1,0,0,1,1,34,25,140,64,1.4,1421.1
3894,f08ccad48500eb2b,7dda2cf308f24a02,d910665038efc639,2019-04-27,0,0,0,900,9,3,37,13,36,1,0,0,1,1,4,4,32,12,32.6,531.9
3895,f08ccad48500eb2b,d910665038efc639,7dda2cf308f24a02,2019-04-27,0,0,0,900,10,4,51,18,42,9,0,0,9,5,8,7,34,13,140.1,540.4
3896,c68e57c19c82d500,75afb06215a07341,85073dbd1be65ed9,2019-04-27,0,0,0,135,2,0,3,1,3,0,0,0,0,0,0,0,3,1,0.0,112.9
3897,c68e57c19c82d500,85073dbd1be65ed9,75afb06215a07341,2019-04-27,1,0,0,135,0,0,30,12,15,15,2,2,13,6,0,0,15,6,22.1,110.0
3898,c300085cc08357b5,411539901068522f,f0feeb2192937424,2019-04-27,0,0,0,900,3,0,289,40,289,0,0,0,0,0,46,17,243,40,0.0,876.7
3899,c300085cc08357b5,f0feeb2192937424,411539901068522f,2019-04-27,0,0,0,900,3,0,236,83,235,1,0,0,1,1,41,34,194,82,0.3,895.0
3900,c2bcdcc472228768,23024fdfc966410a,fb3e61720be4690c,2019-04-27,0,1,1,555,6,3,87,36,67,20,1,1,19,16,15,12,52,20,261.6,228.0
3901,c2bcdcc472228768,fb3e61720be4690c,23024fdfc966410a,2019-04-27,0,0,0,555,0,0,44,5,44,0,0,0,0,0,15,8,29,5,0.0,293.4
3902,bda97d9a44a89d52,7ff97850e8c32bda,cd13728ae1151f46,2019-04-27,0,1,1,517,7,0,57,24,49,8,0,0,8,5,6,6,43,19,25.7,443.9
3903,bda97d9a44a89d52,cd13728ae1151f46,7ff97850e8c32bda,2019-04-27,0,0,0,517,0,0,135,57,119,16,0,0,16,11,22,17,97,46,12.1,460.3
3904,bcb697c4317f0997,65f09bacd3957381,c268b2cfebccf652,2019-04-27,0,0,0,900,4,2,275,72,275,0,0,0,0,0,57,48,218,72,0.0,864.0
3905,bcb697c4317f0997,c268b2cfebccf652,65f09bacd3957381,2019-04-27,0,1,0,900,2,1,256,57,256,0,0,0,0,0,79,49,177,57,0.0,886.0
3906,80e68a6453e15ab9,484acc7b0f856ce9,8abac218746e04ca,2019-04-27,0,0,0,378,0,0,90,9,90,0,0,0,0,0,44,37,46,9,0.0,340.1
3907,80e68a6453e15ab9,8abac218746e04ca,484acc7b0f856ce9,2019-04-27,1,0,0,378,0,0,69,25,50,19,1,1,18,12,4,2,46,13,12.9,361.0
3908,7c13de66ce543d84,523fa774700d7d3f,e9213f53ddeca978,2019-04-27,1,0,0,900,8,0,228,28,227,1,0,0,1,1,62,37,165,27,12.0,840.0
3909,7c13de66ce543d84,e9213f53ddeca978,523fa774700d7d3f,2019-04-27,0,0,0,900,3,0,159,47,159,0,0,0,0,0,24,18,135,47,0.0,847.0
3910,721d870849de4a57,37c5366d18ed6c05,e7f51d9f9e9259e7,2019-04-27,0,0,0,900,4,2,85,41,62,23,3,3,20,16,9,9,53,25,487.4,320.1
3911,721d870849de4a57,e7f51d9f9e9259e7,37c5366d18ed6c05,2019-04-27,0,0,0,900,1,1,70,16,68,2,1,1,1,1,16,13,52,15,28.9,311.6
3912,3b6c18a966a2cea4,d1941565abf50b16,e45cfa47f504033a,2019-04-27,0,1,1,132,2,2,11,4,11,0,0,0,0,0,2,2,9,4,0.0,80.0
3913,3b6c18a966a2cea4,e45cfa47f504033a,d1941565abf50b16,2019-04-27,0,0,0,132,0,0,25,5,25,0,0,0,0,0,5,5,20,5,0.0,132.0
3914,3286d8406eff5c85,57b10fca4f9c9a7a,f2b6fdb20675b11c,2019-04-27,0,0,0,900,1,0,137,30,136,1,0,0,1,0,27,18,109,30,6.5,757.0
3915,3286d8406eff5c85,f2b6fdb20675b11c,57b10fca4f9c9a7a,2019-04-27,0,0,0,900,1,0,110,48,91,19,3,3,16,12,17,14,74,36,65.0,763.5
3916,3256d907f58af95e,3738e68d2261e60f,441eacbe20e0e80b,2019-04-27,0,0,0,900,0,0,175,31,175,0,0,0,0,0,49,44,126,31,0.0,874.0
3917,3256d907f58af95e,441eacbe20e0e80b,3738e68d2261e60f,2019-04-27,0,0,0,900,1,0,132,26,132,0,0,0,0,0,24,16,108,26,0.0,779.0
3918,e458ace6a440b738,4e06913c91da5200,70fa1c64a2c439ef,2019-04-20,0,0,0,900,4,4,69,37,25,44,4,3,40,32,9,3,16,5,576.0,311.0
3919,e458ace6a440b738,70fa1c64a2c439ef,4e06913c91da5200,2019-04-20,0,0,0,900,0,0,17,6,12,5,0,0,5,3,0,0,12,3,13.0,311.0
3920,d9a797f632686568,c3ded6f7155f9ea4,d06f8869449ba7bd,2019-04-20,0,0,0,490,3,1,19,3,14,5,0,0,5,3,5,5,9,0,168.1,139.2
3921,d9a797f632686568,d06f8869449ba7bd,c3ded6f7155f9ea4,2019-04-20,0,1,1,490,2,1,19,9,11,8,1,1,7,6,4,4,7,3,81.8,188.9
3922,a40c70d5a1a1be01,4498b382c65a7faa,d7338bcb141abd2c,2019-04-20,0,0,0,900,6,5,79,29,64,15,0,0,15,12,6,4,58,17,426.3,340.6
3923,a40c70d5a1a1be01,d7338bcb141abd2c,4498b382c65a7faa,2019-04-20,0,0,0,900,0,0,116,50,109,7,0,0,7,5,15,14,94,45,19.4,423.7
3924,75bc89630027c601,31d7446b184e3305,c814b4c899793af6,2019-04-20,1,0,0,86,0,0,12,7,6,6,0,0,6,6,3,3,3,1,3.0,83.0
3925,75bc89630027c601,c814b4c899793af6,31d7446b184e3305,2019-04-20,0,0,0,86,0,0,1,0,1,0,0,0,0,0,1,1,0,0,0.0,83.0
3926,56f984ac83fb34cc,0d65c432720accb9,af997f7611673880,2019-04-20,3,0,0,44,0,0,10,8,6,4,0,0,4,4,0,0,6,4,6.4,36.0
3927,56f984ac83fb34cc,af997f7611673880,0d65c432720accb9,2019-04-20,0,0,0,44,2,0,13,5,13,0,0,0,0,0,1,1,12,5,0.0,37.6
3928,470a3c1b89504258,98c23cb6da5b3352,b4ad3a06ee4d660c,2019-04-20,0,0,0,285,0,0,58,15,58,0,0,0,0,0,24,23,34,15,0.0,167.4
3929,470a3c1b89504258,b4ad3a06ee4d660c,98c23cb6da5b3352,2019-04-20,1,0,0,285,1,0,33,23,21,12,0,0,12,12,6,6,15,11,34.6,213.0
3930,2a2b00e9bfd089cc,ac29d508d78384c9,f14cf73e51b29254,2019-04-20,0,0,0,66,0,0,15,4,15,0,0,0,0,0,2,1,13,4,0.0,66.0
3931,2a2b00e9bfd089cc,f14cf73e51b29254,ac29d508d78384c9,2019-04-20,1,0,0,66,0,0,26,17,26,0,0,0,0,0,0,0,26,17,0.0,65.0
3932,23ba354e606df0ac,65ddc8a9ac4e8531,e70de1859b7ee78e,2019-04-20,0,0,0,900,1,0,81,18,77,4,0,0,4,4,18,11,59,14,8.0,847.4
3933,23ba354e606df0ac,e70de1859b7ee78e,65ddc8a9ac4e8531,2019-04-20,0,0,0,900,7,2,63,22,62,1,0,0,1,1,6,3,56,21,34.6,546.0
3934,1b4374c9d7e5139c,76e2870ffafbe38f,a68575214ecad140,2019-04-20,0,0,0,900,16,5,78,42,45,33,4,4,29,25,5,4,40,17,470.8,200.3
3935,1b4374c9d7e5139c,a68575214ecad140,76e2870ffafbe38f,2019-04-20,0,0,0,900,2,0,58,19,52,6,0,0,6,6,9,7,43,13,0.7,427.2
3936,103a7d8c4f17714b,275aca31f61ba28c,eae48ff31db420c2,2019-04-20,0,0,0,900,9,4,20,7,18,2,0,0,2,2,8,7,10,5,73.2,534.0
3937,103a7d8c4f17714b,eae48ff31db420c2,275aca31f61ba28c,2019-04-20,0,0,0,900,12,1,43,5,43,0,0,0,0,0,18,8,25,5,0.0,719.8
3938,0bc7e4852f75a06d,2f5cbecbbe18bac4,c9cf753cfdf77fc2,2019-04-20,1,0,0,495,3,0,87,24,87,0,0,0,0,0,15,12,72,24,0.0,495.0
3939,0bc7e4852f75a06d,c9cf753cfdf77fc2,2f5cbecbbe18bac4,2019-04-20,0,0,0,495,0,0,70,17,70,0,0,0,0,0,12,11,58,17,0.0,495.0
3940,e0d92694d8a2d38b,749f572d1d3161fb,cad24459b28592ca,2019-04-13,4,0,0,900,0,0,157,26,145,12,7,3,5,1,61,50,84,25,68.0,832.0
3941,e0d92694d8a2d38b,cad24459b28592ca,749f572d1d3161fb,2019-04-13,0,0,0,900,1,0,69,12,69,0,0,0,0,0,7,4,62,12,0.0,805.0
3942,d22c19fd92426567,1091d4d957141094,50db8711c70196cd,2019-04-13,0,2,1,450,2,1,44,15,40,4,0,0,4,4,17,12,23,11,47.7,176.3
3943,d22c19fd92426567,50db8711c70196cd,1091d4d957141094,2019-04-13,0,0,0,450,8,3,8,3,6,2,0,0,2,1,2,1,4,2,130.7,206.3
3944,c6b040021b4ceb0f,5aedf14771ca82d2,a0f0004aadf10b71,2019-04-13,0,0,0,178,4,1,6,0,6,0,0,0,0,0,2,1,4,0,0.0,118.0
3945,c6b040021b4ceb0f,a0f0004aadf10b71,5aedf14771ca82d2,2019-04-13,1,0,0,178,0,0,33,19,12,21,0,0,21,16,5,4,7,3,14.0,164.0
3946,bf719cf83cab229b,7f0f171414d0a287,b0d6a1d8ac3d563d,2019-04-13,0,0,0,900,1,0,150,46,150,0,0,0,0,0,30,18,120,46,0.0,651.6
3947,bf719cf83cab229b,b0d6a1d8ac3d563d,7f0f171414d0a287,2019-04-13,0,3,0,900,11,6,92,23,89,3,2,2,1,0,25,22,64,23,42.4,603.0
3948,9bfda7c26578aaac,1338e2c7480bdf9e,8c0580d4fff106c1,2019-04-13,4,2,0,1500,0,0,237,70,226,11,0,0,11,8,51,39,175,62,38.5,1458.0
3949,9bfda7c26578aaac,8c0580d4fff106c1,1338e2c7480bdf9e,2019-04-13,0,0,0,1500,9,1,220,68,220,0,0,0,0,0,29,23,191,68,0.0,1380.5
3950,8da5849a6e7307bf,cc1a8b4b38b92c6d,d0e50a3d1b250708,2019-04-13,0,0,0,900,4,3,107,38,92,15,9,9,6,6,20,17,72,32,240.0,436.0
3951,8da5849a6e7307bf,d0e50a3d1b250708,cc1a8b4b38b92c6d,2019-04-13,0,0,0,900,1,1,62,6,62,0,0,0,0,0,29,24,33,6,0.0,655.0
3952,87126427cfcaee52,029eaff01e6bb8f0,150ff4cc642270b9,2019-04-13,0,0,0,1500,8,1,381,153,381,0,0,0,0,0,32,25,349,153,0.0,1285.0
3953,87126427cfcaee52,150ff4cc642270b9,029eaff01e6bb8f0,2019-04-13,0,1,0,1500,0,0,446,141,446,0,0,0,0,0,52,40,394,141,0.0,1494.0
3954,7dc87736c304b3dd,8be158ca1e5ea6a0,cf65d56b0755ed3b,2019-04-13,0,0,0,900,0,0,122,13,122,0,0,0,0,0,34,25,88,13,0.0,881.5
3955,7dc87736c304b3dd,cf65d56b0755ed3b,8be158ca1e5ea6a0,2019-04-13,0,0,0,900,2,1,100,9,93,7,1,1,6,3,22,14,71,6,18.5,871.0
3956,79da0eacafb22f86,325ad0dd9126d3df,cc351e408bbb7d43,2019-04-13,0,0,0,372,0,0,101,37,101,0,0,0,0,0,12,9,89,37,0.0,335.0
3957,79da0eacafb22f86,cc351e408bbb7d43,325ad0dd9126d3df,2019-04-13,0,1,1,372,0,0,88,20,88,0,0,0,0,0,21,15,67,20,0.0,297.0
3958,75e580d5ea37c519,5c126c6aac3ef364,f923e012414c883e,2019-04-13,0,0,0,900,2,2,84,19,78,6,2,2,4,4,37,26,41,15,177.0,436.7
3959,75e580d5ea37c519,f923e012414c883e,5c126c6aac3ef364,2019-04-13,0,0,0,900,0,0,116,28,114,2,0,0,2,1,29,19,85,27,50.3,547.0
3960,31b283a5559ad44d,4d8fa64202cee4c1,dccb63727f2f5f74,2019-04-13,0,1,0,900,0,0,116,27,112,4,0,0,4,3,15,8,97,24,29.3,588.4
3961,31b283a5559ad44d,dccb63727f2f5f74,4d8fa64202cee4c1,2019-04-13,0,2,0,900,13,4,77,18,69,8,2,2,6,5,25,11,44,13,245.6,563.7
3962,2456c4550c26e5e8,98e946879ba20c0f,b4537562f88ac582,2019-04-13,0,0,0,25,0,0,0,0,0,0,0,0,0,0,0,0,0,0,0.0,23.0
3963,2456c4550c26e5e8,b4537562f88ac582,98e946879ba20c0f,2019-04-13,1,0,0,25,0,0,5,5,2,3,0,0,3,3,0,0,2,2,2.0,23.0
3964,23fd92555246d61e,b1b0729d27936f2f,f1928a52590c5532,2019-04-13,0,0,0,900,6,2,107,39,79,28,0,0,28,14,11,8,68,25,478.9,404.0
3965,23fd92555246d61e,f1928a52590c5532,b1b0729d27936f2f,2019-04-13,0,0,0,900,0,0,96,19,96,0,0,0,0,0,35,29,61,19,0.0,419.1
3966,f5a038c18f7a44fc,8f382b3baa954d2a,cd2c4d30c6e13b47,2019-03-30,0,1,0,900,1,0,114,23,113,1,0,0,1,1,38,27,75,22,2.6,763.2
3967,f5a038c18f7a44fc,cd2c4d30c6e13b47,8f382b3baa954d2a,2019-03-30,1,0,0,900,1,0,202,58,190,12,1,1,11,11,78,59,112,47,36.8,716.4
3968,b7ff74563d034519,4f732e58ed907eff,f046d724d2a84ac5,2019-03-30,0,0,0,172,1,0,24,1,24,0,0,0,0,0,18,11,6,1,0.0,164.5
3969,b7ff74563d034519,f046d724d2a84ac5,4f732e58ed907eff,2019-03-30,1,0,0,172,2,1,32,17,17,15,2,2,13,12,7,6,10,5,7.5,164.0
3970,b70e72f23446520a,d7c3816669784109,eb04b9d31e938edb,2019-03-30,0,0,0,900,0,0,118,16,116,2,2,2,0,0,55,39,61,16,7.3,791.5
3971,b70e72f23446520a,eb04b9d31e938edb,d7c3816669784109,2019-03-30,0,1,0,900,4,2,149,25,142,7,2,2,5,4,54,37,88,21,53.5,678.7
3972,b695fc80bd538172,70d2329a92864fdb,b4192a975027aab6,2019-03-30,0,0,0,900,0,0,144,21,143,1,1,1,0,0,56,42,87,21,0.0,714.9
3973,b695fc80bd538172,b4192a975027aab6,70d2329a92864fdb,2019-03-30,0,0,0,900,9,1,190,27,183,7,3,3,4,2,37,26,146,25,185.1,477.0
3974,b309cdde35310875,64a50dad704d1d49,9e8f6c728eb01124,2019-03-30,0,0,0,150,0,0,32,6,32,0,0,0,0,0,11,7,21,6,0.0,150.0
3975,b309cdde35310875,9e8f6c728eb01124,64a50dad704d1d49,2019-03-30,1,0,0,150,0,0,35,13,35,0,0,0,0,0,7,7,28,13,0.0,106.0
3976,a0163cdde4ec785d,0a1942069c9ad6b6,d2c55d1d2e67773b,2019-03-30,0,1,1,49,2,1,10,1,10,0,0,0,0,0,4,2,6,1,0.0,39.0
3977,a0163cdde4ec785d,d2c55d1d2e67773b,0a1942069c9ad6b6,2019-03-30,0,0,0,49,0,0,6,1,6,0,0,0,0,0,0,0,6,1,0.0,45.0
3978,93a081342561d0c3,a4de54ea806fb525,e7bba7ce4d6c7b07,2019-03-30,0,0,0,900,10,7,35,8,33,2,0,0,2,2,12,9,21,6,37.4,454.0
3979,93a081342561d0c3,e7bba7ce4d6c7b07,a4de54ea806fb525,2019-03-30,0,0,0,900,3,2,52,9,48,4,2,2,2,2,23,21,25,7,53.0,478.6
3980,818b55b087013e64,0d62719b1dcf7c40,94426bb170c88115,2019-03-30,0,0,0,900,0,0,118,21,118,0,0,0,0,0,48,33,70,21,0.0,761.2
3981,818b55b087013e64,94426bb170c88115,0d62719b1dcf7c40,2019-03-30,1,0,0,900,3,0,148,32,136,12,0,0,12,9,60,41,76,23,57.8,741.0
3982,7dc3ada8f2135477,3a46b268013afede,6ac9bc2953c47345,2019-03-30,0,2,0,900,2,1,43,19,20,23,0,0,23,17,8,8,12,2,241.5,525.3
3983,7dc3ada8f2135477,6ac9bc2953c47345,3a46b268013afede,2019-03-30,0,4,0,900,11,6,13,4,11,2,0,0,2,2,7,6,4,2,122.7,106.5
3984,6173056f0e080ca6,be0b310a12eb80b4,cf946e03ba2e7666,2019-03-30,0,0,0,900,8,0,126,28,126,0,0,0,0,0,30,24,96,28,0.0,870.0
3985,6173056f0e080ca6,cf946e03ba2e7666,be0b310a12eb80b4,2019-03-30,0,0,0,900,0,0,243,36,243,0,0,0,0,0,35,22,208,36,0.0,900.0
3986,5c70b175f08ca141,511e82663651438d,fba03cd6cc28dc41,2019-03-30,0,0,0,854,0,0,128,13,128,0,0,0,0,0,18,11,110,13,0.0,854.0
3987,5c70b175f08ca141,fba03cd6cc28dc41,511e82663651438d,2019-03-30,1,0,0,854,3,0,87,7,87,0,0,0,0,0,22,15,65,7,0.0,852.0
3988,3db15d45e8490c22,ab2b4ff41d6ebe0f,f57dd0bfa8c17813,2019-03-30,0,0,0,900,4,2,110,37,66,44,2,2,42,31,34,21,32,6,472.5,406.0
3989,3db15d45e8490c22,f57dd0bfa8c17813,ab2b4ff41d6ebe0f,2019-03-30,0,0,0,900,0,0,84,19,72,12,0,0,12,9,11,7,61,10,0.0,427.5
3990,1d8ee477e682a8fc,8667caa0451d245b,eabf206b162b3b83,2019-03-30,0,0,0,860,0,0,72,33,43,29,2,2,27,20,6,5,37,13,212.7,596.0
3991,1d8ee477e682a8fc,eabf206b162b3b83,8667caa0451d245b,2019-03-30,0,2,1,860,16,1,77,6,77,0,0,0,0,0,26,19,51,6,0.0,549.3
3992,eb096b0196a7ff65,aa72b0f831d0bfe5,b102c26727306ab6,2019-03-23,0,0,0,900,2,0,50,6,48,2,0,0,2,2,14,8,34,4,4.4,538.1
3993,eb096b0196a7ff65,b102c26727306ab6,aa72b0f831d0bfe5,2019-03-23,0,0,0,900,5,3,51,19,37,14,1,1,13,8,7,6,30,11,350.9,494.6
3994,ced0e31df74f27d6,25af5e832f17b474,c21a036b4e012f1c,2019-03-23,0,0,0,900,0,0,113,18,113,0,0,0,0,0,39,19,74,18,0.0,900.0
3995,ced0e31df74f27d6,c21a036b4e012f1c,25af5e832f17b474,2019-03-23,0,0,0,900,0,0,137,25,137,0,0,0,0,0,77,48,60,25,0.0,898.0
3996,971b3d35c302cf8f,7c7332319c14094c,9ba2226646046b63,2019-03-23,1,0,0,85,0,0,16,7,11,5,0,0,5,5,7,5,4,2,3.0,82.0
3997,971b3d35c302cf8f,9ba2226646046b63,7c7332319c14094c,2019-03-23,0,0,0,85,0,0,10,1,10,0,0,0,0,0,5,3,5,1,0.0,82.0
3998,9532ebf4d9405e65,ce1e867808ef5fce,fa6796c55d6c5440,2019-03-23,0,0,0,900,0,0,9,2,9,0,0,0,0,0,0,0,9,2,0.0,260.0
3999,9532ebf4d9405e65,fa6796c55d6c5440,ce1e867808ef5fce,2019-03-23,0,0,0,900,11,7,33,10,13,20,6,6,14,7,8,6,5,3,640.0,196.0
4000,8d70694ceeb0dc9a,4c2d90e335e6df19,8e1f36476ef02a6a,2019-03-23,0,0,0,900,2,1,122,16,121,1,1,1,0,0,67,55,54,16,11.2,585.0
4001,8d70694ceeb0dc9a,8e1f36476ef02a6a,4c2d90e335e6df19,2019-03-23,0,0,0,900,0,0,128,44,128,0,0,0,0,0,16,16,112,44,0.0,810.8
4002,721b23d896a44e2e,d76ad9a08c4408ff,d9c6f19f958643e9,2019-03-23,0,2,0,900,8,5,42,5,42,0,0,0,0,0,5,4,37,5,0.0,539.0
4003,721b23d896a44e2e,d9c6f19f958643e9,d76ad9a08c4408ff,2019-03-23,0,2,0,900,3,0,44,7,44,0,0,0,0,0,15,10,29,7,0.0,709.0
4004,56ae02578b1163ee,4a28cb716c19157a,cbb682f5fcc44bfc,2019-03-23,0,0,0,595,0,0,107,28,107,0,0,0,0,0,37,19,70,28,0.0,594.0
4005,56ae02578b1163ee,cbb682f5fcc44bfc,4a28cb716c19157a,2019-03-23,1,0,0,595,0,0,55,5,53,2,1,1,1,1,33,26,20,4,1.0,594.0
4006,55b53fdad307b708,6a740daf1b279661,6fd953151d981979,2019-03-23,1,0,0,481,0,0,110,34,110,0,0,0,0,0,27,21,83,34,0.0,471.9
4007,55b53fdad307b708,6fd953151d981979,6a740daf1b279661,2019-03-23,0,0,0,481,0,0,85,23,83,2,1,1,1,0,2,1,81,23,7.1,442.0
4008,469fba0129c95278,215a70f073a7b726,a0c64f272b65d441,2019-03-23,0,0,0,900,3,1,105,19,105,0,0,0,0,0,42,28,63,19,0.0,882.0
4009,469fba0129c95278,a0c64f272b65d441,215a70f073a7b726,2019-03-23,0,0,0,900,0,0,81,18,81,0,0,0,0,0,12,7,69,18,0.0,900.0
4010,3812b265afd78186,2844b047183a1adb,b93c06d09d1c4ac0,2019-03-23,0,0,0,900,3,1,112,43,107,5,0,0,5,4,10,9,97,39,49.7,612.0
4011,3812b265afd78186,b93c06d09d1c4ac0,2844b047183a1adb,2019-03-23,0,1,0,900,8,4,85,15,85,0,0,0,0,0,22,19,63,15,0.0,541.3
4012,0f9679fda36f7f41,4a57ebb14315b251,f0feeb2192937424,2019-03-23,0,1,1,264,1,1,26,9,18,8,0,0,8,8,5,4,13,1,105.8,92.0
4013,0f9679fda36f7f41,f0feeb2192937424,4a57ebb14315b251,2019-03-23,0,0,0,264,0,0,7,1,7,0,0,0,0,0,1,1,6,1,0.0,116.2
4014,0717bc30025f3656,35e1f9984ed64206,45f0cc9d18f35137,2019-03-23,0,0,0,900,3,0,75,4,75,0,0,0,0,0,19,11,56,4,0.0,853.0
4015,0717bc30025f3656,45f0cc9d18f35137,35e1f9984ed64206,2019-03-23,0,0,0,900,0,0,121,15,121,0,0,0,0,0,70,54,51,15,0.0,892.0
4016,e068f14acd47ed69,f1fac969a1d70b08,fd55393021a8c255,2019-03-16,1,0,0,900,3,2,49,17,35,14,1,1,13,10,18,13,17,7,88.7,691.0
4017,e068f14acd47ed69,fd55393021a8c255,f1fac969a1d70b08,2019-03-16,0,0,0,900,4,3,18,3,18,0,0,0,0,0,8,6,10,3,0.0,548.3
4018,c6dd17ab89437805,47b9e0e7703a4868,9ce6d5a03af801b7,2019-03-16,1,0,0,485,2,1,72,18,71,1,0,0,1,1,21,17,50,17,6.7,410.5
4019,c6dd17ab89437805,9ce6d5a03af801b7,47b9e0e7703a4868,2019-03-16,1,0,0,485,1,1,43,17,41,2,0,0,2,0,4,4,37,17,27.5,423.3
4020,bcef35d6e0964f01,82a5152216251682,f7d73e452b064bf2,2019-03-16,1,1,1,77,1,1,17,7,8,9,1,1,8,5,2,2,6,2,31.0,46.0
4021,bcef35d6e0964f01,f7d73e452b064bf2,82a5152216251682,2019-03-16,0,0,0,77,0,0,7,2,7,0,0,0,0,0,2,2,5,2,0.0,46.0
4022,a2f4acc81f7886a2,51018a31ddf31eb2,b1e5bcaad32a3cac,2019-03-16,0,2,0,900,11,2,197,81,190,7,0,0,7,5,30,26,160,76,18.5,826.0
4023,a2f4acc81f7886a2,b1e5bcaad32a3cac,51018a31ddf31eb2,2019-03-16,0,0,0,900,0,0,234,54,234,0,0,0,0,0,28,21,206,54,0.0,815.5
4024,9763e27bf80abe42,56fcb2c4d99f9d1b,776a58a67665a171,2019-03-16,1,0,0,582,3,1,56,32,51,5,0,0,5,4,2,1,49,28,19.7,519.0
4025,9763e27bf80abe42,776a58a67665a171,56fcb2c4d99f9d1b,2019-03-16,0,0,0,582,1,0,95,16,95,0,0,0,0,0,13,6,82,16,0.0,562.3
4026,8cc4c597aecbfef5,040a74bb0a465c54,c07efc18b231f170,2019-03-16,1,0,0,900,0,0,111,25,103,8,8,2,0,0,13,10,90,25,52.4,841.0
4027,8cc4c597aecbfef5,c07efc18b231f170,040a74bb0a465c54,2019-03-16,0,0,0,900,3,0,104,5,104,0,0,0,0,0,43,25,61,5,0.0,847.6
4028,8a8190f3f71408a4,6f7c616b98e18c29,a6cba6bb66c1a8c9,2019-03-16,0,4,1,757,5,3,38,10,27,11,1,1,10,6,9,8,18,4,341.9,207.1
4029,8a8190f3f71408a4,a6cba6bb66c1a8c9,6f7c616b98e18c29,2019-03-16,0,0,0,757,0,0,45,24,20,25,2,2,23,16,0,0,20,8,176.9,224.10000000000002
4030,826fb989c0e6208e,0845c81e37d3bcb3,2e19380f34871c6a,2019-03-16,0,0,0,900,7,1,99,24,98,1,0,0,1,0,18,11,80,24,11.6,807.0
4031,826fb989c0e6208e,2e19380f34871c6a,0845c81e37d3bcb3,2019-03-16,0,0,0,900,2,0,121,16,121,0,0,0,0,0,40,28,81,16,0.0,888.4
4032,6ada4f4286e4261d,88d7b6d8230e1f3f,8c57c7b8c3bab0eb,2019-03-16,0,0,0,900,5,3,86,60,30,56,4,4,52,46,8,6,22,14,582.6,255.0
4033,6ada4f4286e4261d,8c57c7b8c3bab0eb,88d7b6d8230e1f3f,2019-03-16,0,0,0,900,0,0,27,5,27,0,0,0,0,0,10,6,17,5,0.0,317.4
4034,44ab00737c3fb890,32c355b04fc57f3a,654ae722109a0d31,2019-03-16,1,0,0,900,4,3,106,19,103,3,0,0,3,2,50,44,53,17,66.8,615.5
4035,44ab00737c3fb890,654ae722109a0d31,32c355b04fc57f3a,2019-03-16,0,0,0,900,3,1,60,8,59,1,0,0,1,0,10,7,49,8,17.5,798.2
4036,437c6e18f41287f1,045f25b3a4c08e81,e9ac7bfb65c25497,2019-03-16,0,0,0,900,0,0,149,19,149,0,0,0,0,0,14,12,135,19,0.0,900.0
4037,437c6e18f41287f1,e9ac7bfb65c25497,045f25b3a4c08e81,2019-03-16,1,0,0,900,0,0,95,15,95,0,0,0,0,0,25,17,70,15,0.0,864.0
4038,40687c9412e0c279,329e403448756217,36549928f90f1d36,2019-03-16,0,2,1,466,3,2,81,14,81,0,0,0,0,0,28,16,53,14,0.0,394.0
4039,40687c9412e0c279,36549928f90f1d36,329e403448756217,2019-03-16,0,0,0,466,4,1,60,7,60,0,0,0,0,0,32,27,28,7,0.0,358.0
4040,fb34734f84d0a14d,3143bf892608139a,c7d297714d9ab1a4,2019-03-09,0,0,0,900,1,1,223,35,220,3,1,1,2,0,84,62,136,35,19.7,715.7
4041,fb34734f84d0a14d,c7d297714d9ab1a4,3143bf892608139a,2019-03-09,0,0,0,900,1,1,142,42,136,6,0,0,6,2,21,16,115,40,13.3,860.3
4042,ddcfa590f4644240,902ec2cc48c8ae8a,99bd51917728c25d,2019-03-09,0,1,0,900,0,0,85,37,72,13,0,0,13,11,18,12,54,26,9.6,413.4
4043,ddcfa590f4644240,99bd51917728c25d,902ec2cc48c8ae8a,2019-03-09,0,1,0,900,11,6,128,48,87,41,0,0,41,24,13,9,74,24,469.6,283.4
4044,b776b08e2cc6aa0c,068f8a189a47fea6,6a11e325aa60ad02,2019-03-09,0,0,0,900,0,0,161,42,161,0,0,0,0,0,47,28,114,42,0.0,881.0
4045,b776b08e2cc6aa0c,6a11e325aa60ad02,068f8a189a47fea6,2019-03-09,0,0,0,900,1,0,143,42,143,0,0,0,0,0,36,24,107,42,0.0,855.0
4046,aeb0322f619213b1,4b47e71384a9522f,d8da10db80131bec,2019-03-09,0,0,0,290,1,1,48,27,41,7,1,1,6,5,3,3,38,22,86.3,178.2
4047,aeb0322f619213b1,d8da10db80131bec,4b47e71384a9522f,2019-03-09,1,0,0,290,0,0,67,21,61,6,1,1,5,4,18,10,43,17,0.8,201.7
4048,aaad7e29825b3264,16690d100f995f8f,c80095f6092271a7,2019-03-09,0,0,0,900,2,0,135,32,135,0,0,0,0,0,25,20,110,32,0.0,706.0
4049,aaad7e29825b3264,c80095f6092271a7,16690d100f995f8f,2019-03-09,0,0,0,900,2,0,97,20,97,0,0,0,0,0,31,21,66,20,0.0,898.0
4050,9cfad21ef1911728,08af939f41b5a57b,519e4fe37ce9ff75,2019-03-09,0,1,1,581,5,2,65,22,53,12,0,0,12,10,18,15,35,12,146.3,264.0
4051,9cfad21ef1911728,519e4fe37ce9ff75,08af939f41b5a57b,2019-03-09,0,0,0,581,0,0,58,17,58,0,0,0,0,0,14,14,44,17,0.0,373.7
4052,858696528ab7035a,67c1d46f4ed16f9e,d2bc285ead803db0,2019-03-09,0,2,1,198,1,1,40,11,40,0,0,0,0,0,5,3,35,11,0.0,92.0
4053,858696528ab7035a,d2bc285ead803db0,67c1d46f4ed16f9e,2019-03-09,0,0,0,198,0,0,24,9,23,1,1,1,0,0,6,3,17,9,78.0,120.0
4054,710c7f8c7dc2af46,8adcbd525fab8d9b,f1928a52590c5532,2019-03-09,0,1,1,155,1,1,9,4,4,5,0,0,2,0,1,0,0,0,128.0,27.0
4055,710c7f8c7dc2af46,f1928a52590c5532,8adcbd525fab8d9b,2019-03-09,0,0,0,155,0,0,1,0,1,0,0,0,0,0,0,0,1,0,0.0,27.0
4056,6c9bf1d285cf5dd4,66e98b3bb5fc5250,c17041f1bb5768d8,2019-03-09,0,0,0,900,9,1,88,29,81,7,1,1,6,5,16,12,65,24,86.1,445.0
4057,6c9bf1d285cf5dd4,c17041f1bb5768d8,66e98b3bb5fc5250,2019-03-09,0,3,0,900,3,2,82,31,82,0,0,0,0,0,19,18,63,31,0.0,606.9
4058,583f2c3cd0e2385b,47cd337b86b1af92,cdb96af67d096b1e,2019-03-09,0,0,0,214,1,1,31,6,31,0,0,0,0,0,11,4,20,6,0.0,177.0
4059,583f2c3cd0e2385b,cdb96af67d096b1e,47cd337b86b1af92,2019-03-09,1,1,0,214,0,0,55,22,28,27,0,0,27,15,5,3,23,7,31.0,183.0
4060,51808d929c84b8ae,1bcaac2d99b90fce,5331b25a60417ffb,2019-03-09,0,0,0,900,3,3,83,13,82,1,0,0,1,0,8,6,74,13,87.0,813.0
4061,51808d929c84b8ae,5331b25a60417ffb,1bcaac2d99b90fce,2019-03-09,0,0,0,900,0,0,152,29,152,0,0,0,0,0,29,21,123,29,0.0,681.0
4062,4b1606ab1893c242,1788eee370f077b7,bd58d34e39b7b12a,2019-03-09,0,0,0,900,0,0,178,50,178,0,0,0,0,0,22,22,156,50,0.0,900.0
4063,4b1606ab1893c242,bd58d34e39b7b12a,1788eee370f077b7,2019-03-09,0,0,0,900,0,0,163,47,163,0,0,0,0,0,28,23,135,47,0.0,900.0
4064,1b1792afe4457e83,63def5a5662a6917,d3df1add9d9a7efb,2019-03-09,1,0,0,418,0,0,55,15,46,9,0,0,9,3,18,14,28,12,5.0,405.0
4065,1b1792afe4457e83,d3df1add9d9a7efb,63def5a5662a6917,2019-03-09,0,0,0,418,0,0,25,2,24,1,0,0,1,0,8,5,16,2,2.0,411.0
4066,ec149b086b0e7fac,1ebe20ebbfa15e29,31ef8b67e13495b3,2019-03-02,0,0,0,900,8,2,142,29,125,17,0,0,17,14,66,34,59,15,190.4,577.5
4067,ec149b086b0e7fac,31ef8b67e13495b3,1ebe20ebbfa15e29,2019-03-02,0,0,0,900,1,0,62,14,57,5,0,0,5,3,21,16,36,11,42.5,641.6
4068,e3826e06d68ed4af,82e7929bf6c2b689,9e50097a89442158,2019-03-02,1,0,0,553,4,4,87,37,39,48,12,10,36,29,12,9,27,8,290.4,189.7
4069,e3826e06d68ed4af,9e50097a89442158,82e7929bf6c2b689,2019-03-02,0,0,0,553,0,0,65,19,58,7,0,0,7,6,6,4,52,13,6.3,243.60000000000002
4070,bac3ac8d7330d05d,18968f97ad34f15c,87aa9fb63d6b51a1,2019-03-02,0,0,0,900,0,0,121,20,121,0,0,0,0,0,29,21,92,20,0.0,755.1
4071,bac3ac8d7330d05d,87aa9fb63d6b51a1,18968f97ad34f15c,2019-03-02,0,0,0,900,8,3,129,43,118,11,1,1,10,8,33,26,85,35,143.9,743.0
4072,97dabff880f33202,0b31f87be71ebbb1,f2925e6db404bf1d,2019-03-02,0,1,1,200,2,1,1,0,1,0,0,0,0,0,0,0,1,0,0.0,59.0
4073,97dabff880f33202,f2925e6db404bf1d,0b31f87be71ebbb1,2019-03-02,0,0,0,200,1,1,29,21,11,18,0,0,18,16,5,5,6,5,22.0,167.0
4074,8adc6266a7c2fd40,016a8d958883167c,9cdd2da1a9104a0b,2019-03-02,0,0,0,109,0,0,25,6,25,0,0,0,0,0,9,8,16,6,0.0,92.1
4075,8adc6266a7c2fd40,9cdd2da1a9104a0b,016a8d958883167c,2019-03-02,1,0,0,109,0,0,49,15,44,5,0,0,5,4,12,10,32,11,16.9,82.0
4076,851645c373f50e16,effd9de9937996f8,f1b2aa7853d1ed6e,2019-03-02,0,0,0,1500,1,0,51,12,51,0,0,0,0,0,23,22,28,12,0.0,1147.7
4077,851645c373f50e16,f1b2aa7853d1ed6e,effd9de9937996f8,2019-03-02,0,0,0,1500,6,2,194,56,155,39,14,14,25,22,76,71,79,34,352.3,407.0
4078,7adaf85915993137,67f272324a030d00,c21f26bbde777573,2019-03-02,0,0,0,36,0,0,2,0,2,0,0,0,0,0,1,1,1,0,0.0,32.0
4079,7adaf85915993137,c21f26bbde777573,67f272324a030d00,2019-03-02,1,0,0,36,0,0,8,4,2,6,0,0,6,3,0,0,2,1,4.0,32.0
4080,7a26c9407ef64e10,4144798612ef96e5,76ee3d666c648f6b,2019-03-02,1,0,0,38,0,0,21,13,17,4,0,0,4,2,1,0,16,11,0.7,36.0
4081,7a26c9407ef64e10,76ee3d666c648f6b,4144798612ef96e5,2019-03-02,0,0,0,38,1,0,6,0,6,0,0,0,0,0,1,1,5,0,0.0,34.3
4082,5b9f545890407976,07f72a2a7591b409,d4c9dcd330403612,2019-03-02,0,0,0,1500,8,3,167,45,136,31,11,11,20,19,76,69,60,26,371.5,721.0
4083,5b9f545890407976,d4c9dcd330403612,07f72a2a7591b409,2019-03-02,0,0,0,1500,0,0,66,15,66,0,0,0,0,0,26,21,40,15,0.0,1128.5
4084,39fa341fb9161d6f,6bd02119599741a4,d8c7c61b176e3994,2019-03-02,1,0,0,292,1,0,47,16,40,7,0,0,7,6,11,9,29,10,16.3,267.0
4085,39fa341fb9161d6f,d8c7c61b176e3994,6bd02119599741a4,2019-03-02,0,0,0,292,0,0,60,19,59,1,0,0,1,1,10,2,49,18,4.0,271.7
4086,3744d4cdaa6b242b,80daefbed11ce998,bf7ad5628363eec9,2019-03-02,0,0,0,900,2,1,121,17,116,5,3,3,2,2,31,21,85,15,11.2,871.0
4087,3744d4cdaa6b242b,bf7ad5628363eec9,80daefbed11ce998,2019-03-02,0,0,0,900,8,0,121,21,121,0,0,0,0,0,44,27,77,21,0.0,806.8
4088,0405e4446e8f239a,2244d9a2b64b8c3b,9673a497a9da119a,2019-03-02,1,0,0,900,0,0,155,21,146,9,6,3,3,2,66,43,80,19,147.2,622.0
4089,0405e4446e8f239a,9673a497a9da119a,2244d9a2b64b8c3b,2019-03-02,0,0,0,900,0,0,174,29,170,4,0,0,4,4,60,48,110,25,0.0,752.8
4090,fd438db3e60f062a,198994b47f395af0,8be158ca1e5ea6a0,2019-02-23,0,0,0,299,5,1,45,7,45,0,0,0,0,0,13,10,32,7,0.0,276.7
4091,fd438db3e60f062a,8be158ca1e5ea6a0,198994b47f395af0,2019-02-23,1,0,0,299,0,0,53,14,47,6,0,0,6,6,6,6,41,8,3.3,294.0
4092,e4b13f7f43018ec0,135d124172a0bea3,58bbef3770bb2dfc,2019-02-23,0,0,0,900,0,0,150,25,150,0,0,0,0,0,65,39,85,25,0.0,900.0
4093,e4b13f7f43018ec0,58bbef3770bb2dfc,135d124172a0bea3,2019-02-23,0,0,0,900,0,0,127,26,127,0,0,0,0,0,20,12,107,26,0.0,900.0
4094,cb010b41cd20a1ed,99df7d0a2a08a8a8,dea070ed4a2a8281,2019-02-23,0,0,0,639,1,0,53,7,53,0,0,0,0,0,22,13,31,7,0.0,626.4
4095,cb010b41cd20a1ed,dea070ed4a2a8281,99df7d0a2a08a8a8,2019-02-23,1,0,0,639,1,1,104,21,83,21,3,2,18,11,43,29,40,10,7.6,631.0
4096,c827f5212a34bf2e,bebb4ae55ac2bf6f,fbf0537e420e698e,2019-02-23,0,2,1,370,10,5,32,13,26,6,0,0,6,2,1,1,25,11,102.0,117.0
4097,c827f5212a34bf2e,fbf0537e420e698e,bebb4ae55ac2bf6f,2019-02-23,0,0,0,370,1,1,33,14,22,11,1,1,10,8,3,2,19,6,66.0,190.0
4098,c77486266b05f934,6a96ad1bc34fb113,e51fcd9cd84c0b93,2019-02-23,0,1,0,900,1,0,103,36,77,26,6,5,20,16,27,22,50,20,180.4,383.8
4099,c77486266b05f934,e51fcd9cd84c0b93,6a96ad1bc34fb113,2019-02-23,0,0,0,900,13,3,35,11,31,4,0,0,4,3,6,4,25,8,287.2,360.6
4100,9af62d6e404c1002,9b7694d064a8a0ad,f53d4f21d1b5f2dc,2019-02-23,0,0,0,900,12,3,147,32,144,3,1,1,2,0,20,10,124,32,14.3,834.8
4101,9af62d6e404c1002,f53d4f21d1b5f2dc,9b7694d064a8a0ad,2019-02-23,0,1,0,900,0,0,284,55,279,5,0,0,5,4,47,28,232,51,3.2,872.7
4102,4e22e3cdb8757be1,38c7f72747f4f712,4798e823ada58fe9,2019-02-23,0,1,1,507,4,2,8,5,7,1,0,0,1,1,1,0,6,4,267.0,143.8
4103,4e22e3cdb8757be1,4798e823ada58fe9,38c7f72747f4f712,2019-02-23,0,0,0,507,1,1,41,21,27,14,0,0,14,13,3,2,24,8,96.2,130.0
4104,4de28817db9fc9d8,ab943cd2c3c17825,ebc1f40e00e0c481,2019-02-23,1,0,0,441,0,0,32,18,6,26,7,7,19,17,0,0,6,1,316.0,125.0
4105,4de28817db9fc9d8,ebc1f40e00e0c481,ab943cd2c3c17825,2019-02-23,0,1,1,441,1,1,3,0,3,0,0,0,0,0,1,0,2,0,0.0,15.0
4106,34c649f3f43a919b,0d65c432720accb9,fcd448a2fe1a23cc,2019-02-23,1,0,0,94,0,0,22,10,19,3,0,0,3,1,4,4,15,9,2.0,92.0
4107,34c649f3f43a919b,fcd448a2fe1a23cc,0d65c432720accb9,2019-02-23,0,0,0,94,0,0,20,6,20,0,0,0,0,0,8,3,12,6,0.0,92.0
4108,244aa8f002274344,99506df1af6c8b3b,d661ce4da776fc20,2019-02-23,1,0,0,900,8,2,81,18,80,1,0,0,1,1,16,12,64,17,4.6,846.0
4109,244aa8f002274344,d661ce4da776fc20,99506df1af6c8b3b,2019-02-23,0,0,0,900,5,2,155,61,151,4,0,0,4,4,24,19,127,57,17.0,806.4
4110,1db00b3e736c22bf,3cf66c62d9069f43,51a0c09cbe9b8472,2019-02-23,0,2,0,900,1,0,105,13,85,20,12,12,8,4,16,8,69,9,65.0,607.2
4111,1db00b3e736c22bf,51a0c09cbe9b8472,3cf66c62d9069f43,2019-02-23,0,2,0,900,3,3,29,3,26,3,1,1,2,2,16,10,10,1,214.8,477.0
4112,18d6df67968bf06b,38c626ca912c7bac,edd02825c29028fe,2019-02-23,1,0,0,423,3,2,109,48,71,38,0,0,38,26,11,10,60,22,132.0,284.0
4113,18d6df67968bf06b,edd02825c29028fe,38c626ca912c7bac,2019-02-23,0,0,0,423,0,0,107,13,107,0,0,0,0,0,19,11,88,13,0.0,291.0
4114,14c505d7ad55883c,7279654c7674cd24,d802174b0c0c1f4e,2019-02-23,0,0,0,900,5,0,62,10,62,0,0,0,0,0,21,13,41,10,0.0,719.8
4115,14c505d7ad55883c,d802174b0c0c1f4e,7279654c7674cd24,2019-02-23,1,0,0,900,3,1,67,22,60,7,0,0,7,6,12,8,48,16,152.2,552.0
4116,f96f719ad667dd96,6fb1ba67bef41b37,df1eb4354d18a906,2019-02-17,0,1,0,900,19,5,122,39,122,0,0,0,0,0,34,32,88,39,0.0,485.1
4117,f96f719ad667dd96,df1eb4354d18a906,6fb1ba67bef41b37,2019-02-17,0,0,0,900,0,0,122,39,115,7,0,0,7,7,23,15,92,32,7.9,883.0
4118,c8bc7e668ffffc7c,242d36d241b43c12,7aa3d6964eff4877,2019-02-17,0,1,1,126,2,1,10,1,10,0,0,0,0,0,4,1,6,1,0.0,52.0
4119,c8bc7e668ffffc7c,7aa3d6964eff4877,242d36d241b43c12,2019-02-17,0,0,0,126,0,0,14,3,14,0,0,0,0,0,1,1,13,3,0.0,126.0
4120,bdeca00572419011,05fa626cb33d15b8,fc6e681bf6658faf,2019-02-17,0,0,0,900,2,0,209,47,207,2,0,0,2,2,77,64,130,45,8.9,808.5
4121,bdeca00572419011,fc6e681bf6658faf,05fa626cb33d15b8,2019-02-17,0,0,0,900,10,2,225,38,223,2,0,0,2,2,47,28,176,36,6.5,855.1
4122,a9184def876faec6,b3d21b2610dcfaeb,e76d9f656ceb82ab,2019-02-17,0,1,1,61,1,1,5,2,5,0,0,0,0,0,1,1,4,2,0.0,10.0
4123,a9184def876faec6,e76d9f656ceb82ab,b3d21b2610dcfaeb,2019-02-17,0,0,0,61,0,0,5,2,5,0,0,0,0,0,0,0,5,2,0.0,61.0
4124,a212e4c197983ad1,6256b2b1562cb8e1,e5010b1b94ca5755,2019-02-17,0,0,0,900,0,0,121,24,121,0,0,0,0,0,46,37,75,24,0.0,766.0
4125,a212e4c197983ad1,e5010b1b94ca5755,6256b2b1562cb8e1,2019-02-17,0,0,0,900,0,0,119,31,119,0,0,0,0,0,40,24,79,31,0.0,827.0
4126,7fec3b1ec923ad24,2c99576fefe53c7c,96428b9e9bd048ea,2019-02-17,0,0,0,361,0,0,78,10,78,0,0,0,0,0,45,30,33,10,0.0,350.8
4127,7fec3b1ec923ad24,96428b9e9bd048ea,2c99576fefe53c7c,2019-02-17,1,0,0,361,1,0,75,26,72,3,0,0,3,3,17,13,55,23,10.2,344.0
4128,58e21d505c082a9e,9c907996820d2d69,cb696ebfb6598724,2019-02-17,0,0,0,900,0,0,84,8,84,0,0,0,0,0,25,16,59,8,0.0,724.5
4129,58e21d505c082a9e,cb696ebfb6598724,9c907996820d2d69,2019-02-17,0,0,0,900,7,0,176,36,175,1,0,0,1,1,80,65,95,35,5.5,735.0
4130,354425c41008a01f,5f179af5fffeb9f6,98215d037be5bcb7,2019-02-17,0,0,0,900,0,0,176,41,176,0,0,0,0,0,40,32,136,41,0.0,900.0
4131,354425c41008a01f,98215d037be5bcb7,5f179af5fffeb9f6,2019-02-17,0,0,0,900,6,0,192,41,192,0,0,0,0,0,53,41,139,41,0.0,842.0
4132,1521f94cafdfd783,6d4b63c767106d3a,a331233f597090a5,2019-02-17,1,2,0,894,0,0,241,132,233,8,0,0,8,7,32,31,201,125,13.1,840.1
4133,1521f94cafdfd783,a331233f597090a5,6d4b63c767106d3a,2019-02-17,1,0,0,894,1,0,355,146,340,15,0,0,15,8,31,23,309,138,12.9,849.9
4134,0d698108c5f5d1d6,2dc1bc1a02961656,773f7feacf96153e,2019-02-17,0,1,1,189,1,1,10,3,5,5,3,3,2,1,1,1,4,2,76.7,97.0
4135,0d698108c5f5d1d6,773f7feacf96153e,2dc1bc1a02961656,2019-02-17,0,0,0,189,0,0,12,3,12,0,0,0,0,0,4,4,8,3,0.0,53.3
4136,0a4247ba4ae1cca5,08e908ed6d18d6a0,8fd808923cffff82,2019-02-17,1,0,0,900,0,0,143,47,134,9,1,0,8,4,32,29,102,43,50.0,850.0
4137,0a4247ba4ae1cca5,8fd808923cffff82,08e908ed6d18d6a0,2019-02-17,0,0,0,900,0,0,226,65,226,0,0,0,0,0,47,33,179,65,0.0,850.0
4138,01983cba42704c49,0ff11cc094e887bc,8d03ce87ca14e778,2019-02-17,0,0,0,26,1,0,3,0,3,0,0,0,0,0,2,1,1,0,0.0,24.0
4139,01983cba42704c49,8d03ce87ca14e778,0ff11cc094e887bc,2019-02-17,1,0,0,26,0,0,10,6,7,3,0,0,3,2,0,0,7,4,0.0,26.0
4140,fd1854062406d287,6e7506127408aa9e,80d8aed0ca9b00f3,2019-02-09,0,0,0,457,0,0,7,1,5,2,0,0,2,1,4,4,1,0,33.3,25.0
4141,fd1854062406d287,80d8aed0ca9b00f3,6e7506127408aa9e,2019-02-09,0,3,1,457,3,2,35,20,19,16,0,0,16,14,1,1,18,6,382.0,41.7
4142,e4862c4f20117cb8,70e1f8a821b72c8b,d156513a19acf856,2019-02-09,1,0,0,169,0,0,32,7,23,9,0,0,9,5,9,7,14,2,8.0,161.0
4143,e4862c4f20117cb8,d156513a19acf856,70e1f8a821b72c8b,2019-02-09,0,0,0,169,1,0,14,3,14,0,0,0,0,0,0,0,14,3,0.0,161.0
4144,b247a1900cfae052,88cd34d836b4ebcd,a7897d200692ab64,2019-02-09,1,0,0,239,0,0,47,12,45,2,0,0,2,0,11,5,34,12,2.0,227.0
4145,b247a1900cfae052,a7897d200692ab64,88cd34d836b4ebcd,2019-02-09,1,1,1,239,1,1,58,19,58,0,0,0,0,0,12,7,46,19,0.0,163.0
4146,aa71cf96ba4e5a36,72e5e5a6edfa8223,f9b200db02b488d9,2019-02-09,0,0,0,295,0,0,9,2,7,2,0,0,2,2,2,1,5,0,0.0,80.0
4147,aa71cf96ba4e5a36,f9b200db02b488d9,72e5e5a6edfa8223,2019-02-09,0,1,1,295,1,1,40,18,4,36,1,0,35,18,2,2,2,0,215.0,80.0
4148,8e43d61ca6f2d904,2296125b6c362355,f2477cf43c4975cc,2019-02-09,0,1,0,900,6,3,31,8,24,7,1,1,6,4,11,8,13,4,238.0,272.1
4149,8e43d61ca6f2d904,f2477cf43c4975cc,2296125b6c362355,2019-02-09,0,0,0,900,2,1,87,27,51,36,5,5,31,20,27,15,24,7,389.9,218.0
4150,5ff8463edf8155c0,207773daeb4afa7b,98a6b2361045898f,2019-02-09,1,0,0,233,0,0,43,14,38,5,0,0,5,4,9,5,29,10,2.0,231.0
4151,5ff8463edf8155c0,98a6b2361045898f,207773daeb4afa7b,2019-02-09,0,0,0,233,0,0,9,0,9,0,0,0,0,0,5,1,4,0,0.0,231.0
4152,51db35a3cf225bda,82b4e942781b1046,853eb0dd5c0e2149,2019-02-09,0,1,0,900,4,0,184,36,174,10,5,3,5,2,39,28,135,34,71.4,790.0
4153,51db35a3cf225bda,853eb0dd5c0e2149,82b4e942781b1046,2019-02-09,0,0,0,900,7,2,168,33,166,2,0,0,2,2,34,25,132,31,10.0,808.6
4154,4eb91cfc892a108e,1338e2c7480bdf9e,1f454354805b6f75,2019-02-09,0,0,0,900,0,0,132,27,132,0,0,0,0,0,53,38,79,27,0.0,900.0
4155,4eb91cfc892a108e,1f454354805b6f75,1338e2c7480bdf9e,2019-02-09,0,0,0,900,0,0,72,16,72,0,0,0,0,0,23,15,49,16,0.0,900.0
4156,49f7186e1e3cf6c8,4cd8b03aee1d0138,bf0e700106d00e55,2019-02-09,1,0,0,900,2,0,308,69,308,0,0,0,0,0,71,51,237,69,0.0,884.0
4157,49f7186e1e3cf6c8,bf0e700106d00e55,4cd8b03aee1d0138,2019-02-09,0,0,0,900,0,0,209,72,209,0,0,0,0,0,8,5,201,72,0.0,900.0
4158,11c0ef97497303ef,4d8fa64202cee4c1,8fc9ae9c7527dfcb,2019-02-09,1,0,0,53,0,0,17,6,13,4,0,0,4,3,3,3,10,3,10.4,40.0
4159,11c0ef97497303ef,8fc9ae9c7527dfcb,4d8fa64202cee4c1,2019-02-09,0,0,0,53,1,0,4,1,4,0,0,0,0,0,2,2,2,1,0.0,42.6
4160,069e3e704cbf6337,5987b2458f4b5290,94527830000ab715,2019-02-09,2,0,0,900,5,4,137,40,114,23,4,3,19,13,17,11,97,27,230.0,670.0
4161,069e3e704cbf6337,94527830000ab715,5987b2458f4b5290,2019-02-09,0,0,0,900,9,0,186,29,186,0,0,0,0,0,27,18,159,29,0.0,670.0
4162,ebb685a81f65ce1b,093e1f5bb73850be,2ac4628c08ec5125,2019-02-02,0,0,0,367,0,0,35,15,35,0,0,0,0,0,3,2,32,15,0.0,329.0
4163,ebb685a81f65ce1b,2ac4628c08ec5125,093e1f5bb73850be,2019-02-02,0,1,1,367,7,1,32,9,32,0,0,0,0,0,8,7,24,9,0.0,208.0
4164,ce246b336b6bd638,427b5953ac8e3a27,4e0692ad070976e4,2019-02-02,0,2,1,158,4,2,1,0,1,0,0,0,0,0,0,0,1,0,0.0,27.0
4165,ce246b336b6bd638,4e0692ad070976e4,427b5953ac8e3a27,2019-02-02,0,0,0,158,0,0,2,0,2,0,0,0,0,0,0,0,2,0,0.0,158.0
4166,9192053a3884aadf,0fd5f4b838e890cc,1ae8f3c723aacff4,2019-02-02,1,0,0,148,0,0,24,6,24,0,0,0,0,0,11,11,13,6,0.0,143.0
4167,9192053a3884aadf,1ae8f3c723aacff4,0fd5f4b838e890cc,2019-02-02,0,0,0,148,0,0,8,1,8,0,0,0,0,0,3,1,5,1,0.0,148.0
4168,904e0e46392dff93,82cbb809d5ee565c,f7467152fd9f18a2,2019-02-02,0,0,0,900,5,2,83,14,71,12,0,0,12,9,19,15,52,5,203.4,544.0
4169,904e0e46392dff93,f7467152fd9f18a2,82cbb809d5ee565c,2019-02-02,0,2,0,900,1,1,100,17,100,0,0,0,0,0,31,19,69,17,0.0,531.6
4170,8f8a6c578308d014,07a2bdaa0afdd831,87f19d19f4cb73f8,2019-02-02,0,2,0,900,3,1,77,27,76,1,0,0,1,1,15,13,61,26,25.4,694.8
4171,8f8a6c578308d014,87f19d19f4cb73f8,07a2bdaa0afdd831,2019-02-02,0,0,0,900,8,4,98,21,94,4,1,1,3,2,40,36,54,19,27.2,738.6
4172,85036b967403cdab,07225ba28ae309b6,2747c60e42d9d75f,2019-02-02,0,1,1,355,1,1,58,21,58,0,0,0,0,0,16,7,42,21,0.0,307.0
4173,85036b967403cdab,2747c60e42d9d75f,07225ba28ae309b6,2019-02-02,1,0,0,355,0,0,53,16,47,6,1,0,5,3,12,10,35,13,35.0,320.0
4174,818456a713fdabe6,9cfbfae5fa1fdd93,dbac0a413af64bbe,2019-02-02,0,0,0,900,9,6,76,31,72,4,0,0,4,3,22,18,50,28,79.2,441.0
4175,818456a713fdabe6,dbac0a413af64bbe,9cfbfae5fa1fdd93,2019-02-02,0,0,0,900,8,3,51,11,48,3,0,0,3,1,15,10,33,10,63.0,568.8
4176,59097097bc09cdef,31ee470ef5dc8d7f,b0d6a1d8ac3d563d,2019-02-02,0,0,0,900,1,0,135,45,135,0,0,0,0,0,45,38,90,45,0.0,817.5
4177,59097097bc09cdef,b0d6a1d8ac3d563d,31ee470ef5dc8d7f,2019-02-02,1,0,0,900,4,2,154,77,152,2,0,0,2,0,39,35,113,77,9.5,682.0
4178,53abea410a0541c8,1641ef250e9de19b,dab8cfbb6b1db10a,2019-02-02,0,0,0,900,0,0,90,23,84,6,0,0,6,5,18,9,66,18,165.6,437.1
4179,53abea410a0541c8,dab8cfbb6b1db10a,1641ef250e9de19b,2019-02-02,0,3,0,900,10,4,65,14,49,16,0,0,16,5,16,9,33,9,186.9,512.4
4180,4e8b2357fea211e9,2f13e4020cea5b38,fea79f9bc8c68769,2019-02-02,0,0,0,197,0,0,12,1,12,0,0,0,0,0,2,1,10,1,0.0,122.0
4181,4e8b2357fea211e9,fea79f9bc8c68769,2f13e4020cea5b38,2019-02-02,1,1,1,197,0,0,23,8,18,5,0,0,5,3,6,2,12,5,75.0,122.0
4182,491b7d974254596d,2cd428e9606856fd,c482c8605455a213,2019-02-02,1,0,0,354,0,0,27,15,22,5,0,0,5,5,4,4,18,10,7.0,227.8
4183,491b7d974254596d,c482c8605455a213,2cd428e9606856fd,2019-02-02,0,0,0,354,6,2,27,7,24,3,0,0,3,2,11,11,13,5,112.2,160.0
4184,44cfd4330eb6e2bf,ba1e6cb3d43f7430,c21f26bbde777573,2019-02-02,0,0,0,15,0,0,4,0,4,0,0,0,0,0,0,0,4,0,0.0,11.0
4185,44cfd4330eb6e2bf,c21f26bbde777573,ba1e6cb3d43f7430,2019-02-02,1,0,0,15,0,0,8,6,4,4,0,0,4,3,1,1,3,3,4.0,11.0
4186,300f1489174a3ece,b6452706b373eea1,d0f3959b4a9747e6,2019-02-02,0,0,0,344,0,0,53,17,53,0,0,0,0,0,13,7,40,17,0.0,344.0
4187,300f1489174a3ece,d0f3959b4a9747e6,b6452706b373eea1,2019-02-02,1,0,0,344,0,0,50,18,50,0,0,0,0,0,14,8,36,18,0.0,344.0
4188,efbab76bedbfb65d,65f09bacd3957381,bc711b6dd95c1af6,2019-01-19,1,2,1,211,2,1,54,9,47,7,0,0,7,4,11,8,36,5,39.0,172.0
4189,efbab76bedbfb65d,bc711b6dd95c1af6,65f09bacd3957381,2019-01-19,0,0,0,211,1,1,30,4,30,0,0,0,0,0,8,5,22,4,0.0,118.0
4190,e76227f395b94e47,1ddb480b601cefb1,bb61823f76361297,2019-01-19,0,1,1,145,3,2,9,5,7,2,0,0,2,2,1,1,6,3,119.0,26.0
4191,e76227f395b94e47,bb61823f76361297,1ddb480b601cefb1,2019-01-19,0,0,0,145,0,0,11,0,11,0,0,0,0,0,2,2,9,0,0.0,26.0
4192,8da2c348ba6001a0,85073dbd1be65ed9,a9d6e047ce48ab63,2019-01-19,0,0,0,448,0,0,64,21,58,6,1,1,5,5,7,7,51,16,35.1,286.8
4193,8da2c348ba6001a0,a9d6e047ce48ab63,85073dbd1be65ed9,2019-01-19,0,1,0,448,3,1,30,12,27,3,0,0,3,3,0,0,27,9,85.2,270.9
4194,8a9c8f1d53d8c664,a495f599e787614f,acb36c908d415c4a,2019-01-19,1,0,0,236,0,0,60,32,46,14,0,0,14,9,1,1,45,23,29.0,207.0
4195,8a9c8f1d53d8c664,acb36c908d415c4a,a495f599e787614f,2019-01-19,0,0,0,236,4,0,21,0,21,0,0,0,0,0,15,11,6,0,0.0,127.0
4196,85511ab7fd9ed061,056c493bbd76a918,c849740a3ff51931,2019-01-19,1,0,0,32,0,0,23,17,6,17,0,0,17,15,1,1,5,2,0.0,32.0
4197,85511ab7fd9ed061,c849740a3ff51931,056c493bbd76a918,2019-01-19,0,0,0,32,0,0,3,0,3,0,0,0,0,0,2,1,1,0,0.0,23.0
4198,7ddd21d48e3b34b9,01784fbc27c68b14,4d5197f331c47290,2019-01-19,0,0,0,410,4,4,14,7,11,3,0,0,3,2,3,3,8,5,51.0,87.0
4199,7ddd21d48e3b34b9,4d5197f331c47290,01784fbc27c68b14,2019-01-19,0,2,1,410,1,0,27,13,13,14,1,1,13,11,3,3,10,2,272.0,87.0
4200,77c6a6f33289b872,12f91bfa8f1f723b,6551c64fbcd1a467,2019-01-19,0,2,0,900,3,1,172,47,155,17,0,0,17,14,55,38,100,33,130.3,609.9
4201,77c6a6f33289b872,6551c64fbcd1a467,12f91bfa8f1f723b,2019-01-19,0,0,0,900,1,1,154,29,153,1,0,0,1,1,39,24,114,28,14.1,571.7
4202,5d1f24e034772338,37d5b176d438d2a5,7ff97850e8c32bda,2019-01-19,1,0,0,201,0,0,30,22,9,21,1,1,20,16,1,1,8,6,32.7,53.0
4203,5d1f24e034772338,7ff97850e8c32bda,37d5b176d438d2a5,2019-01-19,0,1,1,201,3,1,11,6,3,8,0,0,8,6,0,0,3,0,106.0,62.3
4204,4738cd4cd8d33eeb,80eacd4da0617c57,f53c1f4ceeed8c08,2019-01-19,1,0,0,900,12,7,50,7,46,4,0,0,4,1,20,14,26,6,273.3,438.5
4205,4738cd4cd8d33eeb,f53c1f4ceeed8c08,80eacd4da0617c57,2019-01-19,0,0,0,900,8,3,87,21,78,9,4,4,5,3,29,24,49,18,51.5,443.7
4206,3dd0951b8855137d,1d00756835ca67c9,262a7d06203657e6,2019-01-19,1,0,0,523,1,1,162,58,146,16,1,1,15,13,25,21,121,45,12.2,494.0
4207,3dd0951b8855137d,262a7d06203657e6,1d00756835ca67c9,2019-01-19,0,0,0,523,2,0,105,20,105,0,0,0,0,0,46,29,59,20,0.0,488.8
4208,2ea1f463620bcd3d,6f242453c91a5af0,ef44e4ea9050f2ea,2019-01-19,0,2,0,900,9,5,122,42,74,48,2,2,46,31,24,19,50,11,34.8,475.2
4209,2ea1f463620bcd3d,ef44e4ea9050f2ea,6f242453c91a5af0,2019-01-19,1,0,0,900,0,0,56,16,45,11,0,0,11,4,10,7,35,12,382.8,343.2
4210,2cc1fe3570999428,b1b0729d27936f2f,b997be68943010fc,2019-01-19,0,0,0,900,7,0,204,39,204,0,0,0,0,0,41,24,163,39,0.0,856.6
4211,2cc1fe3570999428,b997be68943010fc,b1b0729d27936f2f,2019-01-19,2,0,0,900,0,0,190,61,180,10,0,0,10,5,12,10,168,56,20.4,843.0
4212,0261adcfc6e49150,813550bc53b15fb0,84ff027394f7e470,2019-01-19,0,0,0,599,0,0,12,1,11,1,0,0,1,0,1,0,10,1,7.0,143.2
4213,0261adcfc6e49150,84ff027394f7e470,813550bc53b15fb0,2019-01-19,1,0,0,599,11,6,71,38,20,51,10,10,41,34,3,3,17,4,448.8,64.0
4214,ceaae1db8ccde29c,07f72a2a7591b409,3c6976f8182d9527,2018-12-29,1,0,0,722,5,1,102,26,89,13,0,0,13,12,50,33,39,14,55.1,633.0
4215,ceaae1db8ccde29c,3c6976f8182d9527,07f72a2a7591b409,2018-12-29,0,0,0,722,0,0,83,12,83,0,0,0,0,0,21,10,62,12,0.0,666.9
4216,bd7a8c6c74655afc,73c7cfa551289285,8866c6f509c19089,2018-12-29,0,0,0,166,0,0,8,1,5,3,2,1,1,0,1,1,4,1,94.0,72.0
4217,bd7a8c6c74655afc,8866c6f509c19089,73c7cfa551289285,2018-12-29,0,1,1,166,0,0,15,0,15,0,0,0,0,0,8,6,7,0,0.0,72.0
4218,b0e16dd491bc4fea,3ecd936bd8814108,a0e75f4a13eb73f1,2018-12-29,0,0,0,61,0,0,6,0,6,0,0,0,0,0,5,3,1,0,0.0,61.0
4219,b0e16dd491bc4fea,a0e75f4a13eb73f1,3ecd936bd8814108,2018-12-29,1,0,0,61,0,0,9,2,9,0,0,0,0,0,1,1,8,2,0.0,61.0
4220,a5ea53104392fa9f,b5b684eac99ae0a3,e1248941344b3288,2018-12-29,1,0,0,554,4,3,51,16,51,0,0,0,0,0,14,12,37,16,0.0,506.8
4221,a5ea53104392fa9f,e1248941344b3288,b5b684eac99ae0a3,2018-12-29,1,0,0,554,0,0,124,36,121,3,0,0,3,3,33,18,88,33,2.2,546.0
4222,9ee818e10dcf3b45,5e4eec08896c9423,e9a3aeb207578eea,2018-12-29,0,0,0,900,4,0,121,24,121,0,0,0,0,0,28,16,93,24,0.0,877.0
4223,9ee818e10dcf3b45,e9a3aeb207578eea,5e4eec08896c9423,2018-12-29,0,0,0,900,4,0,78,23,78,0,0,0,0,0,12,10,66,23,0.0,854.0
4224,8ce926b4d38a55a0,7be14eaed4c74856,cc1a8b4b38b92c6d,2018-12-29,0,0,0,100,1,0,10,0,10,0,0,0,0,0,7,6,3,0,0.0,83.0
4225,8ce926b4d38a55a0,cc1a8b4b38b92c6d,7be14eaed4c74856,2018-12-29,0,1,1,100,0,0,16,6,13,3,0,0,3,2,5,4,8,4,12.0,84.0
4226,819af4bbad55324d,03f982ca3735070c,3738e68d2261e60f,2018-12-29,0,0,0,900,3,1,93,13,93,0,0,0,0,0,21,11,72,13,0.0,866.0
4227,819af4bbad55324d,3738e68d2261e60f,03f982ca3735070c,2018-12-29,0,0,0,900,1,0,93,20,93,0,0,0,0,0,33,24,60,20,0.0,891.0
4228,61bf6748cf85eb84,329e403448756217,5f6f049d54728e88,2018-12-29,1,1,1,852,3,2,114,32,77,37,15,15,22,14,28,14,49,18,453.7,337.0
4229,61bf6748cf85eb84,5f6f049d54728e88,329e403448756217,2018-12-29,0,0,0,852,0,0,58,10,58,0,0,0,0,0,15,5,43,10,0.0,398.3
4230,4de25b19c4dedb14,65578a75fa7900e3,899923ff6ab13917,2018-12-29,1,0,0,692,0,0,88,13,88,0,0,0,0,0,40,26,48,13,0.0,691.0
4231,4de25b19c4dedb14,899923ff6ab13917,65578a75fa7900e3,2018-12-29,0,0,0,692,0,0,157,27,157,0,0,0,0,0,57,41,100,27,0.0,563.0
4232,498e7b0800af226c,3a314d9fa7c6825d,d661ce4da776fc20,2018-12-29,0,0,0,600,1,0,77,13,77,0,0,0,0,0,33,15,44,13,0.0,426.4
4233,498e7b0800af226c,d661ce4da776fc20,3a314d9fa7c6825d,2018-12-29,1,1,0,600,4,3,118,49,86,32,4,4,28,22,28,23,58,27,173.6,383.0
4234,3f5a623cf360c494,aec185309b4843d0,f1928a52590c5532,2018-12-29,0,0,0,900,7,3,121,30,109,12,1,1,11,8,22,9,87,22,136.9,706.0
4235,3f5a623cf360c494,f1928a52590c5532,aec185309b4843d0,2018-12-29,0,0,0,900,0,0,165,59,165,0,0,0,0,0,53,30,112,59,0.0,746.1
4236,3278e45b30f7dd33,634bb0de2eb043b4,80fa8218c99f9c58,2018-12-29,0,0,0,51,1,0,15,1,15,0,0,0,0,0,3,2,12,1,0.0,51.0
4237,3278e45b30f7dd33,80fa8218c99f9c58,634bb0de2eb043b4,2018-12-29,2,0,0,51,0,0,21,12,21,0,0,0,0,0,1,1,20,12,0.0,50.0
4238,1ca41d3b11d88b36,c58f51dedb310998,f9f07bb5a43535ed,2018-12-29,0,1,1,356,5,4,22,8,10,12,0,0,12,6,2,2,8,2,216.0,98.0
4239,1ca41d3b11d88b36,f9f07bb5a43535ed,c58f51dedb310998,2018-12-29,0,1,0,356,0,0,24,2,22,2,0,0,2,1,6,3,16,1,6.0,122.0
4240,f3e289f1423c0e6f,07225ba28ae309b6,d1941565abf50b16,2018-12-15,0,1,1,75,1,1,1,0,1,0,0,0,0,0,1,0,0,0,0.0,28.0
4241,f3e289f1423c0e6f,d1941565abf50b16,07225ba28ae309b6,2018-12-15,0,0,0,75,0,0,2,0,2,0,0,0,0,0,1,1,1,0,0.0,75.0
4242,c4f443509308dec6,83b00f7597e5ac83,e51ee8ded927fc51,2018-12-15,1,0,0,658,2,2,144,74,100,44,3,2,41,33,10,10,90,41,205.8,368.9
4243,c4f443509308dec6,e51ee8ded927fc51,83b00f7597e5ac83,2018-12-15,0,0,0,658,2,1,76,30,74,2,0,0,2,2,12,11,62,28,13.1,393.2
4244,c0ab927864bb6e98,47cd337b86b1af92,8be158ca1e5ea6a0,2018-12-15,0,0,0,900,6,1,71,5,70,1,0,0,1,1,18,9,52,4,43.5,723.1
4245,c0ab927864bb6e98,8be158ca1e5ea6a0,47cd337b86b1af92,2018-12-15,0,0,0,900,1,1,84,15,83,1,0,0,1,1,13,10,70,14,2.9,836.5
4246,bf41783b9446891e,4ba8d454f762005d,f797f0c57a83353e,2018-12-15,1,0,0,900,5,0,139,30,135,4,3,3,1,1,28,23,107,29,45.5,700.5
4247,bf41783b9446891e,f797f0c57a83353e,4ba8d454f762005d,2018-12-15,0,0,0,900,0,0,103,42,90,13,2,2,11,6,16,10,74,36,74.5,728.5
4248,b9c82dfde8b66e37,59279a7c978f7da0,ee9ebceabfd16fa7,2018-12-15,0,0,0,1500,7,0,228,82,226,2,0,0,2,1,39,29,187,81,14.0,1175.1
4249,b9c82dfde8b66e37,ee9ebceabfd16fa7,59279a7c978f7da0,2018-12-15,0,0,0,1500,5,3,296,80,274,22,7,6,15,14,22,16,252,66,310.9,1161.0
4250,b69d3d55c84f5dd6,7cbf7c78d3b34218,887961364be5ceb3,2018-12-15,0,0,0,900,6,0,131,26,125,6,0,0,6,4,42,32,83,22,19.4,742.4
4251,b69d3d55c84f5dd6,887961364be5ceb3,7cbf7c78d3b34218,2018-12-15,0,1,0,900,4,1,154,39,141,13,1,1,12,9,62,52,79,30,102.6,659.6
4252,986f0b480389ad25,0a1942069c9ad6b6,6ac9bc2953c47345,2018-12-15,0,1,1,265,2,1,59,37,4,55,1,1,54,37,4,3,0,0,225.7,27.0
4253,986f0b480389ad25,6ac9bc2953c47345,0a1942069c9ad6b6,2018-12-15,0,0,0,265,2,0,2,0,2,0,0,0,0,0,1,1,1,0,0.0,24.30000000000001
4254,92fd2127f46b0cb7,7026eca45f65377b,ae7fe94f117f98cf,2018-12-15,0,0,0,759,8,3,194,94,178,16,2,2,14,13,26,20,152,81,136.8,489.9
4255,92fd2127f46b0cb7,ae7fe94f117f98cf,7026eca45f65377b,2018-12-15,1,2,0,759,1,1,191,54,189,2,0,0,2,2,53,41,136,52,4.1,583.2
4256,920b6f739a36e721,193b9d1858bc4df3,64a50dad704d1d49,2018-12-15,0,0,0,739,1,0,204,59,204,0,0,0,0,0,43,22,161,59,0.0,734.0
4257,920b6f739a36e721,64a50dad704d1d49,193b9d1858bc4df3,2018-12-15,1,0,0,739,1,0,226,71,226,0,0,0,0,0,66,55,160,71,0.0,636.0
4258,4da4c5ef6a4ffc5b,05339613bf8e9808,de75d1c45a39e221,2018-12-15,0,1,0,900,4,2,247,79,228,19,5,4,14,4,30,28,198,75,276.4,593.0
4259,4da4c5ef6a4ffc5b,de75d1c45a39e221,05339613bf8e9808,2018-12-15,0,0,0,900,2,1,185,53,183,2,0,0,2,0,20,18,163,53,16.0,607.6
4260,1b6e5363eb81c409,82a5152216251682,ebef46976554f975,2018-12-15,0,0,0,900,7,3,107,46,57,50,4,3,46,29,8,7,49,17,382.4,269.9
4261,1b6e5363eb81c409,ebef46976554f975,82a5152216251682,2018-12-15,0,1,0,900,2,0,107,49,69,38,1,1,37,20,6,6,63,29,217.1,277.6
4262,05f1e8ff81dbe05b,18b602842a24f7c5,72ffecf712673af1,2018-12-15,2,0,0,179,0,0,42,25,28,14,1,1,13,13,11,9,17,12,82.5,67.0
4263,05f1e8ff81dbe05b,72ffecf712673af1,18b602842a24f7c5,2018-12-15,0,0,0,179,0,0,21,5,20,1,0,0,1,1,5,5,15,4,0.0,96.5
4264,fdc97f9b88bdef7d,31f8081c7600da93,f53d4f21d1b5f2dc,2018-12-08,0,0,0,383,0,0,50,12,49,1,0,0,1,0,13,8,36,12,7.0,165.4
4265,fdc97f9b88bdef7d,f53d4f21d1b5f2dc,31f8081c7600da93,2018-12-08,1,1,0,383,4,2,102,42,56,46,1,1,45,25,14,11,42,17,203.6,168.0
4266,e909e34cdee01831,c03a5022f8439f2a,e9213f53ddeca978,2018-12-08,0,0,0,97,0,0,16,2,16,0,0,0,0,0,7,6,9,2,0.0,97.0
4267,e909e34cdee01831,e9213f53ddeca978,c03a5022f8439f2a,2018-12-08,1,0,0,97,0,0,25,4,25,0,0,0,0,0,2,1,23,4,0.0,95.0
4268,e0e22d7bc5a293e8,2c9d00968f818270,c5af5750e8bae4f0,2018-12-08,0,0,0,900,0,0,212,51,212,0,0,0,0,0,66,52,146,51,0.0,879.5
4269,e0e22d7bc5a293e8,c5af5750e8bae4f0,2c9d00968f818270,2018-12-08,0,0,0,900,12,2,109,27,107,2,0,0,2,2,30,15,77,25,18.5,789.0
4270,d5577e3272ef3032,d343df8ba11f4c4e,ec34349e7dffcde7,2018-12-08,0,0,0,900,0,0,211,62,211,0,0,0,0,0,38,34,173,62,0.0,806.7
4271,d5577e3272ef3032,ec34349e7dffcde7,d343df8ba11f4c4e,2018-12-08,0,0,0,900,10,2,112,45,105,7,0,0,7,7,6,4,99,38,93.3,700.0
4272,7d679c16024f6f38,34f88592c0ab7a54,cad24459b28592ca,2018-12-08,0,0,0,900,3,0,211,31,211,0,0,0,0,0,84,61,127,31,0.0,864.0
4273,7d679c16024f6f38,cad24459b28592ca,34f88592c0ab7a54,2018-12-08,1,0,0,900,1,0,133,54,133,0,0,0,0,0,17,11,116,54,0.0,877.0
4274,4e55251b7a0df0c2,150ff4cc642270b9,def8166ff24bd237,2018-12-08,1,0,0,1200,1,1,490,244,489,1,0,0,1,1,60,46,429,243,1.5,1184.0
4275,4e55251b7a0df0c2,def8166ff24bd237,150ff4cc642270b9,2018-12-08,0,0,0,1200,11,2,292,87,292,0,0,0,0,0,25,23,267,87,0.0,1053.5
4276,48a2a476d3b59866,132deb59abae64b1,3d6749c4267da18f,2018-12-08,0,0,0,1500,14,5,191,50,183,8,0,0,8,8,56,39,127,42,123.5,1006.0
4277,48a2a476d3b59866,3d6749c4267da18f,132deb59abae64b1,2018-12-08,0,0,0,1500,0,0,250,12,250,0,0,0,0,0,117,66,133,12,0.0,1359.5
4278,41feee2c08af2235,2fc7e9701642ca38,7b433309b0fd12aa,2018-12-08,0,1,0,900,6,4,142,41,140,2,0,0,2,1,43,28,97,40,13.8,838.5
4279,41feee2c08af2235,7b433309b0fd12aa,2fc7e9701642ca38,2018-12-08,0,0,0,900,3,0,158,40,152,6,0,0,6,5,52,36,100,35,6.5,873.2
4280,3a42dd84680f444b,57b10fca4f9c9a7a,fd55393021a8c255,2018-12-08,0,0,0,557,2,0,49,27,13,36,2,2,34,22,7,7,6,5,148.8,117.19999999999999
4281,3a42dd84680f444b,fd55393021a8c255,57b10fca4f9c9a7a,2018-12-08,0,1,1,557,5,2,11,10,2,9,0,0,9,9,1,1,1,1,253.8,126.19999999999999
4282,37a7dc68f3a0e65d,1e1dbd1cc5a7469e,dea070ed4a2a8281,2018-12-08,0,0,0,341,2,0,42,15,39,3,0,0,3,2,12,12,27,13,19.8,193.2
4283,37a7dc68f3a0e65d,dea070ed4a2a8281,1e1dbd1cc5a7469e,2018-12-08,2,0,0,341,3,1,74,27,73,1,0,0,1,0,16,15,57,27,2.8,241.2
4284,1fa8537d3992a09a,23024fdfc966410a,55ee431411ccf07a,2018-12-08,1,0,0,900,7,3,143,57,101,42,0,0,42,33,22,19,79,24,329.9,523.0
4285,1fa8537d3992a09a,55ee431411ccf07a,23024fdfc966410a,2018-12-08,0,0,0,900,0,0,96,35,96,0,0,0,0,0,8,5,88,35,0.0,519.1
4286,19d1ae54681bc722,333b9e5c723ac873,cc7040fe76f0ef91,2018-12-08,1,0,0,245,1,0,45,12,29,16,0,0,16,10,21,19,8,2,40.6,156.8
4287,19d1ae54681bc722,cc7040fe76f0ef91,333b9e5c723ac873,2018-12-08,1,0,0,245,2,0,31,15,23,8,0,0,8,7,5,4,18,8,22.2,154.4
4288,00b1e95f6aea7027,e872e9a9a902c045,f72465a784c1b084,2018-12-08,0,0,0,900,0,0,201,51,191,10,0,0,10,8,21,14,170,43,26.3,850.0
4289,00b1e95f6aea7027,f72465a784c1b084,e872e9a9a902c045,2018-12-08,0,0,0,900,3,0,190,39,190,0,0,0,0,0,63,42,127,39,0.0,853.7
4290,fa9ec0b8c4b3a84a,5aedf14771ca82d2,840d2c82ea68b9aa,2018-12-01,0,1,0,900,17,7,115,18,115,0,0,0,0,0,24,14,91,18,0.0,543.0
4291,fa9ec0b8c4b3a84a,840d2c82ea68b9aa,5aedf14771ca82d2,2018-12-01,0,0,0,900,0,0,111,31,111,0,0,0,0,0,14,8,97,31,0.0,875.0
4292,c65f4b4c0338d0c1,853eb0dd5c0e2149,ac5a7400da3a9a41,2018-12-01,1,0,0,900,0,0,178,74,82,96,2,2,94,51,13,10,69,23,570.0,330.0
4293,c65f4b4c0338d0c1,ac5a7400da3a9a41,853eb0dd5c0e2149,2018-12-01,1,2,0,900,7,1,73,13,73,0,0,0,0,0,6,3,67,13,0.0,302.0
4294,b6bd31215bd7ec1f,63def5a5662a6917,c62fbc117d57b943,2018-12-01,1,0,0,450,0,0,65,20,38,27,2,1,25,10,8,5,30,10,46.3,402.0
4295,b6bd31215bd7ec1f,c62fbc117d57b943,63def5a5662a6917,2018-12-01,0,0,0,450,0,0,42,9,42,0,0,0,0,0,9,7,33,9,0.0,328.7
4296,94dcbc64641cbb6e,65ddc8a9ac4e8531,cbf1c7ba5408a66f,2018-12-01,1,0,0,900,4,0,97,32,97,0,0,0,0,0,15,9,82,32,0.0,900.0
4297,94dcbc64641cbb6e,cbf1c7ba5408a66f,65ddc8a9ac4e8531,2018-12-01,0,0,0,900,0,0,79,14,79,0,0,0,0,0,27,20,52,14,0.0,860.0
4298,73a299d44d2ef5cd,acff437707625fc7,e2ccd9a9ace60de7,2018-12-01,0,0,0,900,15,0,56,7,56,0,0,0,0,0,4,3,52,7,0.0,708.0
4299,73a299d44d2ef5cd,e2ccd9a9ace60de7,acff437707625fc7,2018-12-01,0,0,0,900,0,0,129,44,121,8,1,1,7,5,34,27,87,39,26.0,822.0
4300,70feb2bfc12b97d4,ce1e867808ef5fce,eef9b891edbd4604,2018-12-01,0,0,0,900,0,0,103,45,103,0,0,0,0,0,19,14,84,45,0.0,900.0
4301,70feb2bfc12b97d4,eef9b891edbd4604,ce1e867808ef5fce,2018-12-01,0,0,0,900,0,0,60,3,60,0,0,0,0,0,23,16,37,3,0.0,900.0
4302,69279781a89c893e,35faad160d346839,de45aaae23dfa392,2018-12-01,0,1,0,900,0,0,55,15,51,4,0,0,4,3,5,4,46,12,18.9,332.8
4303,69279781a89c893e,de45aaae23dfa392,35faad160d346839,2018-12-01,0,0,0,900,10,5,90,22,57,33,1,1,32,13,9,8,48,9,501.2,319.1
4304,60cc0ac9ace28324,5331b25a60417ffb,a845f0735bc67405,2018-12-01,0,1,1,679,0,0,86,15,85,1,0,0,1,1,11,10,74,14,35.0,609.0
4305,60cc0ac9ace28324,a845f0735bc67405,5331b25a60417ffb,2018-12-01,0,1,0,679,1,0,75,15,75,0,0,0,0,0,15,9,60,15,0.0,606.0
4306,44c60f91b4f7b23d,135d124172a0bea3,803bebcfb6d6f506,2018-12-01,0,0,0,900,11,5,55,22,35,20,1,1,19,10,16,11,19,12,509.6,314.0
4307,44c60f91b4f7b23d,803bebcfb6d6f506,135d124172a0bea3,2018-12-01,0,0,0,900,0,0,31,5,31,0,0,0,0,0,10,5,21,5,0.0,390.4
4308,29f40d82bd128c65,70e1f8a821b72c8b,eabf206b162b3b83,2018-12-01,0,4,1,891,1,1,38,16,14,24,0,0,24,15,2,1,12,1,505.0,192.5
4309,29f40d82bd128c65,eabf206b162b3b83,70e1f8a821b72c8b,2018-12-01,0,0,0,891,7,3,22,7,19,3,0,0,3,3,6,5,13,4,193.5,128.0
4310,20063242f6e40d31,140745cbbcb023ac,49e96ff8ab781589,2018-12-01,1,0,0,643,5,3,56,23,28,28,1,1,27,16,10,6,18,7,296.8,325.0
4311,20063242f6e40d31,49e96ff8ab781589,140745cbbcb023ac,2018-12-01,0,1,0,643,1,0,44,21,44,0,0,0,0,0,11,10,33,21,0.0,305.2
4312,0ac4f0c1b4d021f6,192520689012c7e4,94426bb170c88115,2018-12-01,0,0,0,134,0,0,9,1,9,0,0,0,0,0,4,4,5,1,0.0,100.0
4313,0ac4f0c1b4d021f6,94426bb170c88115,192520689012c7e4,2018-12-01,1,0,0,134,0,0,43,18,43,0,0,0,0,0,5,5,38,18,0.0,77.0
4314,e3f31cdd33b4ca92,45f0cc9d18f35137,b9f28e7045fdfce7,2018-11-30,0,0,0,552,1,0,52,9,48,4,1,0,3,3,26,17,22,6,0.0,229.0
4315,e3f31cdd33b4ca92,b9f28e7045fdfce7,45f0cc9d18f35137,2018-11-30,0,1,1,552,2,2,63,33,22,41,1,1,40,31,2,1,20,2,323.0,229.0
4316,d99b2abf50e9a03e,91dac5e69e28d5b5,9cdd2da1a9104a0b,2018-11-30,0,1,0,431,2,0,39,10,39,0,0,0,0,0,12,9,27,10,0.0,357.8
4317,d99b2abf50e9a03e,9cdd2da1a9104a0b,91dac5e69e28d5b5,2018-11-30,1,2,1,431,6,0,50,11,46,4,0,0,4,2,19,13,27,9,60.2,100.0
4318,d2ef04d5f384c05a,18e8b7070228e728,37c5366d18ed6c05,2018-11-30,0,0,0,290,1,0,33,5,33,0,0,0,0,0,8,5,25,5,0.0,234.0
4319,d2ef04d5f384c05a,37c5366d18ed6c05,18e8b7070228e728,2018-11-30,0,1,1,290,0,0,35,10,35,0,0,0,0,0,7,6,28,10,0.0,285.0
4320,cc73c73e6e3412d4,78863e4a28204a6b,ccf5dc41417e9daf,2018-11-30,0,0,0,216,0,0,6,0,6,0,0,0,0,0,4,4,2,0,0.0,58.69999999999999
4321,cc73c73e6e3412d4,ccf5dc41417e9daf,78863e4a28204a6b,2018-11-30,0,2,1,216,2,2,23,19,5,18,1,1,17,16,2,2,3,3,157.3,15.0
4322,c7df07266a9597d9,4b47e71384a9522f,9b1e3fb4f8cbd5b7,2018-11-30,1,0,0,78,2,2,32,17,14,18,1,1,17,13,1,1,13,4,33.0,45.0
4323,c7df07266a9597d9,9b1e3fb4f8cbd5b7,4b47e71384a9522f,2018-11-30,0,0,0,78,0,0,12,6,12,0,0,0,0,0,1,0,11,6,0.0,45.0
4324,c2fd3d874f558408,a20f234df70f2182,d7338bcb141abd2c,2018-11-30,0,0,0,900,0,0,128,18,128,0,0,0,0,0,15,15,113,18,0.0,708.5
4325,c2fd3d874f558408,d7338bcb141abd2c,a20f234df70f2182,2018-11-30,0,0,0,900,2,2,134,41,125,9,3,3,6,3,30,22,95,38,94.5,606.0
4326,aa7d691fc6385acb,5ef0088c1b19beeb,6bd02119599741a4,2018-11-30,0,0,0,159,5,0,48,18,48,0,0,0,0,0,2,2,46,18,0.0,141.3
4327,aa7d691fc6385acb,6bd02119599741a4,5ef0088c1b19beeb,2018-11-30,1,0,0,159,0,0,58,24,54,4,0,0,4,4,13,11,41,20,0.7,157.0
4328,86046081e767437e,068f8a189a47fea6,34218661c44ed55d,2018-11-30,0,1,1,134,0,0,15,6,15,0,0,0,0,0,4,3,11,6,0.0,134.0
4329,86046081e767437e,34218661c44ed55d,068f8a189a47fea6,2018-11-30,0,0,0,134,2,1,0,0,0,0,0,0,0,0,0,0,0,0,0.0,62.0
4330,6abf4f61a1e11d34,8cb78f3a6c2a08f7,a78a87d8c2bbb1cb,2018-11-30,0,0,0,900,1,0,179,40,178,1,0,0,1,1,42,33,136,39,17.8,721.6
4331,6abf4f61a1e11d34,a78a87d8c2bbb1cb,8cb78f3a6c2a08f7,2018-11-30,0,1,0,900,4,0,158,39,156,2,0,0,2,2,32,18,124,37,0.4,880.2
4332,5b2835ac76f05993,4144798612ef96e5,a17ad5a5048e8c3f,2018-11-30,0,0,0,900,21,8,37,12,36,1,1,1,0,0,11,9,25,12,37.3,283.2
4333,5b2835ac76f05993,a17ad5a5048e8c3f,4144798612ef96e5,2018-11-30,0,0,0,900,3,1,71,29,56,15,1,1,14,10,7,4,49,19,19.8,821.7
4334,4e6bbc5832e55f64,814ff3018127e8fc,cf946e03ba2e7666,2018-11-30,0,0,0,900,4,0,187,50,186,1,0,0,1,0,38,24,148,50,1.7,813.2
4335,4e6bbc5832e55f64,cf946e03ba2e7666,814ff3018127e8fc,2018-11-30,1,0,0,900,1,0,168,47,152,16,0,0,16,13,44,39,108,34,59.8,771.3
4336,1785c7fb722d3007,80eacd4da0617c57,ab2b4ff41d6ebe0f,2018-11-30,1,0,0,259,2,1,72,20,52,20,2,2,18,13,22,13,30,7,68.2,184.0
4337,1785c7fb722d3007,ab2b4ff41d6ebe0f,80eacd4da0617c57,2018-11-30,0,0,0,259,1,1,32,5,32,0,0,0,0,0,11,9,21,5,0.0,187.8
4338,0d077813b6164fe1,6a2f7c151031653d,f1b2aa7853d1ed6e,2018-11-30,0,2,0,1500,1,0,112,27,107,5,0,0,5,5,38,35,69,22,3.6,797.0
4339,0d077813b6164fe1,f1b2aa7853d1ed6e,6a2f7c151031653d,2018-11-30,0,0,0,1500,18,12,223,95,154,69,7,7,62,42,33,28,121,53,682.0,389.4
4340,e8093d77f566fe51,a851c35f58199231,c41d426cc7326d1b,2018-11-24,0,0,0,900,0,0,221,60,221,0,0,0,0,0,40,26,181,60,0.0,900.0
4341,e8093d77f566fe51,c41d426cc7326d1b,a851c35f58199231,2018-11-24,0,0,0,900,1,0,331,115,331,0,0,0,0,0,55,35,276,115,0.0,900.0
4342,d755a29a49c9ee09,37098a6e6c27fb66,efb96bf3e9ada36f,2018-11-24,0,0,0,900,0,0,201,52,198,3,0,0,3,1,34,22,164,51,1.4,779.3
4343,d755a29a49c9ee09,efb96bf3e9ada36f,37098a6e6c27fb66,2018-11-24,0,0,0,900,2,2,172,55,167,5,0,0,5,3,34,24,133,52,115.7,736.6
4344,d1a93a55c8063ff3,f923e012414c883e,fdbefee0827e1567,2018-11-24,0,0,0,240,1,0,43,9,40,3,0,0,3,1,12,8,28,8,11.2,210.0
4345,d1a93a55c8063ff3,fdbefee0827e1567,f923e012414c883e,2018-11-24,0,1,1,240,1,0,36,8,36,0,0,0,0,0,14,10,22,8,0.0,155.8
4346,a932059e61f4c25e,1ebe20ebbfa15e29,8f382b3baa954d2a,2018-11-24,0,2,1,221,3,1,58,36,12,46,4,4,42,35,6,5,6,1,140.8,71.0
4347,a932059e61f4c25e,8f382b3baa954d2a,1ebe20ebbfa15e29,2018-11-24,0,0,0,221,1,0,12,0,12,0,0,0,0,0,10,9,2,0,0.0,33.19999999999999
4348,9e1853861f58191f,32490e80ddab1e5a,cdb96af67d096b1e,2018-11-24,0,0,0,900,0,0,152,36,152,0,0,0,0,0,44,25,108,36,0.0,897.0
4349,9e1853861f58191f,cdb96af67d096b1e,32490e80ddab1e5a,2018-11-24,0,0,0,900,2,0,212,74,212,0,0,0,0,0,34,24,178,74,0.0,854.0
4350,8c109a0c53ed9618,3cf18e01cb6cbde3,d2bc285ead803db0,2018-11-24,0,2,0,427,0,0,30,18,13,17,0,0,17,14,1,0,12,4,24.6,56.5
4351,8c109a0c53ed9618,d2bc285ead803db0,3cf18e01cb6cbde3,2018-11-24,0,1,1,427,5,2,62,30,11,51,1,0,50,29,3,2,8,1,344.5,44.4
4352,43af7c5772e8198f,31bbd39c0a075d4e,ea3dcc417c322064,2018-11-24,1,2,0,900,4,0,133,41,126,7,0,0,7,4,22,14,104,37,133.0,508.6
4353,43af7c5772e8198f,ea3dcc417c322064,31bbd39c0a075d4e,2018-11-24,1,2,0,900,1,1,184,54,168,16,0,0,16,14,64,46,104,40,106.4,634.0
4354,438fbdd4cf27e324,d1528ac5675558b1,f1175ea3aafbf351,2018-11-24,1,0,0,900,0,0,157,80,154,3,0,0,3,2,18,18,136,78,1.0,888.0
4355,438fbdd4cf27e324,f1175ea3aafbf351,d1528ac5675558b1,2018-11-24,0,0,0,900,1,0,174,33,174,0,0,0,0,0,75,59,99,33,0.0,577.0
4356,21992c366d3b4602,3bb2dc8e87b10a46,e64b96c07d7ce999,2018-11-24,1,0,0,847,4,0,184,52,182,2,0,0,2,0,25,21,157,52,4.5,772.7
4357,21992c366d3b4602,e64b96c07d7ce999,3bb2dc8e87b10a46,2018-11-24,1,0,0,847,2,1,222,59,216,6,0,0,6,5,39,30,177,54,25.3,766.5
4358,1c43b38c1f4bdbe2,b4ad3a06ee4d660c,f14cf73e51b29254,2018-11-24,1,0,0,261,2,1,26,13,12,14,3,3,11,9,7,6,5,4,77.3,145.0
4359,1c43b38c1f4bdbe2,f14cf73e51b29254,b4ad3a06ee4d660c,2018-11-24,0,0,0,261,2,0,32,9,32,0,0,0,0,0,7,4,25,9,0.0,171.7
4360,12e12307414dafc6,8d03ce87ca14e778,fa6796c55d6c5440,2018-11-24,1,0,0,45,0,0,17,11,11,6,1,1,5,4,1,1,10,7,4.4,37.0
4361,12e12307414dafc6,fa6796c55d6c5440,8d03ce87ca14e778,2018-11-24,0,0,0,45,2,0,8,1,8,0,0,0,0,0,1,0,7,1,0.0,40.6
4362,02731f017c838ad4,3a46b268013afede,e9ac7bfb65c25497,2018-11-24,0,2,1,845,6,5,187,74,165,22,1,1,21,16,59,48,106,58,130.7,629.6
4363,02731f017c838ad4,e9ac7bfb65c25497,3a46b268013afede,2018-11-24,0,0,0,845,0,0,154,21,148,6,0,0,6,1,46,30,102,20,13.4,665.3
4364,f9ab603b763998f7,3974fa35c917af1d,92a9aa9c93192871,2018-11-17,1,0,0,849,5,3,123,39,105,18,3,3,15,14,32,28,73,25,91.2,683.2
4365,f9ab603b763998f7,92a9aa9c93192871,3974fa35c917af1d,2018-11-17,0,0,0,849,6,3,174,50,172,2,0,0,2,1,23,12,149,49,13.8,598.8
4366,c7bc8750e9503805,776a58a67665a171,bbc9ab95fa766493,2018-11-17,0,0,0,900,5,1,186,63,160,26,1,1,25,16,25,20,135,47,196.8,612.8
4367,c7bc8750e9503805,bbc9ab95fa766493,776a58a67665a171,2018-11-17,0,1,0,900,1,0,170,32,166,4,0,0,4,2,16,14,150,30,7.2,685.2
4368,b9a3b520e68f8142,7c7332319c14094c,d05412b513b19621,2018-11-17,1,2,1,391,2,2,35,13,29,6,1,1,5,3,16,10,13,10,19.4,240.1
4369,b9a3b520e68f8142,d05412b513b19621,7c7332319c14094c,2018-11-17,0,0,0,391,4,2,42,11,34,8,4,4,4,4,13,9,21,7,69.9,205.6
4370,9cd172df74575fd4,065eb44700e641a4,25af5e832f17b474,2018-11-17,0,0,0,900,1,0,139,18,127,12,2,0,10,1,59,40,68,17,6.9,677.3
4371,9cd172df74575fd4,25af5e832f17b474,065eb44700e641a4,2018-11-17,0,0,0,900,5,5,142,35,114,28,5,3,23,12,34,22,80,23,207.7,626.1
4372,99bfad1679112591,5c126c6aac3ef364,98215d037be5bcb7,2018-11-17,0,0,0,288,0,0,20,1,19,1,0,0,1,1,9,5,10,0,0.0,190.9
4373,99bfad1679112591,98215d037be5bcb7,5c126c6aac3ef364,2018-11-17,0,1,1,288,3,2,41,7,27,14,6,6,8,5,20,9,7,2,97.1,177.0
4374,961f434fe238f40e,7c3c48cf54a2848e,a0f0004aadf10b71,2018-11-17,0,0,0,138,0,0,11,6,6,5,0,0,5,4,1,1,5,2,84.0,54.0
4375,961f434fe238f40e,a0f0004aadf10b71,7c3c48cf54a2848e,2018-11-17,0,2,1,138,1,0,7,3,7,0,0,0,0,0,2,1,5,3,0.0,16.0
4376,85f85003fadf7a7b,2c2caf2f2bab9df5,bf0e700106d00e55,2018-11-17,0,0,0,900,3,2,85,12,85,0,0,0,0,0,26,18,59,12,0.0,706.0
4377,85f85003fadf7a7b,bf0e700106d00e55,2c2caf2f2bab9df5,2018-11-17,0,0,0,900,6,1,116,43,94,22,2,2,20,16,41,29,53,27,179.0,542.0
4378,7e695ad026b2ec66,6d1bffff14897645,84b3e7d38f2d2ec5,2018-11-17,2,0,0,1056,0,0,177,51,174,3,3,3,0,0,30,25,144,51,24.6,1015.0
4379,7e695ad026b2ec66,84b3e7d38f2d2ec5,6d1bffff14897645,2018-11-17,0,0,0,1056,2,0,251,51,247,4,2,2,2,0,30,19,217,51,0.0,1031.4
4380,629c0eb319e01374,a12a8314adc1c1c9,c487223b0289bda9,2018-11-17,0,0,0,900,0,0,275,71,275,0,0,0,0,0,40,26,235,71,0.0,900.0
4381,629c0eb319e01374,c487223b0289bda9,a12a8314adc1c1c9,2018-11-17,0,0,0,900,0,0,170,45,170,0,0,0,0,0,34,24,136,45,0.0,857.0
4382,51ce499611a5df68,749f572d1d3161fb,c21f26bbde777573,2018-11-17,0,0,0,117,0,0,9,3,9,0,0,0,0,0,2,1,7,3,0.0,110.4
4383,51ce499611a5df68,c21f26bbde777573,749f572d1d3161fb,2018-11-17,1,0,0,117,0,0,11,7,9,2,0,0,2,2,3,3,6,5,1.6,113.0
4384,410aca28fda60f76,e17ac6410c8377f4,e51fcd9cd84c0b93,2018-11-17,0,0,0,62,0,0,5,0,5,0,0,0,0,0,1,1,4,0,0.0,21.1
4385,410aca28fda60f76,e51fcd9cd84c0b93,e17ac6410c8377f4,2018-11-17,1,1,1,62,1,1,23,18,7,16,0,0,16,14,0,0,7,4,40.9,16.0
4386,3bde8910fabf0dd3,2e585c701f72fe55,dbc17725b887860a,2018-11-17,1,2,0,900,7,1,95,38,80,15,0,0,15,11,21,17,59,27,37.5,810.0
4387,3bde8910fabf0dd3,dbc17725b887860a,2e585c701f72fe55,2018-11-17,0,0,0,900,11,5,55,17,55,0,0,0,0,0,16,9,39,17,0.0,542.5
4388,bd5efa4b53dc1642,b4c6c904a9ffc5e8,d4a31850a7457f1b,2018-11-10,0,3,0,900,2,1,90,32,82,8,0,0,8,5,6,6,76,27,123.7,447.4
4389,bd5efa4b53dc1642,d4a31850a7457f1b,b4c6c904a9ffc5e8,2018-11-10,0,2,0,900,6,2,105,28,92,13,5,4,8,7,25,19,67,21,251.6,447.3
4390,933cf2674503c63d,0052de90691d4a93,3956bdc8ab2e54b3,2018-11-10,0,1,1,117,1,1,5,3,1,4,1,1,3,3,0,0,1,0,105.0,12.0
4391,933cf2674503c63d,3956bdc8ab2e54b3,0052de90691d4a93,2018-11-10,0,0,0,117,0,0,3,0,3,0,0,0,0,0,1,1,2,0,0.0,12.0
4392,79fb77a0b0294aec,207773daeb4afa7b,902ec2cc48c8ae8a,2018-11-10,1,0,0,46,0,0,19,9,13,6,1,1,5,3,3,3,10,6,3.0,43.0
4393,79fb77a0b0294aec,902ec2cc48c8ae8a,207773daeb4afa7b,2018-11-10,0,0,0,46,0,0,7,1,7,0,0,0,0,0,3,3,4,1,0.0,43.0
4394,46cfd4aaa02ce202,1d00756835ca67c9,f2b6fdb20675b11c,2018-11-10,0,1,1,286,1,0,13,2,13,0,0,0,0,0,8,7,5,2,0.0,237.7
4395,46cfd4aaa02ce202,f2b6fdb20675b11c,1d00756835ca67c9,2018-11-10,0,0,0,286,1,1,20,0,19,1,1,1,0,0,10,10,9,0,8.3,228.0
4396,38abefbf24624a35,b12fc8a41e82d3a2,f57dd0bfa8c17813,2018-11-10,0,0,0,900,1,0,124,45,124,0,0,0,0,0,13,10,111,45,0.0,820.0
4397,38abefbf24624a35,f57dd0bfa8c17813,b12fc8a41e82d3a2,2018-11-10,0,0,0,900,7,0,167,34,167,0,0,0,0,0,36,32,131,34,0.0,787.0
4398,3210723fbb018fa7,2fe9032955c2e013,a0c64f272b65d441,2018-11-10,0,4,0,900,1,1,67,14,59,8,1,1,7,6,10,9,49,8,34.7,645.0
4399,3210723fbb018fa7,a0c64f272b65d441,2fe9032955c2e013,2018-11-10,0,0,0,900,10,7,57,7,55,2,1,1,1,1,10,8,45,6,203.0,459.3
4400,2c84f2cb1bb23ab8,2844b047183a1adb,5bf31a46becc1204,2018-11-10,0,0,0,900,9,1,85,12,84,1,0,0,1,1,17,11,67,11,65.2,520.4
4401,2c84f2cb1bb23ab8,5bf31a46becc1204,2844b047183a1adb,2018-11-10,0,1,0,900,2,1,100,25,94,6,0,0,6,5,32,26,62,20,53.6,700.8
4402,17f69a241aa952fd,2244d9a2b64b8c3b,6a740daf1b279661,2018-11-10,0,0,0,421,0,0,69,10,69,0,0,0,0,0,37,31,32,10,0.0,277.5
4403,17f69a241aa952fd,6a740daf1b279661,2244d9a2b64b8c3b,2018-11-10,1,0,0,421,5,1,97,46,65,32,3,3,29,20,21,19,44,26,115.5,208.0
4404,14cf0828d6e373ab,08af939f41b5a57b,d945aae53e3e54e6,2018-11-10,0,2,0,900,8,4,68,22,20,48,17,15,31,19,7,7,13,3,749.5,88.0
4405,14cf0828d6e373ab,d945aae53e3e54e6,08af939f41b5a57b,2018-11-10,0,4,0,900,2,0,16,5,15,1,0,0,1,1,5,3,10,4,0.0,150.5
4406,0ccd16201ac41ef8,c451d67c09c55418,cbf5e6f231b55443,2018-11-10,0,0,0,1499,5,0,308,111,308,0,0,0,0,0,23,15,285,111,0.0,1439.0
4407,0ccd16201ac41ef8,cbf5e6f231b55443,c451d67c09c55418,2018-11-10,1,0,0,1499,4,0,271,59,271,0,0,0,0,0,81,60,190,59,0.0,1480.0
4408,0a667143584a2d96,1d239d571e342453,fc169c387b4b465d,2018-11-10,0,0,0,900,0,0,107,17,107,0,0,0,0,0,34,25,73,17,0.0,834.0
4409,0a667143584a2d96,fc169c387b4b465d,1d239d571e342453,2018-11-10,0,0,0,900,8,0,84,4,84,0,0,0,0,0,29,20,55,4,0.0,535.0
4410,04d37c1c206c0efd,4bd6b4800070b069,d76ad9a08c4408ff,2018-11-10,0,0,0,463,2,1,60,26,60,0,0,0,0,0,5,4,55,26,0.0,230.2
4411,04d37c1c206c0efd,d76ad9a08c4408ff,4bd6b4800070b069,2018-11-10,0,1,0,463,1,1,56,13,55,1,0,0,1,1,9,7,46,12,14.8,389.0
4412,e9700d51ec2b940b,d3df1add9d9a7efb,d967f0128c323de6,2018-11-03,0,0,0,434,0,0,13,2,13,0,0,0,0,0,4,2,9,2,0.0,140.3
4413,e9700d51ec2b940b,d967f0128c323de6,d3df1add9d9a7efb,2018-11-03,0,1,1,434,4,4,25,16,7,18,0,0,18,14,3,3,4,2,293.7,124.0
4414,e4e1d12441b90866,1338e2c7480bdf9e,b1a3e0aca758b322,2018-11-03,3,0,0,291,0,0,23,9,22,1,0,0,1,0,7,4,15,9,2.5,281.0
4415,e4e1d12441b90866,b1a3e0aca758b322,1338e2c7480bdf9e,2018-11-03,0,0,0,291,7,0,14,2,14,0,0,0,0,0,3,1,11,2,0.0,193.5
4416,df9aa51f6ccdfe02,dccb63727f2f5f74,f9b200db02b488d9,2018-11-03,0,1,0,900,6,2,176,43,176,0,0,0,0,0,42,23,134,43,0.0,852.0
4417,df9aa51f6ccdfe02,f9b200db02b488d9,dccb63727f2f5f74,2018-11-03,2,1,0,900,5,1,164,38,161,3,0,0,3,2,40,29,121,36,6.0,880.0
4418,c037cdc1de53de8e,3a8176e15b9887c1,7a703c565ccaa18f,2018-11-03,0,0,0,766,1,1,193,52,193,0,0,0,0,0,22,16,171,52,0.0,722.4
4419,c037cdc1de53de8e,7a703c565ccaa18f,3a8176e15b9887c1,2018-11-03,1,0,0,766,0,0,132,42,130,2,0,0,2,2,43,32,87,40,0.6,759.0
4420,b8b2cdf962cc65a0,484acc7b0f856ce9,4e0692ad070976e4,2018-11-03,0,0,0,92,0,0,23,2,23,0,0,0,0,0,15,10,8,2,0.0,90.8
4421,b8b2cdf962cc65a0,4e0692ad070976e4,484acc7b0f856ce9,2018-11-03,1,0,0,92,0,0,22,10,19,3,0,0,3,3,6,4,13,7,1.2,87.0
4422,b4ec3e067604f90a,13a0275fa13c4d26,d2c55d1d2e67773b,2018-11-03,1,0,0,339,0,0,56,22,42,14,0,0,14,10,4,4,38,12,21.0,207.8
4423,b4ec3e067604f90a,d2c55d1d2e67773b,13a0275fa13c4d26,2018-11-03,0,0,0,339,10,3,25,8,22,3,0,0,3,1,4,2,18,7,89.2,199.0
4424,7aede55e4e47c698,045f25b3a4c08e81,37d5b176d438d2a5,2018-11-03,0,0,0,900,0,0,98,12,98,0,0,0,0,0,18,9,80,12,0.0,747.0
4425,7aede55e4e47c698,37d5b176d438d2a5,045f25b3a4c08e81,2018-11-03,0,0,0,900,3,2,71,24,64,7,0,0,7,5,13,10,51,19,153.0,594.0
4426,78bb2b441917848c,bb1a2cdad6ff34db,c07efc18b231f170,2018-11-03,0,0,0,900,0,0,42,5,41,1,0,0,1,1,9,7,32,4,2.0,183.0
4427,78bb2b441917848c,c07efc18b231f170,bb1a2cdad6ff34db,2018-11-03,0,2,0,900,4,3,40,12,18,22,2,2,20,9,9,6,9,3,705.0,193.0
4428,752f19e9c201ea57,4234f0097c83fa62,4498b382c65a7faa,2018-11-03,1,0,0,900,4,3,175,44,155,20,1,1,19,9,17,12,138,35,298.3,542.0
4429,752f19e9c201ea57,4498b382c65a7faa,4234f0097c83fa62,2018-11-03,0,0,0,900,4,1,120,27,120,0,0,0,0,0,2,1,118,27,0.0,443.7
4430,41be95916aef568f,0d62719b1dcf7c40,1291edf2d566a71a,2018-11-03,2,0,0,900,0,0,102,22,82,20,1,0,19,7,18,10,64,15,59.4,802.0
4431,41be95916aef568f,1291edf2d566a71a,0d62719b1dcf7c40,2018-11-03,0,2,0,900,5,1,119,16,119,0,0,0,0,0,22,9,97,16,0.0,589.6
4432,3729ff914eaede07,98d961097baaf308,a7151778b3381036,2018-11-03,0,1,1,131,0,0,24,13,24,0,0,0,0,0,5,4,19,13,0.0,126.7
4433,3729ff914eaede07,a7151778b3381036,98d961097baaf308,2018-11-03,1,0,0,131,0,0,51,14,50,1,0,0,1,1,11,7,39,13,4.3,118.0
4434,33116969380185a9,ab943cd2c3c17825,efa1f6b42c86793c,2018-11-03,0,0,0,900,5,3,59,18,42,17,0,0,17,8,12,10,30,10,370.3,399.0
4435,33116969380185a9,efa1f6b42c86793c,ab943cd2c3c17825,2018-11-03,0,0,0,900,2,1,38,3,38,0,0,0,0,0,10,4,28,3,0.0,394.7
4436,e202f273220aa533,02f2a9702ba3d167,511e82663651438d,2018-10-27,0,0,0,900,0,0,189,29,189,0,0,0,0,0,48,38,141,29,0.0,874.0
4437,e202f273220aa533,511e82663651438d,02f2a9702ba3d167,2018-10-27,0,0,0,900,1,1,219,46,217,2,0,0,2,1,72,53,145,45,26.0,861.0
4438,e1eeb61d0669ce45,d0e50a3d1b250708,f2477cf43c4975cc,2018-10-27,2,1,0,900,3,3,138,29,133,5,1,1,4,3,52,49,81,26,20.5,442.6
4439,e1eeb61d0669ce45,f2477cf43c4975cc,d0e50a3d1b250708,2018-10-27,0,0,0,900,2,1,111,36,78,33,9,9,24,20,35,26,43,16,190.4,579.5
4440,bd0622b184ab4f28,751de04455cfaac0,bebb4ae55ac2bf6f,2018-10-27,1,0,0,251,0,0,48,23,35,13,0,0,13,7,1,1,34,16,5.0,246.0
4441,bd0622b184ab4f28,bebb4ae55ac2bf6f,751de04455cfaac0,2018-10-27,0,0,0,251,2,1,75,14,75,0,0,0,0,0,13,6,62,14,0.0,212.0
4442,a9a770bac1261af9,67f272324a030d00,e51e5cb722bd47a8,2018-10-27,0,2,1,160,1,1,18,2,17,1,0,0,1,1,12,9,5,1,3.0,121.0
4443,a9a770bac1261af9,e51e5cb722bd47a8,67f272324a030d00,2018-10-27,0,0,0,160,3,0,5,0,5,0,0,0,0,0,4,3,1,0,0.0,71.0
4444,9d204f44a9988b93,68c7ad953455c73f,ef44e4ea9050f2ea,2018-10-27,2,1,0,314,0,0,31,14,25,6,1,1,5,5,7,6,18,9,21.3,54.0
4445,9d204f44a9988b93,ef44e4ea9050f2ea,68c7ad953455c73f,2018-10-27,0,0,0,314,1,1,15,4,13,2,0,0,2,0,1,1,12,4,228.0,64.7
4446,96b59d89ecac66d0,0845c81e37d3bcb3,d4c9dcd330403612,2018-10-27,0,0,0,866,1,1,148,48,117,31,4,4,27,19,30,25,87,29,195.2,565.3
4447,96b59d89ecac66d0,d4c9dcd330403612,0845c81e37d3bcb3,2018-10-27,0,2,1,866,3,1,117,41,116,1,0,0,1,1,29,22,87,40,4.7,581.8
4448,8dcfa933877e3a0b,539ed332b3078821,5b2325cd70dbe2ea,2018-10-27,0,0,0,900,2,1,95,36,85,10,0,0,10,8,3,1,82,28,55.0,494.0
4449,8dcfa933877e3a0b,5b2325cd70dbe2ea,539ed332b3078821,2018-10-27,0,1,0,900,6,2,102,36,93,9,1,1,8,7,23,23,70,29,318.0,421.0
4450,8a08b8043f83d245,523fa774700d7d3f,a2b12c3f3d60ff69,2018-10-27,1,0,0,900,6,2,88,32,59,29,4,4,25,22,19,15,40,10,328.9,444.3
4451,8a08b8043f83d245,a2b12c3f3d60ff69,523fa774700d7d3f,2018-10-27,0,0,0,900,4,1,60,17,54,6,0,0,6,3,10,10,44,14,58.7,385.1
4452,6fd7f6f1deaef4e8,0d8011111be000b2,49858bf46dabf6fb,2018-10-27,1,0,0,490,0,0,177,60,157,20,1,1,19,10,4,4,153,50,29.6,453.0
4453,6fd7f6f1deaef4e8,49858bf46dabf6fb,0d8011111be000b2,2018-10-27,0,0,0,490,0,0,95,11,95,0,0,0,0,0,48,37,47,11,0.0,460.4
4454,53d6e37063f9c404,06f36cf4bd97ec77,fcd448a2fe1a23cc,2018-10-27,0,0,0,900,1,0,223,63,221,2,0,0,2,0,33,21,188,63,2.4,894.0
4455,53d6e37063f9c404,fcd448a2fe1a23cc,06f36cf4bd97ec77,2018-10-27,0,0,0,900,1,0,217,69,217,0,0,0,0,0,16,12,201,69,0.0,893.6
4456,53bb7c4a606d60c0,31a13532e724ca2b,6eaec40f724852f4,2018-10-27,0,0,0,900,0,0,174,23,174,0,0,0,0,0,67,52,107,23,0.0,900.0
4457,53bb7c4a606d60c0,6eaec40f724852f4,31a13532e724ca2b,2018-10-27,0,0,0,900,0,0,138,49,138,0,0,0,0,0,17,14,121,49,0.0,894.0
4458,4f42acd810ed5173,7e511f8d842a109d,ac29d508d78384c9,2018-10-27,0,0,0,900,2,1,84,40,73,11,1,1,10,8,7,6,66,32,158.2,483.0
4459,4f42acd810ed5173,ac29d508d78384c9,7e511f8d842a109d,2018-10-27,0,0,0,900,1,0,87,17,87,0,0,0,0,0,30,26,57,17,0.0,713.8
4460,3d7ea6012fd8f786,51e86de150ee8be6,b7b84ccd221be298,2018-10-27,0,0,0,900,0,0,284,56,284,0,0,0,0,0,32,22,252,56,0.0,781.0
4461,3d7ea6012fd8f786,b7b84ccd221be298,51e86de150ee8be6,2018-10-27,1,0,0,900,1,0,256,98,205,51,5,4,46,21,34,22,171,77,119.0,725.0
4462,e2e524bb5392a3ea,b12a1d19ee383b7c,d4691518d012b9e7,2018-10-06,0,0,0,206,1,0,16,2,16,0,0,0,0,0,9,7,7,2,0.0,47.7
4463,e2e524bb5392a3ea,d4691518d012b9e7,b12a1d19ee383b7c,2018-10-06,1,0,0,206,0,0,73,43,21,52,3,3,49,37,4,4,17,6,96.3,93.0
4464,c835ccffa472970e,cd7763bcadb5d4c8,df1eb4354d18a906,2018-10-06,0,0,0,822,4,0,62,16,61,1,1,0,0,0,16,9,45,16,3.2,509.7
4465,c835ccffa472970e,df1eb4354d18a906,cd7763bcadb5d4c8,2018-10-06,1,0,0,822,2,1,111,55,62,49,4,4,45,36,16,14,46,19,299.3,482.8
4466,adee1fc200ed1a12,b6850671a008bf9a,eb04b9d31e938edb,2018-10-06,0,0,0,900,4,1,100,15,97,3,0,0,3,2,49,36,48,13,26.8,470.3
4467,adee1fc200ed1a12,eb04b9d31e938edb,b6850671a008bf9a,2018-10-06,0,0,0,900,4,0,107,47,79,28,3,3,25,23,31,26,48,24,71.7,704.2
4468,9bc042a700d9a531,6fb1ba67bef41b37,7d96bc577e5178b2,2018-10-06,1,1,0,379,5,2,101,67,50,51,1,1,50,39,7,7,43,28,162.9,165.0
4469,9bc042a700d9a531,7d96bc577e5178b2,6fb1ba67bef41b37,2018-10-06,0,0,0,379,0,0,27,11,27,0,0,0,0,0,2,2,25,11,0.0,208.1
4470,8f6dda53ea3b09c7,22a92d7f62195791,cbb682f5fcc44bfc,2018-10-06,1,0,0,600,0,0,194,66,188,6,2,2,4,2,61,46,127,64,1.8,548.7
4471,8f6dda53ea3b09c7,cbb682f5fcc44bfc,22a92d7f62195791,2018-10-06,1,0,0,600,0,0,99,32,93,6,1,1,5,4,18,12,75,28,47.3,527.2
4472,8f5482992dad74d2,b102c26727306ab6,de75d1c45a39e221,2018-10-06,0,0,0,900,5,2,37,17,35,2,0,0,2,2,1,1,34,15,297.3,454.0
4473,8f5482992dad74d2,de75d1c45a39e221,b102c26727306ab6,2018-10-06,0,0,0,900,0,0,97,23,93,4,0,0,4,0,11,7,82,23,0.0,602.7
4474,68ba4aca75b02496,4c7781da8c6cae93,5331b25a60417ffb,2018-10-06,0,0,0,660,1,0,68,8,67,1,0,0,1,1,35,27,32,7,5.2,441.2
4475,68ba4aca75b02496,5331b25a60417ffb,4c7781da8c6cae93,2018-10-06,2,1,0,660,0,0,77,33,54,23,0,0,23,16,3,3,51,17,197.8,439.8
4476,48ea8a30f7b88cfc,4d8fa64202cee4c1,6d4b63c767106d3a,2018-10-06,0,0,0,232,0,0,58,25,58,0,0,0,0,0,8,6,50,25,0.0,229.2
4477,48ea8a30f7b88cfc,6d4b63c767106d3a,4d8fa64202cee4c1,2018-10-06,1,0,0,232,0,0,64,25,55,9,0,0,9,8,16,16,39,17,2.8,228.0
4478,3eea92e7f26fb05b,032cc3922d871c7f,f4c49976c75c5ab2,2018-10-06,0,1,1,1083,7,3,119,58,56,63,8,8,55,37,6,4,50,21,701.6,348.0
4479,3eea92e7f26fb05b,f4c49976c75c5ab2,032cc3922d871c7f,2018-10-06,0,0,0,1083,0,0,81,34,75,6,0,0,6,6,21,17,54,28,0.0,381.4
4480,3c5442bb62ca1505,2e19380f34871c6a,50db8711c70196cd,2018-10-06,1,0,0,900,2,0,142,48,142,0,0,0,0,0,55,46,87,48,0.0,814.0
4481,3c5442bb62ca1505,50db8711c70196cd,2e19380f34871c6a,2018-10-06,0,0,0,900,9,1,71,23,71,0,0,0,0,0,19,15,52,23,0.0,807.0
4482,397ace87deeb8697,279566840aa55bf2,d3df1add9d9a7efb,2018-10-06,0,0,0,889,2,1,171,78,158,13,4,4,9,9,45,39,113,69,32.8,745.6
4483,397ace87deeb8697,d3df1add9d9a7efb,279566840aa55bf2,2018-10-06,1,0,0,889,2,0,70,31,50,20,2,2,18,15,7,6,43,16,37.4,813.2
4484,21be9181725ab599,2eeaefbfc7f9fcff,3143bf892608139a,2018-10-06,0,1,0,900,0,0,87,18,86,1,0,0,1,1,26,25,60,17,0.9,744.1
4485,21be9181725ab599,3143bf892608139a,2eeaefbfc7f9fcff,2018-10-06,0,1,0,900,8,5,111,26,101,10,3,3,7,6,54,43,47,20,137.9,306.1
4486,f4187c30c311eb93,2c99576fefe53c7c,5f6f049d54728e88,2018-09-22,0,2,0,900,5,3,101,23,84,17,3,3,14,13,37,18,47,10,263.1,587.3
4487,f4187c30c311eb93,5f6f049d54728e88,2c99576fefe53c7c,2018-09-22,1,0,0,900,1,1,123,41,121,2,0,0,2,1,19,12,102,40,18.7,608.9
4488,d7c7b312279104d2,01b352b6a9074d5c,441eacbe20e0e80b,2018-09-22,0,0,0,843,0,0,178,37,178,0,0,0,0,0,58,42,120,37,0.0,753.4
4489,d7c7b312279104d2,441eacbe20e0e80b,01b352b6a9074d5c,2018-09-22,1,0,0,843,1,1,218,81,205,13,1,1,12,11,48,29,157,70,17.6,774.0
4490,c5479f20e4db357d,cfb65863d5099327,db1f2ed63b54b9a7,2018-09-22,0,0,0,900,3,2,117,26,117,0,0,0,0,0,32,28,85,26,0.0,880.0
4491,c5479f20e4db357d,db1f2ed63b54b9a7,cfb65863d5099327,2018-09-22,0,0,0,900,0,0,80,16,80,0,0,0,0,0,40,30,40,16,0.0,807.0
4492,ba766bd03090dab9,07225ba28ae309b6,de45aaae23dfa392,2018-09-22,0,1,1,502,4,2,60,13,58,2,1,1,1,1,24,14,34,12,32.4,419.2
4493,ba766bd03090dab9,de45aaae23dfa392,07225ba28ae309b6,2018-09-22,0,0,0,502,0,0,80,13,79,1,1,1,0,0,14,4,65,13,1.8,462.6
4494,b509c337d181c567,1bcaac2d99b90fce,484acc7b0f856ce9,2018-09-22,0,2,1,582,2,2,3,2,1,2,0,0,2,2,0,0,1,0,485.0,97.0
4495,b509c337d181c567,484acc7b0f856ce9,1bcaac2d99b90fce,2018-09-22,0,0,0,582,0,0,2,0,1,1,0,0,1,0,1,1,0,0,0.0,97.0
4496,a7492cbfb9b5d4a3,4a57ebb14315b251,cd2c4d30c6e13b47,2018-09-22,0,0,0,900,5,2,116,44,104,12,3,2,9,9,2,2,102,35,137.2,557.0
4497,a7492cbfb9b5d4a3,cd2c4d30c6e13b47,4a57ebb14315b251,2018-09-22,0,0,0,900,0,0,142,26,142,0,0,0,0,0,43,34,99,26,0.0,704.8
4498,a409a5381f082e8f,198994b47f395af0,57b10fca4f9c9a7a,2018-09-22,0,0,0,39,0,0,4,0,4,0,0,0,0,0,2,2,2,0,0.0,34.0
4499,a409a5381f082e8f,57b10fca4f9c9a7a,198994b47f395af0,2018-09-22,1,0,0,39,0,0,10,7,4,6,0,0,6,5,1,0,3,2,5.0,34.0
4500,7cdda45e7d52bf40,cad24459b28592ca,dea070ed4a2a8281,2018-09-22,0,1,0,900,10,6,67,26,57,10,1,1,9,8,7,5,50,18,185.8,511.8
4501,7cdda45e7d52bf40,dea070ed4a2a8281,cad24459b28592ca,2018-09-22,1,0,0,900,1,1,152,65,130,22,3,2,19,11,40,33,90,54,35.2,602.2
4502,3d9398386c84109b,a8283a4f415e1eb9,e5c9de15bb58b1c6,2018-09-22,1,0,0,550,1,0,69,20,67,2,0,0,2,2,12,8,55,18,12.9,485.6
4503,3d9398386c84109b,e5c9de15bb58b1c6,a8283a4f415e1eb9,2018-09-22,0,0,0,550,2,1,85,21,83,2,0,0,2,1,8,4,75,20,6.4,505.1
4504,37ff18106c6e38fc,26b63bc5c0c1f65d,dab8cfbb6b1db10a,2018-09-22,0,0,0,81,0,0,9,4,9,0,0,0,0,0,0,0,9,4,0.0,63.7
4505,37ff18106c6e38fc,dab8cfbb6b1db10a,26b63bc5c0c1f65d,2018-09-22,0,1,1,81,1,1,18,7,14,4,0,0,4,2,4,3,10,5,17.3,42.0
4506,30eaf1650bc359b3,a67f5afa8d6a1b80,e5bda12faabfc850,2018-09-22,0,1,0,900,0,0,97,38,74,23,7,6,16,12,2,2,72,26,244.3,326.9
4507,30eaf1650bc359b3,e5bda12faabfc850,a67f5afa8d6a1b80,2018-09-22,0,1,0,900,11,4,59,22,38,21,1,1,20,13,7,7,31,9,265.1,352.7
4508,1c6d3ef6beb9966e,2f1a257d6777096d,8adcbd525fab8d9b,2018-09-22,0,1,0,380,5,0,17,1,17,0,0,0,0,0,6,3,11,1,0.0,215.0
4509,1c6d3ef6beb9966e,8adcbd525fab8d9b,2f1a257d6777096d,2018-09-22,1,0,0,380,0,0,32,8,28,4,2,2,2,1,6,5,22,7,4.0,372.0
4510,1669773acd404217,73e09f837f3b5ecc,d156513a19acf856,2018-09-22,1,0,0,360,0,0,52,20,49,3,0,0,3,2,8,6,41,18,0.9,357.0
4511,1669773acd404217,d156513a19acf856,73e09f837f3b5ecc,2018-09-22,0,0,0,360,0,0,82,20,82,0,0,0,0,0,15,14,67,20,0.0,359.1
4512,0c618cd41b88c558,38c7f72747f4f712,cc8c623cca88f54f,2018-09-22,0,0,0,295,3,1,18,10,9,9,0,0,9,8,1,1,8,2,145.8,120.4
4513,0c618cd41b88c558,cc8c623cca88f54f,38c7f72747f4f712,2018-09-22,0,1,1,295,0,0,32,9,23,9,0,0,9,6,2,2,21,3,12.6,135.2
4514,f56c6646b54c0662,8f5c8850b2484173,f046d724d2a84ac5,2018-09-15,0,0,0,900,0,0,82,11,82,0,0,0,0,0,30,16,52,11,0.0,896.0
4515,f56c6646b54c0662,f046d724d2a84ac5,8f5c8850b2484173,2018-09-15,0,0,0,900,4,0,83,16,83,0,0,0,0,0,24,11,59,16,0.0,900.0
4516,eebb4dde70a67369,98c23cb6da5b3352,eef9b891edbd4604,2018-09-15,0,1,1,266,5,1,26,2,26,0,0,0,0,0,4,1,22,2,0.0,224.0
4517,eebb4dde70a67369,eef9b891edbd4604,98c23cb6da5b3352,2018-09-15,0,0,0,266,0,0,27,2,27,0,0,0,0,0,7,4,20,2,0.0,266.0
4518,ed72edc2ce0f3c5f,0a95c474e61a6c44,99bcdf5eac39898f,2018-09-15,0,0,0,342,0,0,12,0,12,0,0,0,0,0,3,1,9,0,0.0,137.8
4519,ed72edc2ce0f3c5f,99bcdf5eac39898f,0a95c474e61a6c44,2018-09-15,0,2,1,342,4,3,55,33,17,38,1,1,37,29,2,1,15,4,204.2,127.0
4520,dd0a3aedba5cee87,31ee470ef5dc8d7f,e2ccd9a9ace60de7,2018-09-15,0,0,0,900,0,0,175,19,175,0,0,0,0,0,59,37,116,19,0.0,852.0
4521,dd0a3aedba5cee87,e2ccd9a9ace60de7,31ee470ef5dc8d7f,2018-09-15,0,0,0,900,2,1,153,32,153,0,0,0,0,0,20,12,133,32,0.0,900.0
4522,d40f865aa6be9cd0,231cae8b77fbbcc1,5d7bdab5e03e3216,2018-09-15,1,0,0,600,5,5,69,33,15,54,11,10,43,27,5,5,10,6,340.1,241.0
4523,d40f865aa6be9cd0,5d7bdab5e03e3216,231cae8b77fbbcc1,2018-09-15,0,3,0,600,3,2,19,1,19,0,0,0,0,0,7,3,12,1,0.0,161.89999999999998
4524,c76fd2ddcbc4713d,7c9c6a884be167fe,d661ce4da776fc20,2018-09-15,0,0,0,900,7,1,220,51,214,6,0,0,6,4,17,7,197,47,48.9,742.2
4525,c76fd2ddcbc4713d,d661ce4da776fc20,7c9c6a884be167fe,2018-09-15,0,0,0,900,1,0,232,87,224,8,0,0,8,7,16,13,208,80,2.8,838.1
4526,ba33d0868b25483b,633a45d131192ffe,9b7694d064a8a0ad,2018-09-15,0,0,0,900,0,0,123,15,123,0,0,0,0,0,38,29,85,15,0.0,763.6
4527,ba33d0868b25483b,9b7694d064a8a0ad,633a45d131192ffe,2018-09-15,0,0,0,900,8,3,70,16,64,6,0,0,6,4,6,1,58,12,136.4,650.0
4528,a7e8416f0d57c8e0,2f5cbecbbe18bac4,3738e68d2261e60f,2018-09-15,0,0,0,900,4,2,70,19,52,18,1,0,3,0,6,0,28,0,127.9,688.3
4529,a7e8416f0d57c8e0,3738e68d2261e60f,2f5cbecbbe18bac4,2018-09-15,0,0,0,900,3,2,58,8,52,6,0,0,3,0,3,0,34,0,5.7,754.1
4530,880f2bb0a639a5a0,1091d4d957141094,99df7d0a2a08a8a8,2018-09-15,0,1,0,461,1,1,22,3,16,6,0,0,6,2,8,1,8,1,100.0,68.0
4531,880f2bb0a639a5a0,99df7d0a2a08a8a8,1091d4d957141094,2018-09-15,0,1,1,461,1,1,18,10,5,13,0,0,13,9,1,0,4,1,293.0,68.0
4532,67f559403a6ec7cb,348dff4e03bd18c6,abd5fb12437eda21,2018-09-15,0,0,0,900,5,1,58,6,58,0,0,0,0,0,24,16,34,6,0.0,714.2
4533,67f559403a6ec7cb,abd5fb12437eda21,348dff4e03bd18c6,2018-09-15,1,1,0,900,3,2,84,22,75,9,0,0,9,7,20,14,55,15,49.8,756.0
4534,6455d9c54d99b851,ba5e253af86db1a8,c03520b5c88ed6b4,2018-09-15,0,0,0,900,0,0,34,5,27,7,1,1,6,4,5,2,22,1,0.0,263.79999999999995
4535,6455d9c54d99b851,c03520b5c88ed6b4,ba5e253af86db1a8,2018-09-15,0,0,0,900,8,5,165,51,53,112,6,4,106,47,10,7,43,4,636.2,207.0
4536,1687e2cd061b7aec,6370c1c1e12723d5,d802174b0c0c1f4e,2018-09-15,0,0,0,189,0,0,22,1,22,0,0,0,0,0,7,2,15,1,0.0,188.3
4537,1687e2cd061b7aec,d802174b0c0c1f4e,6370c1c1e12723d5,2018-09-15,1,0,0,189,0,0,27,10,25,2,0,0,0,0,0,0,15,0,0.7,187.0
4538,fd61e6146f3b2942,b08012bbe542592a,d910665038efc639,2018-09-08,1,0,0,873,11,9,98,64,19,79,9,9,70,61,12,9,7,3,705.6,96.0
4539,fd61e6146f3b2942,d910665038efc639,b08012bbe542592a,2018-09-08,0,0,0,873,2,0,10,1,10,0,0,0,0,0,5,5,5,1,0.0,163.39999999999998
4540,f3bebb48771a414a,d8da10db80131bec,eae431e70064e046,2018-09-08,0,0,0,43,1,0,10,2,10,0,0,0,0,0,4,2,6,2,0.0,43.0
4541,f3bebb48771a414a,eae431e70064e046,d8da10db80131bec,2018-09-08,1,0,0,43,0,0,21,11,21,0,0,0,0,0,4,4,17,11,0.0,41.0
4542,e65ffb177a2c7669,bf7ad5628363eec9,cb696ebfb6598724,2018-09-08,0,0,0,522,3,3,43,2,43,0,0,0,0,0,12,10,31,2,0.0,223.1
4543,e65ffb177a2c7669,cb696ebfb6598724,bf7ad5628363eec9,2018-09-08,0,2,1,522,9,2,74,23,55,19,1,1,18,16,17,9,38,7,142.9,349.0
4544,e40a5bd62ce710ac,c17041f1bb5768d8,d1941565abf50b16,2018-09-08,0,0,0,89,0,0,14,3,14,0,0,0,0,0,3,2,11,3,0.0,70.0
4545,e40a5bd62ce710ac,d1941565abf50b16,c17041f1bb5768d8,2018-09-08,0,1,1,89,1,1,24,11,15,9,0,0,9,7,5,4,10,4,19.0,70.0
4546,dbf786f9808c6a08,6a1901c62ab3870f,d7c3816669784109,2018-09-08,1,0,0,118,0,0,73,32,73,0,0,0,0,0,7,6,66,32,0.0,117.0
4547,dbf786f9808c6a08,d7c3816669784109,6a1901c62ab3870f,2018-09-08,0,0,0,118,0,0,56,15,56,0,0,0,0,0,10,9,46,15,0.0,118.0
4548,b66ac52bfb217761,9ce6d5a03af801b7,effd9de9937996f8,2018-09-08,0,0,0,559,0,0,6,0,6,0,0,0,0,0,0,0,6,0,0.0,250.0
4549,b66ac52bfb217761,effd9de9937996f8,9ce6d5a03af801b7,2018-09-08,1,1,1,559,4,0,79,47,25,54,2,2,52,43,10,8,15,4,297.0,229.0
4550,b2625001e0b89369,87aa9fb63d6b51a1,cc351e408bbb7d43,2018-09-08,0,1,1,526,7,6,53,26,44,9,0,0,9,8,13,12,31,18,135.0,286.0
4551,b2625001e0b89369,cc351e408bbb7d43,87aa9fb63d6b51a1,2018-09-08,0,0,0,526,0,0,69,8,69,0,0,0,0,0,32,19,37,8,0.0,391.0
4552,a65909d4083c2088,3cf66c62d9069f43,578ef12674df1e6a,2018-09-08,0,0,0,900,0,0,329,81,329,0,0,0,0,0,40,24,289,81,0.0,883.0
4553,a65909d4083c2088,578ef12674df1e6a,3cf66c62d9069f43,2018-09-08,0,0,0,900,1,0,226,80,226,0,0,0,0,0,62,39,164,80,0.0,898.0
4554,9399c772adc7bcab,546f8599a63c29da,81d9df19e255b8b6,2018-09-08,0,0,0,900,4,1,40,10,25,15,4,3,11,9,6,3,19,1,223.4,238.5
4555,9399c772adc7bcab,81d9df19e255b8b6,546f8599a63c29da,2018-09-08,0,1,0,900,4,2,42,15,23,19,1,1,18,13,10,8,13,2,378.5,178.6
4556,82342dc6be82778b,99506df1af6c8b3b,9c907996820d2d69,2018-09-08,0,0,0,900,1,0,117,21,117,0,0,0,0,0,22,20,95,21,0.0,898.0
4557,82342dc6be82778b,9c907996820d2d69,99506df1af6c8b3b,2018-09-08,0,0,0,900,3,0,125,25,125,0,0,0,0,0,46,37,79,25,0.0,896.0
4558,7658965c2a700b39,76ee3d666c648f6b,a17ad5a5048e8c3f,2018-09-08,0,0,0,437,3,0,63,32,63,0,0,0,0,0,8,6,55,32,0.0,336.0
4559,7658965c2a700b39,a17ad5a5048e8c3f,76ee3d666c648f6b,2018-09-08,1,0,0,437,0,0,65,17,65,0,0,0,0,0,7,7,58,17,0.0,375.0
4560,6caf9ebf42ddae2e,764342d39cdaa54a,b997be68943010fc,2018-09-08,0,0,0,383,2,0,57,12,57,0,0,0,0,0,17,13,40,12,0.0,368.2
4561,6caf9ebf42ddae2e,b997be68943010fc,764342d39cdaa54a,2018-09-08,2,0,0,383,0,0,102,56,92,10,0,0,10,7,4,3,88,49,3.8,375.0
4562,294a9e9780afa789,3dd949593346dbc3,82e7929bf6c2b689,2018-09-08,1,1,0,900,0,0,42,16,18,24,2,1,22,8,1,1,17,8,7.7,44.5
4563,294a9e9780afa789,82e7929bf6c2b689,3dd949593346dbc3,2018-09-08,0,0,0,900,4,3,77,34,9,68,10,10,58,32,2,2,7,2,847.5,32.3
4564,f20e742e6b0c0b3b,5f179af5fffeb9f6,f0feeb2192937424,2018-08-25,0,0,0,900,6,1,333,80,331,2,0,0,2,2,43,31,288,78,16.8,796.9
4565,f20e742e6b0c0b3b,f0feeb2192937424,5f179af5fffeb9f6,2018-08-25,0,0,0,900,1,1,222,65,221,1,1,1,0,0,65,55,156,65,2.1,860.2
4566,d6f6ac29008509db,6256b2b1562cb8e1,9e8f6c728eb01124,2018-08-25,0,0,0,87,0,0,20,3,20,0,0,0,0,0,11,7,9,3,0.0,83.0
4567,d6f6ac29008509db,9e8f6c728eb01124,6256b2b1562cb8e1,2018-08-25,1,0,0,87,0,0,15,3,14,1,0,0,1,1,7,4,7,2,4.0,83.0
4568,aa91cb7567d6c48a,a331233f597090a5,d81ac739417d7f53,2018-08-25,2,0,0,146,0,0,35,17,23,12,0,0,12,10,2,2,21,7,0.0,146.0
4569,aa91cb7567d6c48a,d81ac739417d7f53,a331233f597090a5,2018-08-25,0,0,0,146,0,0,14,6,14,0,0,0,0,0,6,6,8,6,0.0,125.0
4570,9115354413739aa8,12f91bfa8f1f723b,27b164b0d1833df0,2018-08-25,0,2,1,297,0,0,6,4,2,4,0,0,4,4,1,1,1,0,0.0,34.80000000000001
4571,9115354413739aa8,27b164b0d1833df0,12f91bfa8f1f723b,2018-08-25,0,0,0,297,1,1,17,10,5,12,1,1,11,9,3,2,2,1,262.2,13.0
4572,7fe1486a2c33bf91,92437c6775b3f7d1,aa72b0f831d0bfe5,2018-08-25,0,1,0,488,2,0,26,6,24,2,0,0,2,2,9,8,15,4,0.0,213.10000000000002
4573,7fe1486a2c33bf91,aa72b0f831d0bfe5,92437c6775b3f7d1,2018-08-25,2,1,0,488,4,2,39,20,13,26,4,4,22,18,5,5,8,2,274.9,192.0
4574,67e1ec8ee2db3423,6c7e25571490aa3b,9e50097a89442158,2018-08-25,0,0,0,69,0,0,0,0,0,0,0,0,0,0,0,0,0,0,0.0,27.0
4575,67e1ec8ee2db3423,9e50097a89442158,6c7e25571490aa3b,2018-08-25,0,1,1,69,1,1,2,0,2,0,0,0,0,0,0,0,2,0,0.0,69.0
4576,62fecd327391557e,8f6a18831a120817,d317a5e2b3f88c5f,2018-08-25,1,0,0,448,4,0,106,43,106,0,0,0,0,0,23,16,83,43,0.0,313.3
4577,62fecd327391557e,d317a5e2b3f88c5f,8f6a18831a120817,2018-08-25,0,0,0,448,1,1,64,20,62,2,2,0,0,0,15,8,47,20,9.7,385.0
4578,5e3779f7c1c39679,2ac4628c08ec5125,fccf811c1e8b01c7,2018-08-25,0,0,0,900,1,0,122,22,122,0,0,0,0,0,43,32,79,22,0.0,893.0
4579,5e3779f7c1c39679,fccf811c1e8b01c7,2ac4628c08ec5125,2018-08-25,0,0,0,900,6,0,159,44,159,0,0,0,0,0,40,29,119,44,0.0,560.0
4580,5362ea7c63432cf9,94527830000ab715,96428b9e9bd048ea,2018-08-25,0,2,1,91,2,0,8,1,8,0,0,0,0,0,4,3,4,1,0.0,65.0
4581,5362ea7c63432cf9,96428b9e9bd048ea,94527830000ab715,2018-08-25,0,0,0,91,0,0,4,2,3,1,0,0,1,0,0,0,3,2,22.0,69.0
4582,48a9d2a3967d13a4,511e82663651438d,8fd808923cffff82,2018-08-25,0,0,0,900,3,0,116,31,110,6,3,3,3,3,46,31,64,28,77.1,810.0
4583,48a9d2a3967d13a4,8fd808923cffff82,511e82663651438d,2018-08-25,0,1,0,900,4,2,117,25,117,0,0,0,0,0,13,12,104,25,0.0,621.9
4584,3e0090669d51415f,2f95a3c6d58b2aad,65f09bacd3957381,2018-08-25,0,2,0,361,1,1,24,9,15,9,0,0,9,7,0,0,15,2,54.8,39.400000000000006
4585,3e0090669d51415f,65f09bacd3957381,2f95a3c6d58b2aad,2018-08-25,1,0,0,361,0,0,113,65,9,104,0,0,104,60,1,1,8,5,248.6,55.2
4586,3b701c0a0525341b,990bd63726a577f8,cad24459b28592ca,2018-08-25,0,0,0,882,5,2,113,29,109,4,1,0,3,2,23,14,86,27,30.3,775.2
4587,3b701c0a0525341b,cad24459b28592ca,990bd63726a577f8,2018-08-25,2,0,0,882,1,0,93,30,91,2,0,0,2,0,13,12,78,30,15.8,780.7
4588,047d6739aa1d5c1e,519e4fe37ce9ff75,53ec9cb470e1a4ea,2018-08-25,0,0,0,900,2,2,136,42,111,25,2,2,23,19,23,16,88,23,417.0,433.0
4589,047d6739aa1d5c1e,53ec9cb470e1a4ea,519e4fe37ce9ff75,2018-08-25,0,1,0,900,1,0,75,16,70,5,1,1,4,2,21,16,49,14,0.0,483.0
4590,f2ca358ea9bec156,056c493bbd76a918,8a304bfd6bf04a57,2018-08-04,0,0,0,1500,11,3,147,29,142,5,1,1,4,2,30,21,112,27,51.5,1218.0
4591,f2ca358ea9bec156,8a304bfd6bf04a57,056c493bbd76a918,2018-08-04,0,0,0,1500,2,1,134,23,133,1,0,0,1,1,72,58,61,22,4.0,1412.5
4592,e85e83ab4e60e768,0d62719b1dcf7c40,5b8ba8f5512893b1,2018-08-04,0,0,0,900,4,0,172,31,172,0,0,0,0,0,59,42,113,31,0.0,897.0
4593,e85e83ab4e60e768,5b8ba8f5512893b1,0d62719b1dcf7c40,2018-08-04,0,0,0,900,3,0,235,39,235,0,0,0,0,0,50,38,185,39,0.0,833.0
4594,e57a78a422439774,5987b2458f4b5290,cc1a8b4b38b92c6d,2018-08-04,0,0,0,900,20,7,53,7,52,1,0,0,1,0,22,18,30,7,37.4,555.0
4595,e57a78a422439774,cc1a8b4b38b92c6d,5987b2458f4b5290,2018-08-04,0,0,0,900,2,2,94,27,89,5,0,0,5,3,18,15,71,24,8.0,817.6
4596,de32c5a78aaf89e9,c849740a3ff51931,d8c7c61b176e3994,2018-08-04,2,0,0,250,0,0,72,37,54,18,0,0,18,14,12,8,42,23,15.4,221.0
4597,de32c5a78aaf89e9,d8c7c61b176e3994,c849740a3ff51931,2018-08-04,0,0,0,250,2,0,43,14,43,0,0,0,0,0,6,3,37,14,0.0,234.6
4598,d2f6b87189908088,6fd953151d981979,9673a497a9da119a,2018-08-04,0,0,0,900,1,0,83,36,81,2,0,0,2,2,6,4,75,34,71.4,519.2
4599,d2f6b87189908088,9673a497a9da119a,6fd953151d981979,2018-08-04,0,0,0,900,5,1,129,24,124,5,0,0,5,3,32,22,92,21,23.8,766.6
4600,c8a9d3917d77ede2,6bd02119599741a4,ec52462a1b41f714,2018-08-04,3,1,0,900,4,0,245,78,206,39,0,0,39,21,63,39,143,57,148.9,629.0
4601,c8a9d3917d77ede2,ec52462a1b41f714,6bd02119599741a4,2018-08-04,0,0,0,900,6,0,168,61,168,0,0,0,0,0,15,12,153,61,0.0,685.1
4602,8e971c1ec4b981cc,2296125b6c362355,7c7332319c14094c,2018-08-04,0,0,0,593,4,2,61,16,55,6,1,1,5,5,28,14,27,11,86.3,373.4
4603,8e971c1ec4b981cc,7c7332319c14094c,2296125b6c362355,2018-08-04,1,0,0,593,4,1,86,24,76,10,0,0,10,7,28,21,48,17,32.6,444.7
4604,866729ea2ceddb25,ab2b4ff41d6ebe0f,d2036f31c035e0d1,2018-08-04,1,0,0,226,3,0,162,67,162,0,0,0,0,0,23,17,139,67,0.0,223.0
4605,866729ea2ceddb25,d2036f31c035e0d1,ab2b4ff41d6ebe0f,2018-08-04,0,0,0,226,0,0,76,22,76,0,0,0,0,0,9,7,67,22,0.0,226.0
4606,65223fa6055df489,1ae8f3c723aacff4,a7897d200692ab64,2018-08-04,0,1,0,900,2,1,146,40,142,4,0,0,4,3,29,14,113,37,38.7,715.0
4607,65223fa6055df489,a7897d200692ab64,1ae8f3c723aacff4,2018-08-04,0,0,0,900,2,1,157,38,151,6,0,0,6,5,37,27,114,33,127.0,734.3
4608,5d8a1daadda47ace,1ebe20ebbfa15e29,b76c6268dc1d3c05,2018-08-04,0,0,0,900,2,1,194,31,192,2,0,0,2,2,87,46,105,29,10.7,852.0
4609,5d8a1daadda47ace,b76c6268dc1d3c05,1ebe20ebbfa15e29,2018-08-04,0,1,0,900,1,0,123,22,123,0,0,0,0,0,19,12,104,22,0.0,889.3
4610,520f6379fefd8fda,b6452706b373eea1,d247691a6c0e9034,2018-08-04,1,1,1,255,2,1,47,14,35,12,0,0,12,7,5,3,30,7,69.4,174.0
4611,520f6379fefd8fda,d247691a6c0e9034,b6452706b373eea1,2018-08-04,0,0,0,255,0,0,38,5,38,0,0,0,0,0,19,15,19,5,0.0,185.6
4612,3b03f8d3a55f3cb2,3a46b268013afede,dea070ed4a2a8281,2018-08-04,0,1,0,900,1,0,55,20,40,15,1,0,14,13,13,11,27,7,65.6,279.5
4613,3b03f8d3a55f3cb2,dea070ed4a2a8281,3a46b268013afede,2018-08-04,0,1,0,900,7,3,153,50,49,104,10,7,94,40,12,12,37,10,550.5,257.4
4614,ef2c7bfced561374,262a7d06203657e6,55ee431411ccf07a,2018-07-28,0,0,0,900,10,4,81,24,62,19,1,0,18,12,25,15,37,12,186.1,447.6
4615,ef2c7bfced561374,55ee431411ccf07a,262a7d06203657e6,2018-07-28,0,1,0,900,6,2,32,8,31,1,0,0,1,1,14,11,17,7,21.4,478.9
4616,e54c16d867875738,275aca31f61ba28c,633a45d131192ffe,2018-07-28,0,1,1,283,1,1,18,6,9,9,0,0,9,6,1,1,8,0,88.0,195.0
4617,e54c16d867875738,633a45d131192ffe,275aca31f61ba28c,2018-07-28,0,0,0,283,0,0,17,0,17,0,0,0,0,0,11,7,6,0,0.0,195.0
4618,d441715577c5934c,4a57ebb14315b251,d343df8ba11f4c4e,2018-07-28,0,0,0,900,11,1,72,20,61,11,2,2,9,4,2,1,59,16,297.0,582.0
4619,d441715577c5934c,d343df8ba11f4c4e,4a57ebb14315b251,2018-07-28,0,0,0,900,0,0,118,20,111,7,0,0,7,4,34,29,77,16,21.0,570.0
4620,c4253cb471013765,4c2d90e335e6df19,e872e9a9a902c045,2018-07-28,0,0,0,900,2,1,201,24,201,0,0,0,0,0,60,46,141,24,0.0,881.0
4621,c4253cb471013765,e872e9a9a902c045,4c2d90e335e6df19,2018-07-28,0,0,0,900,0,0,202,50,202,0,0,0,0,0,14,12,188,50,0.0,900.0
4622,bd1fc4ff619f4e61,029eaff01e6bb8f0,33a331684283900f,2018-07-28,1,2,0,545,0,0,115,44,115,0,0,0,0,0,14,10,101,44,0.0,441.3
4623,bd1fc4ff619f4e61,33a331684283900f,029eaff01e6bb8f0,2018-07-28,0,1,0,545,3,0,76,10,70,6,3,2,3,2,20,14,50,8,98.7,397.0
4624,95f37dc43e808ebf,af997f7611673880,cd13728ae1151f46,2018-07-28,0,0,0,265,8,3,18,8,12,6,0,0,6,3,4,4,8,5,75.4,64.0
4625,95f37dc43e808ebf,cd13728ae1151f46,af997f7611673880,2018-07-28,1,0,0,265,0,0,46,27,46,0,0,0,0,0,15,13,31,27,0.0,161.6
4626,77be83973766e104,2aa49b3766a59bcd,cdb96af67d096b1e,2018-07-28,0,0,0,900,4,3,38,9,26,12,2,1,10,7,4,4,22,2,543.0,251.0
4627,77be83973766e104,cdb96af67d096b1e,2aa49b3766a59bcd,2018-07-28,0,1,0,900,0,0,67,15,57,10,0,0,10,4,8,5,49,11,106.0,251.0
4628,6b47093b62155478,18968f97ad34f15c,d0f3959b4a9747e6,2018-07-28,0,0,0,259,0,0,60,16,60,0,0,0,0,0,5,4,55,16,0.0,236.1
4629,6b47093b62155478,d0f3959b4a9747e6,18968f97ad34f15c,2018-07-28,1,0,0,259,0,0,63,21,42,21,1,1,20,11,7,7,35,10,22.9,235.0
4630,62f564662f33692d,065eb44700e641a4,74d35fbc9c6a61bd,2018-07-28,1,0,0,112,1,0,26,3,24,2,1,1,1,1,11,8,13,2,11.0,91.0
4631,62f564662f33692d,74d35fbc9c6a61bd,065eb44700e641a4,2018-07-28,0,0,0,112,0,0,23,3,22,1,0,0,1,1,4,4,18,2,10.0,91.0
4632,3249bbbb7ce837ef,4f732e58ed907eff,c21a036b4e012f1c,2018-07-28,0,0,0,900,2,0,224,51,224,0,0,0,0,0,42,28,182,51,0.0,882.0
4633,3249bbbb7ce837ef,c21a036b4e012f1c,4f732e58ed907eff,2018-07-28,0,0,0,900,0,0,261,99,261,0,0,0,0,0,50,32,211,99,0.0,900.0
4634,11c851a73ffb55ba,2c9d00968f818270,bf0e700106d00e55,2018-07-28,0,0,0,900,1,0,170,28,170,0,0,0,0,0,62,47,108,28,0.0,854.0
4635,11c851a73ffb55ba,bf0e700106d00e55,2c9d00968f818270,2018-07-28,0,0,0,900,4,0,68,22,68,0,0,0,0,0,1,1,67,22,0.0,900.0
4636,0b2ae6c368369d1b,31ef8b67e13495b3,3d6749c4267da18f,2018-07-28,0,0,0,900,10,0,78,11,78,0,0,0,0,0,34,22,44,11,0.0,617.0
4637,0b2ae6c368369d1b,3d6749c4267da18f,31ef8b67e13495b3,2018-07-28,0,0,0,900,0,0,166,21,166,0,0,0,0,0,53,41,113,21,0.0,765.0
4638,09ab925c4cfe0cc5,1a31ef98efce7a79,f53c1f4ceeed8c08,2018-07-28,0,0,0,229,0,0,16,2,16,0,0,0,0,0,8,5,8,2,0.0,225.0
4639,09ab925c4cfe0cc5,f53c1f4ceeed8c08,1a31ef98efce7a79,2018-07-28,1,0,0,229,0,0,43,6,36,7,0,0,7,3,6,2,30,3,4.0,225.0
4640,e8190df7465ba2df,103b06d8707895a9,e17ac6410c8377f4,2018-07-22,0,1,0,900,0,0,65,20,61,4,0,0,4,4,5,1,56,16,5.8,211.10000000000002
4641,e8190df7465ba2df,e17ac6410c8377f4,103b06d8707895a9,2018-07-22,0,0,0,900,9,6,48,28,23,25,5,5,20,15,3,2,20,13,675.9,110.2
4642,e0e19f79019d63d2,5e4eec08896c9423,7ff97850e8c32bda,2018-07-22,0,0,0,900,19,7,97,39,85,12,1,1,11,11,9,8,76,28,192.0,432.0
4643,e0e19f79019d63d2,7ff97850e8c32bda,5e4eec08896c9423,2018-07-22,0,1,0,900,4,0,46,15,44,2,0,0,2,2,7,5,37,13,20.0,668.0
4644,b71192c8fe23078c,776a58a67665a171,b4537562f88ac582,2018-07-22,0,0,0,900,11,6,69,37,39,30,0,0,30,26,13,8,26,11,490.5,284.1
4645,b71192c8fe23078c,b4537562f88ac582,776a58a67665a171,2018-07-22,0,0,0,900,0,0,57,24,52,5,0,0,5,4,13,8,39,20,10.9,374.5
4646,afb0d61f22e85d90,333b9e5c723ac873,ba1e6cb3d43f7430,2018-07-22,1,0,0,900,4,3,144,88,46,98,5,5,93,73,17,11,29,15,711.0,160.0
4647,afb0d61f22e85d90,ba1e6cb3d43f7430,333b9e5c723ac873,2018-07-22,0,0,0,900,1,0,26,12,26,0,0,0,0,0,2,0,24,12,0.0,189.0
4648,981ed463bf5d91a8,025f0b1b58fbad01,917a5cb9821df261,2018-07-22,1,0,0,193,0,0,16,8,5,11,0,0,11,8,4,1,1,0,12.0,181.0
4649,981ed463bf5d91a8,917a5cb9821df261,025f0b1b58fbad01,2018-07-22,0,0,0,193,1,0,16,1,16,0,0,0,0,0,3,3,13,1,0.0,181.0
4650,8784ae31153178cd,c9cf753cfdf77fc2,ebc1f40e00e0c481,2018-07-22,0,0,0,900,7,5,68,17,42,26,8,8,18,14,23,16,19,3,463.0,435.0
4651,8784ae31153178cd,ebc1f40e00e0c481,c9cf753cfdf77fc2,2018-07-22,0,0,0,900,0,0,78,20,76,2,0,0,2,1,14,11,62,19,2.0,432.0
4652,62389e8fb68f93a4,140745cbbcb023ac,d4c9dcd330403612,2018-07-22,0,0,0,89,0,0,12,0,12,0,0,0,0,0,5,4,7,0,0.0,89.0
4653,62389e8fb68f93a4,d4c9dcd330403612,140745cbbcb023ac,2018-07-22,1,0,0,89,0,0,31,21,31,0,0,0,0,0,2,2,29,21,0.0,88.0
4654,4f16ef3e707447a0,32c355b04fc57f3a,b7b84ccd221be298,2018-07-22,0,0,0,900,4,0,220,28,220,0,0,0,0,0,26,22,194,28,0.0,879.4
4655,4f16ef3e707447a0,b7b84ccd221be298,32c355b04fc57f3a,2018-07-22,1,0,0,900,2,0,198,79,181,17,0,0,17,8,18,14,163,71,20.6,866.0
4656,43af04881587abbc,31bbd39c0a075d4e,42a7e90605df3c8a,2018-07-22,0,2,0,900,1,1,77,21,65,12,1,1,11,8,12,10,53,13,75.8,528.7
4657,43af04881587abbc,42a7e90605df3c8a,31bbd39c0a075d4e,2018-07-22,0,0,0,900,8,3,49,11,41,8,1,1,7,5,19,12,22,6,251.3,447.2
4658,3ce7f58911773a56,2816ced060a21be3,38c626ca912c7bac,2018-07-22,0,0,0,900,0,0,198,32,198,0,0,0,0,0,16,11,182,32,0.0,897.7
4659,3ce7f58911773a56,38c626ca912c7bac,2816ced060a21be3,2018-07-22,1,0,0,900,0,0,155,48,154,1,0,0,1,1,28,23,126,47,2.3,893.0
4660,23e03d226eb7af80,3bb2dc8e87b10a46,a6cba6bb66c1a8c9,2018-07-22,0,5,0,900,5,2,64,21,59,5,1,1,4,4,12,11,47,17,50.6,224.5
4661,23e03d226eb7af80,a6cba6bb66c1a8c9,3bb2dc8e87b10a46,2018-07-22,0,1,0,900,2,0,87,32,46,41,6,6,35,24,8,7,38,8,513.5,323.4
4662,20bbf7e139c73e8d,46d0a888d87d91ac,4bcb6eb12b4ad4aa,2018-07-22,0,0,0,900,1,1,128,33,112,16,0,0,16,13,19,15,93,20,132.0,486.0
4663,20bbf7e139c73e8d,4bcb6eb12b4ad4aa,46d0a888d87d91ac,2018-07-22,0,1,0,900,4,3,45,10,37,8,2,2,6,2,11,7,26,8,216.0,471.0
4664,110a49a43aafe044,113df4fde64735c6,2dc1bc1a02961656,2018-07-22,0,0,0,59,0,0,6,1,6,0,0,0,0,0,4,3,2,1,0.0,21.0
4665,110a49a43aafe044,2dc1bc1a02961656,113df4fde64735c6,2018-07-22,1,2,1,59,0,0,5,3,4,1,0,0,1,1,0,0,4,2,21.0,38.0
4666,cda0d9b5ce9b9c12,51a0c09cbe9b8472,8e1f36476ef02a6a,2018-07-14,0,0,0,900,4,3,78,32,58,20,5,5,15,14,16,16,42,18,279.1,562.4
4667,cda0d9b5ce9b9c12,8e1f36476ef02a6a,51a0c09cbe9b8472,2018-07-14,0,0,0,900,0,0,104,19,102,2,0,0,2,2,32,23,70,17,16.6,471.9
4668,c3939438ae7934df,08e908ed6d18d6a0,b5b684eac99ae0a3,2018-07-14,0,0,0,172,0,0,12,0,12,0,0,0,0,0,6,3,6,0,0.0,146.0
4669,c3939438ae7934df,b5b684eac99ae0a3,08e908ed6d18d6a0,2018-07-14,1,0,0,172,0,0,27,16,5,22,0,0,22,15,3,1,2,1,26.0,146.0
4670,c1677875a80c2584,ac5a7400da3a9a41,f57dd0bfa8c17813,2018-07-14,0,0,0,420,0,0,54,6,54,0,0,0,0,0,18,13,36,6,0.0,353.5
4671,c1677875a80c2584,f57dd0bfa8c17813,ac5a7400da3a9a41,2018-07-14,0,1,1,420,3,2,44,20,39,5,0,0,5,5,8,5,31,15,66.5,287.0
4672,b25eacaca1499e30,80daefbed11ce998,fc9a9559a05f2704,2018-07-14,0,0,0,900,2,0,214,40,214,0,0,0,0,0,17,13,197,40,0.0,893.5
4673,b25eacaca1499e30,fc9a9559a05f2704,80daefbed11ce998,2018-07-14,0,0,0,900,0,0,183,23,182,1,0,0,1,0,48,25,134,23,3.5,893.0
4674,a3dd2249d046cf9d,c6aee362c7a7d482,d8da10db80131bec,2018-07-14,0,0,0,369,2,1,37,9,29,8,0,0,8,2,8,4,21,7,52.8,192.0
4675,a3dd2249d046cf9d,d8da10db80131bec,c6aee362c7a7d482,2018-07-14,1,0,0,369,2,1,39,9,27,12,0,0,12,9,6,3,21,0,78.0,212.2
4676,7fe2b6a9fc4748fa,411539901068522f,8f382b3baa954d2a,2018-07-14,0,0,0,900,2,0,190,54,190,0,0,0,0,0,38,27,152,54,0.0,813.0
4677,7fe2b6a9fc4748fa,8f382b3baa954d2a,411539901068522f,2018-07-14,0,0,0,900,6,0,199,83,199,0,0,0,0,0,49,45,150,83,0.0,806.0
4678,786296db3c4749f1,6f242453c91a5af0,814ff3018127e8fc,2018-07-14,0,0,0,900,14,6,114,25,100,14,1,0,13,8,26,17,74,17,190.1,623.5
4679,786296db3c4749f1,814ff3018127e8fc,6f242453c91a5af0,2018-07-14,0,1,0,900,0,0,137,32,131,6,0,0,6,5,27,16,104,27,18.5,675.9
4680,691c0d2f30e4de5a,3ecd936bd8814108,c7d297714d9ab1a4,2018-07-14,0,0,0,900,10,6,57,14,32,25,8,4,17,9,17,15,15,5,392.6,366.0
4681,691c0d2f30e4de5a,c7d297714d9ab1a4,3ecd936bd8814108,2018-07-14,0,0,0,900,0,0,39,10,39,0,0,0,0,0,5,4,34,10,0.0,431.4
4682,67018331e90a9949,92a9aa9c93192871,e1248941344b3288,2018-07-14,0,0,0,900,6,1,172,66,172,0,0,0,0,0,25,16,147,66,0.0,833.0
4683,67018331e90a9949,e1248941344b3288,92a9aa9c93192871,2018-07-14,2,3,0,900,12,2,144,76,143,1,0,0,1,1,26,24,117,75,8.0,693.0
4684,66ba984cc547e31a,a7151778b3381036,b9f28e7045fdfce7,2018-07-14,0,0,0,689,3,1,226,88,216,10,0,0,10,8,20,14,196,80,21.1,578.1
4685,66ba984cc547e31a,b9f28e7045fdfce7,a7151778b3381036,2018-07-14,1,0,0,689,4,3,146,76,138,8,1,1,7,6,7,5,131,70,72.9,512.9
4686,543de77637ad2a20,47cd337b86b1af92,ed9d8ee3a4239b1c,2018-07-14,1,1,0,493,4,1,16,5,4,12,2,1,10,3,0,0,4,2,270.9,139.0
4687,543de77637ad2a20,ed9d8ee3a4239b1c,47cd337b86b1af92,2018-07-14,1,1,0,493,1,1,37,18,28,9,1,1,8,6,8,5,20,12,38.0,129.10000000000002
4688,48d21357134ca51a,0fd5f4b838e890cc,9fa568ad2bf2cb0b,2018-07-14,0,0,0,900,11,1,113,40,106,7,0,0,7,6,30,25,76,34,38.2,780.0
4689,48d21357134ca51a,9fa568ad2bf2cb0b,0fd5f4b838e890cc,2018-07-14,0,0,0,900,1,0,87,18,85,2,0,0,2,1,25,14,60,17,0.0,861.8
4690,35ebaf80f8730b14,1788eee370f077b7,63def5a5662a6917,2018-07-14,0,0,0,1500,0,0,229,40,229,0,0,0,0,0,16,11,213,40,0.0,1497.0
4691,35ebaf80f8730b14,63def5a5662a6917,1788eee370f077b7,2018-07-14,0,0,0,1500,1,0,248,66,248,0,0,0,0,0,78,44,170,66,0.0,1500.0
4692,fccedc456048216b,d28dee5c705991df,d967f0128c323de6,2018-07-07,0,0,0,273,1,1,51,15,51,0,0,0,0,0,10,9,41,15,0.0,189.0
4693,fccedc456048216b,d967f0128c323de6,d28dee5c705991df,2018-07-07,1,0,0,273,0,0,37,20,33,4,0,0,4,4,7,5,26,16,4.0,267.0
4694,d3f26e0fbf694375,c58f51dedb310998,cbb682f5fcc44bfc,2018-07-07,0,0,0,352,6,2,26,4,24,2,0,0,2,1,9,8,15,3,63.2,151.3
4695,d3f26e0fbf694375,cbb682f5fcc44bfc,c58f51dedb310998,2018-07-07,0,2,1,352,0,0,22,3,20,2,0,0,2,1,9,6,11,2,42.7,224.8
4696,c9e4aa12aaa7309e,2e5c2aa8e4ab9d82,65578a75fa7900e3,2018-07-07,1,0,0,458,0,0,116,39,114,2,0,0,2,1,43,36,71,38,1.5,450.0
4697,c9e4aa12aaa7309e,65578a75fa7900e3,2e5c2aa8e4ab9d82,2018-07-07,0,0,0,458,1,0,122,45,122,0,0,0,0,0,20,13,102,45,0.0,453.5
4698,c931097a857ed60c,882d62561063a927,b3d21b2610dcfaeb,2018-07-07,0,0,0,900,3,0,117,24,114,3,0,0,3,2,36,26,78,22,16.3,629.1
4699,c931097a857ed60c,b3d21b2610dcfaeb,882d62561063a927,2018-07-07,0,0,0,900,2,1,183,33,168,15,2,2,13,9,22,18,146,24,232.9,588.7
4700,bd97a96ac8203457,193b9d1858bc4df3,23024fdfc966410a,2018-07-07,2,1,0,148,0,0,34,12,31,3,0,0,3,3,11,10,20,9,15.0,133.0
4701,bd97a96ac8203457,23024fdfc966410a,193b9d1858bc4df3,2018-07-07,0,0,0,148,1,0,28,5,28,0,0,0,0,0,12,8,16,5,0.0,133.0
4702,9bd9a8127b55fbf7,8d03ce87ca14e778,d3df1add9d9a7efb,2018-07-07,0,0,0,900,0,0,46,7,46,0,0,0,0,0,7,4,39,7,0.0,900.0
4703,9bd9a8127b55fbf7,d3df1add9d9a7efb,8d03ce87ca14e778,2018-07-07,0,0,0,900,2,0,54,1,54,0,0,0,0,0,28,19,26,1,0.0,899.0
4704,9589b41c4637b057,b0d6a1d8ac3d563d,f1928a52590c5532,2018-07-07,0,0,0,900,2,1,99,28,88,11,0,0,11,9,24,16,64,19,201.9,638.2
4705,9589b41c4637b057,f1928a52590c5532,b0d6a1d8ac3d563d,2018-07-07,0,0,0,900,1,1,94,23,92,2,0,0,2,2,23,15,69,21,4.8,679.1
4706,7a3947a0e7bc3558,e5010b1b94ca5755,f2b6fdb20675b11c,2018-07-07,0,0,0,900,1,0,120,27,119,1,0,0,1,1,41,29,78,26,4.5,832.2
4707,7a3947a0e7bc3558,f2b6fdb20675b11c,e5010b1b94ca5755,2018-07-07,0,0,0,900,3,2,110,34,107,3,0,0,3,3,32,28,75,31,22.8,713.5
4708,55bd050afe169b34,4690d47bf725fd98,749f572d1d3161fb,2018-07-07,0,0,0,96,0,0,11,2,11,0,0,0,0,0,4,3,7,2,0.0,91.0
4709,55bd050afe169b34,749f572d1d3161fb,4690d47bf725fd98,2018-07-07,1,0,0,96,0,0,17,9,11,6,0,0,6,6,0,0,11,3,5.0,91.0
4710,2817a6f9e09eb15f,7cbf7c78d3b34218,f9b200db02b488d9,2018-07-07,0,0,0,900,4,1,98,29,98,0,0,0,0,0,30,26,68,29,0.0,702.0
4711,2817a6f9e09eb15f,f9b200db02b488d9,7cbf7c78d3b34218,2018-07-07,0,0,0,900,4,1,133,18,133,0,0,0,0,0,53,32,80,18,0.0,838.0
4712,148c26038e80465b,05339613bf8e9808,2f13e4020cea5b38,2018-07-07,0,0,0,900,0,0,122,12,122,0,0,0,0,0,17,8,105,12,0.0,638.9
4713,148c26038e80465b,2f13e4020cea5b38,05339613bf8e9808,2018-07-07,0,0,0,900,2,2,120,41,96,24,1,1,23,16,21,12,75,25,261.1,628.0
4714,ca3963b76a38c408,d9c6f19f958643e9,f5f6419c5f00abad,2018-07-06,0,1,0,900,10,3,69,29,49,20,0,0,20,18,19,9,30,11,90.0,309.9
4715,ca3963b76a38c408,f5f6419c5f00abad,d9c6f19f958643e9,2018-07-06,0,0,0,900,4,3,107,34,67,40,9,7,31,23,10,10,57,11,455.1,298.0
4716,b3caae587e956f54,01784fbc27c68b14,80d8aed0ca9b00f3,2018-07-06,0,1,0,861,0,0,96,23,96,0,0,0,0,0,27,17,69,23,0.0,683.8
4717,b3caae587e956f54,80d8aed0ca9b00f3,01784fbc27c68b14,2018-07-06,0,1,1,861,6,0,149,46,129,20,0,0,20,15,15,10,114,31,175.2,607.0
4718,9fc03704a10977b3,3956bdc8ab2e54b3,523af801b3429015,2018-07-06,0,0,0,900,19,8,71,22,69,2,0,0,2,2,10,5,59,20,148.4,232.0
4719,9fc03704a10977b3,523af801b3429015,3956bdc8ab2e54b3,2018-07-06,0,1,0,900,0,0,112,33,111,1,1,1,0,0,33,25,78,33,0.0,751.6
4720,7c2b219fe208c565,4498b382c65a7faa,472f6f6e6d962f40,2018-07-06,1,0,0,512,1,1,129,50,79,50,0,0,50,31,1,1,78,19,324.0,188.0
4721,7c2b219fe208c565,472f6f6e6d962f40,4498b382c65a7faa,2018-07-06,0,0,0,512,1,0,80,23,80,0,0,0,0,0,4,1,76,23,0.0,188.0
4722,760b90b0805e0fbf,77d7295d1b22c694,d0e1b42d41dab603,2018-07-06,0,0,0,900,6,4,116,30,109,7,0,0,7,1,26,20,83,29,185.1,662.0
4723,760b90b0805e0fbf,d0e1b42d41dab603,77d7295d1b22c694,2018-07-06,0,2,0,900,1,0,147,28,147,0,0,0,0,0,27,19,120,28,0.0,711.9
4724,674f3fa16e717ff1,7aa3d6964eff4877,9c44f290f5726d95,2018-07-06,0,0,0,900,1,0,159,60,156,3,0,0,3,0,25,22,131,60,10.8,772.0
4725,674f3fa16e717ff1,9c44f290f5726d95,7aa3d6964eff4877,2018-07-06,0,0,0,900,9,3,236,61,226,10,3,3,7,2,29,14,197,59,85.0,668.2
4726,4d549f33c0711a7a,0b8d512c79b4baf3,b93c06d09d1c4ac0,2018-07-06,0,0,0,900,3,0,141,42,139,2,0,0,2,2,20,15,119,40,11.5,652.6
4727,4d549f33c0711a7a,b93c06d09d1c4ac0,0b8d512c79b4baf3,2018-07-06,0,1,0,900,6,2,175,44,161,14,0,0,14,12,34,30,127,32,155.4,455.5
4728,4caa0dcdaa253612,2844b047183a1adb,f75c5ca0d91b9115,2018-07-06,1,1,1,212,1,1,23,8,21,2,0,0,2,0,1,0,20,8,40.7,51.0
4729,4caa0dcdaa253612,f75c5ca0d91b9115,2844b047183a1adb,2018-07-06,0,0,0,212,3,2,9,3,5,4,2,2,2,2,2,2,3,1,100.0,71.3
4730,363b72bf7f75091c,1cf7ccf64a5bf24e,6ac9bc2953c47345,2018-07-06,1,2,0,595,1,1,53,17,49,4,0,0,4,2,7,6,42,15,73.1,312.9
4731,363b72bf7f75091c,6ac9bc2953c47345,1cf7ccf64a5bf24e,2018-07-06,0,2,1,595,4,3,104,43,71,33,3,3,30,19,6,5,65,24,81.1,371.9
4732,247f9e56965a1c07,0c6d9ea8306c029e,1338e2c7480bdf9e,2018-07-06,0,0,0,1500,12,1,174,34,172,2,0,0,2,2,11,6,161,32,25.2,1332.1
4733,247f9e56965a1c07,1338e2c7480bdf9e,0c6d9ea8306c029e,2018-07-06,0,1,0,1500,2,0,215,61,206,9,0,0,9,8,71,58,135,53,41.9,1367.8
4734,1d8e2e8e3bd28cad,5bf31a46becc1204,946db8a378903cc3,2018-07-06,0,1,0,900,0,0,71,9,67,4,0,0,4,2,45,33,22,7,339.0,504.0
4735,1d8e2e8e3bd28cad,946db8a378903cc3,5bf31a46becc1204,2018-07-06,0,0,0,900,6,1,75,3,73,2,0,0,2,0,32,26,41,3,57.0,390.0
4736,1901d27ea35ae733,683ea28a198936fe,7b433309b0fd12aa,2018-07-06,0,0,0,900,1,0,64,8,63,1,0,0,1,0,9,6,54,8,0.0,401.0
4737,1901d27ea35ae733,7b433309b0fd12aa,683ea28a198936fe,2018-07-06,0,0,0,900,7,2,111,42,81,30,4,3,26,18,33,26,48,24,499.0,401.0
4738,d80b0bea0e260b95,c41d426cc7326d1b,d50382dc0565a9e1,2018-06-23,0,0,0,900,0,0,227,42,227,0,0,0,0,0,53,29,174,42,0.0,900.0
4739,d80b0bea0e260b95,d50382dc0565a9e1,c41d426cc7326d1b,2018-06-23,0,0,0,900,0,0,212,34,212,0,0,0,0,0,23,10,189,34,0.0,900.0
4740,d5176b45df32f67e,199eb7cf6ae90294,67c1d46f4ed16f9e,2018-06-23,0,0,0,900,1,0,196,35,196,0,0,0,0,0,24,13,172,35,0.0,863.0
4741,d5176b45df32f67e,67c1d46f4ed16f9e,199eb7cf6ae90294,2018-06-23,0,0,0,900,1,0,183,43,183,0,0,0,0,0,42,28,141,43,0.0,900.0
4742,c5c5f678558a0ba2,71002dbc1743b9a7,efb96bf3e9ada36f,2018-06-23,0,0,0,599,2,0,31,7,31,0,0,0,0,0,4,1,27,7,0.0,259.5
4743,c5c5f678558a0ba2,efb96bf3e9ada36f,71002dbc1743b9a7,2018-06-23,1,1,0,599,1,1,100,26,68,32,5,5,27,16,15,8,53,10,323.5,225.0
4744,bb7408d59b7279f7,4cd8b03aee1d0138,55ed59d541f8b90c,2018-06-23,1,0,0,580,5,1,215,74,215,0,0,0,0,0,32,30,183,74,0.0,476.0
4745,bb7408d59b7279f7,55ed59d541f8b90c,4cd8b03aee1d0138,2018-06-23,0,0,0,580,0,0,152,41,152,0,0,0,0,0,21,16,131,41,0.0,580.0
4746,bb4755924dfafaea,49e96ff8ab781589,50db8711c70196cd,2018-06-23,1,1,0,174,4,0,12,5,12,0,0,0,0,0,6,4,6,5,0.0,61.0
4747,bb4755924dfafaea,50db8711c70196cd,49e96ff8ab781589,2018-06-23,0,1,1,174,1,0,12,5,8,4,0,0,4,3,3,2,5,2,34.0,140.0
4748,b125025990755616,32490e80ddab1e5a,c487223b0289bda9,2018-06-23,1,0,0,585,0,0,71,17,64,7,0,0,7,5,19,15,45,12,4.0,570.0
4749,b125025990755616,c487223b0289bda9,32490e80ddab1e5a,2018-06-23,0,0,0,585,2,2,90,17,89,1,0,0,1,1,31,22,58,16,11.0,570.0
4750,ab6cd718c5459eeb,4665f9f909cd7214,a845f0735bc67405,2018-06-23,0,0,0,164,1,0,5,0,5,0,0,0,0,0,1,1,4,0,0.0,91.6
4751,ab6cd718c5459eeb,a845f0735bc67405,4665f9f909cd7214,2018-06-23,0,1,1,164,1,1,19,9,16,3,0,0,3,2,3,3,13,7,16.4,104.0
4752,8167bd097a16062f,88cd34d836b4ebcd,d661ce4da776fc20,2018-06-23,0,0,0,208,2,0,30,4,30,0,0,0,0,0,12,7,18,4,0.0,186.4
4753,8167bd097a16062f,d661ce4da776fc20,88cd34d836b4ebcd,2018-06-23,2,0,0,208,0,0,40,18,32,8,0,0,8,5,8,7,24,13,3.6,204.0
4754,484c48d3723e72cd,5140122c3eecd307,e64b96c07d7ce999,2018-06-23,0,0,0,900,0,0,154,24,154,0,0,0,0,0,31,21,123,24,0.0,900.0
4755,484c48d3723e72cd,e64b96c07d7ce999,5140122c3eecd307,2018-06-23,0,0,0,900,0,0,206,32,206,0,0,0,0,0,95,64,111,32,0.0,900.0
4756,3d12c63c47828937,8c020156779f7888,a20f234df70f2182,2018-06-23,0,0,0,900,1,0,173,39,173,0,0,0,0,0,46,33,127,39,0.0,898.0
4757,3d12c63c47828937,a20f234df70f2182,8c020156779f7888,2018-06-23,0,0,0,900,0,0,241,46,241,0,0,0,0,0,36,27,205,46,0.0,754.0
4758,28c70663b99560a8,1d00756835ca67c9,f1fac969a1d70b08,2018-06-23,0,0,0,1500,9,1,131,17,130,1,0,0,1,1,64,43,66,16,10.2,1337.0
4759,28c70663b99560a8,f1fac969a1d70b08,1d00756835ca67c9,2018-06-23,0,0,0,1500,4,0,166,37,166,0,0,0,0,0,61,47,105,37,0.0,1441.8
4760,26582aa0b79d2f20,7c3c48cf54a2848e,ec664422b22d9787,2018-06-23,0,1,1,544,7,5,56,18,22,34,4,2,30,13,6,5,16,5,358.3,121.0
4761,26582aa0b79d2f20,ec664422b22d9787,7c3c48cf54a2848e,2018-06-23,0,0,0,544,0,0,14,4,12,2,0,0,2,2,4,3,8,2,12.0,173.7
4762,2242e7df6f320ea6,6c8072b61c276e67,f72465a784c1b084,2018-06-23,0,0,0,900,0,0,139,30,137,2,0,0,2,1,28,21,109,29,0.6,773.0
4763,2242e7df6f320ea6,f72465a784c1b084,6c8072b61c276e67,2018-06-23,0,0,0,900,2,1,225,38,217,8,4,4,4,3,39,25,178,35,125.0,774.4
4764,eb6f80ccaf2a3dbc,6a2f7c151031653d,dc9572dd6ec74859,2018-06-09,0,0,0,1500,6,3,198,54,195,3,3,3,0,0,56,48,139,54,11.5,1281.9
4765,eb6f80ccaf2a3dbc,dc9572dd6ec74859,6a2f7c151031653d,2018-06-09,0,0,0,1500,18,7,296,54,294,2,0,0,2,1,67,45,227,53,84.1,731.5
4766,e82d734674ce4d46,07225ba28ae309b6,c47df9303d318c67,2018-06-09,0,1,1,138,0,0,29,6,29,0,0,0,0,0,11,8,18,6,0.0,136.0
4767,e82d734674ce4d46,c47df9303d318c67,07225ba28ae309b6,2018-06-09,0,0,0,138,1,0,25,4,25,0,0,0,0,0,5,5,20,4,0.0,138.0
4768,d3f5854d16fc31f9,82a5152216251682,bc656db347f31e19,2018-06-09,1,0,0,50,1,1,27,25,5,22,0,0,22,21,0,0,5,4,28.2,18.0
4769,d3f5854d16fc31f9,bc656db347f31e19,82a5152216251682,2018-06-09,0,0,0,50,0,0,1,0,1,0,0,0,0,0,0,0,1,0,0.0,21.8
4770,c3425412e4f2f486,d910665038efc639,ec34349e7dffcde7,2018-06-09,0,0,0,900,4,2,103,33,91,12,0,0,12,8,14,10,77,25,107.5,469.3
4771,c3425412e4f2f486,ec34349e7dffcde7,d910665038efc639,2018-06-09,0,1,0,900,5,4,64,23,59,5,1,1,4,2,4,2,55,21,215.7,490.5
4772,8f9b16f170dbdbb6,d4c9dcd330403612,ee779c43a8926d52,2018-06-09,1,0,0,53,1,0,9,4,7,2,0,0,2,2,2,2,5,2,1.6,49.0
4773,8f9b16f170dbdbb6,ee779c43a8926d52,d4c9dcd330403612,2018-06-09,0,0,0,53,1,0,6,1,6,0,0,0,0,0,0,0,6,1,0.0,36.4
4774,7fd0f7b3866b2c75,b4ad3a06ee4d660c,fa6796c55d6c5440,2018-06-09,0,2,0,776,0,0,12,3,10,2,0,0,2,1,4,4,6,2,0.0,486.9
4775,7fd0f7b3866b2c75,fa6796c55d6c5440,b4ad3a06ee4d660c,2018-06-09,1,0,0,776,4,4,53,32,30,23,4,4,19,18,1,1,29,14,289.1,311.0
4776,64756e0f4b305da8,0641c21bec209472,a8c9d16fe2a14d72,2018-06-09,0,0,0,900,1,1,108,54,82,26,3,3,23,15,10,7,72,39,276.1,417.1
4777,64756e0f4b305da8,a8c9d16fe2a14d72,0641c21bec209472,2018-06-09,0,0,0,900,9,1,81,10,78,3,0,0,3,2,18,9,60,8,36.9,451.9
4778,5e2f2f5d9a756de9,80eacd4da0617c57,de75d1c45a39e221,2018-06-09,0,0,0,900,14,2,186,28,186,0,0,0,0,0,58,31,128,28,0.0,636.0
4779,5e2f2f5d9a756de9,de75d1c45a39e221,80eacd4da0617c57,2018-06-09,0,0,0,900,0,0,168,69,167,1,0,0,1,1,13,5,154,68,0.0,900.0
4780,5a09fd7cb3db9705,e1147d3d2dabe1ce,f77c68bb4be8516d,2018-06-09,0,0,0,1500,1,0,326,57,325,1,0,0,1,0,101,71,224,57,2.1,1367.7
4781,5a09fd7cb3db9705,f77c68bb4be8516d,e1147d3d2dabe1ce,2018-06-09,2,0,0,1500,10,3,240,76,217,23,2,2,21,18,44,33,173,58,95.3,1236.9
4782,32990cbf8976d94b,3974fa35c917af1d,cbd3e590a85b18c5,2018-06-09,0,2,0,900,4,0,62,8,60,2,0,0,2,0,28,26,32,8,4.9,769.7
4783,32990cbf8976d94b,cbd3e590a85b18c5,3974fa35c917af1d,2018-06-09,0,0,0,900,4,2,89,12,85,4,2,2,2,0,22,17,63,12,76.3,380.1
4784,319b09306094259b,3738e68d2261e60f,c62fbc117d57b943,2018-06-09,0,0,0,900,2,0,125,32,123,2,0,0,2,0,28,19,95,32,8.4,862.0
4785,319b09306094259b,c62fbc117d57b943,3738e68d2261e60f,2018-06-09,1,0,0,900,0,0,120,36,120,0,0,0,0,0,22,18,98,36,0.0,792.6
4786,140e810f952714ea,d1528ac5675558b1,e51ee8ded927fc51,2018-06-09,0,0,0,533,1,0,57,26,57,0,0,0,0,0,5,4,52,26,0.0,318.7
4787,140e810f952714ea,e51ee8ded927fc51,d1528ac5675558b1,2018-06-09,1,2,0,533,4,3,79,36,57,22,0,0,22,18,4,4,53,18,213.3,213.0
4788,051124b25d576906,634e2fb70bde3fd5,a0e75f4a13eb73f1,2018-06-09,0,1,0,900,8,4,71,27,45,26,2,2,24,18,22,18,23,9,464.4,257.0
4789,051124b25d576906,a0e75f4a13eb73f1,634e2fb70bde3fd5,2018-06-09,0,0,0,900,0,0,58,15,58,0,0,0,0,0,16,11,42,15,0.0,435.6
4790,f43f9861e73739c8,03f982ca3735070c,f86cb5f25d545e0e,2018-06-01,1,0,0,599,0,0,79,19,68,11,0,0,11,9,18,10,50,10,8.5,589.0
4791,f43f9861e73739c8,f86cb5f25d545e0e,03f982ca3735070c,2018-06-01,0,0,0,599,0,0,42,1,42,0,0,0,0,0,25,16,17,1,0.0,590.5
4792,b7c7707ccea492c7,484acc7b0f856ce9,d81ac739417d7f53,2018-06-01,1,0,0,116,0,0,21,7,18,3,0,0,3,2,4,3,14,5,0.0,116.0
4793,b7c7707ccea492c7,d81ac739417d7f53,484acc7b0f856ce9,2018-06-01,0,0,0,116,0,0,9,4,9,0,0,0,0,0,1,1,8,4,0.0,76.0
4794,a25633b1494f1360,2747c60e42d9d75f,6fb1ba67bef41b37,2018-06-01,0,0,0,900,0,0,187,31,187,0,0,0,0,0,46,36,141,31,0.0,894.0
4795,a25633b1494f1360,6fb1ba67bef41b37,2747c60e42d9d75f,2018-06-01,0,0,0,900,5,0,144,31,144,0,0,0,0,0,37,30,107,31,0.0,856.0
4796,9fb0a4e18ddcd14c,4234f0097c83fa62,729d4bd5a6cd0a97,2018-06-01,0,0,0,900,4,2,213,51,197,16,0,0,16,11,34,24,163,40,232.0,607.0
4797,9fb0a4e18ddcd14c,729d4bd5a6cd0a97,4234f0097c83fa62,2018-06-01,0,0,0,900,2,0,125,35,122,3,0,0,3,3,24,14,98,32,3.0,658.0
4798,9cb4196446f3ce79,1291edf2d566a71a,fbf0537e420e698e,2018-06-01,0,1,1,775,1,0,178,37,172,6,0,0,6,3,37,26,135,34,28.2,695.0
4799,9cb4196446f3ce79,fbf0537e420e698e,1291edf2d566a71a,2018-06-01,0,0,0,775,2,0,102,5,102,0,0,0,0,0,55,32,47,5,0.0,654.8
4800,921a8db065cd8cc5,84ff027394f7e470,c77a953488e5607d,2018-06-01,0,2,1,546,9,7,26,11,18,8,1,1,7,5,1,1,17,6,289.8,75.0
4801,921a8db065cd8cc5,c77a953488e5607d,84ff027394f7e470,2018-06-01,0,0,0,546,0,0,22,6,22,0,0,0,0,0,1,1,21,6,0.0,256.2
4802,7969abc596485189,81d9df19e255b8b6,d2036f31c035e0d1,2018-06-01,0,0,0,475,5,2,69,17,58,11,3,3,8,8,13,11,45,9,132.7,262.6
4803,7969abc596485189,d2036f31c035e0d1,81d9df19e255b8b6,2018-06-01,1,0,0,475,3,1,62,14,56,6,1,1,5,4,10,7,46,10,19.4,300.3
4804,69b147aaaafeb47d,9c907996820d2d69,fea79f9bc8c68769,2018-06-01,0,0,0,33,0,0,3,0,3,0,0,0,0,0,0,0,3,0,0.0,33.0
4805,69b147aaaafeb47d,fea79f9bc8c68769,9c907996820d2d69,2018-06-01,1,0,0,33,0,0,9,6,3,6,0,0,6,5,1,1,2,1,0.0,33.0
4806,4b155647201d549e,329e403448756217,528c24b99fbaab79,2018-06-01,0,1,1,438,0,0,97,20,97,0,0,0,0,0,24,13,73,20,0.0,397.0
4807,4b155647201d549e,528c24b99fbaab79,329e403448756217,2018-06-01,0,0,0,438,1,0,88,27,88,0,0,0,0,0,16,10,72,27,0.0,435.0
4808,19fc916df1f0e6ff,75e5fec9f72910ef,f046d724d2a84ac5,2018-06-01,0,0,0,900,3,0,178,20,178,0,0,0,0,0,19,8,159,20,0.0,900.0
4809,19fc916df1f0e6ff,f046d724d2a84ac5,75e5fec9f72910ef,2018-06-01,0,0,0,900,0,0,191,61,191,0,0,0,0,0,31,16,160,61,0.0,900.0
4810,194d73490eb731c6,d156513a19acf856,fcd448a2fe1a23cc,2018-06-01,1,0,0,900,0,0,122,40,121,1,0,0,1,0,18,13,103,40,0.0,900.0
4811,194d73490eb731c6,fcd448a2fe1a23cc,d156513a19acf856,2018-06-01,0,0,0,900,0,0,133,20,133,0,0,0,0,0,42,30,91,20,0.0,894.0
4812,026c4a26106cc158,1ddb480b601cefb1,b1b0729d27936f2f,2018-06-01,0,0,0,900,3,0,123,8,123,0,0,0,0,0,21,8,102,8,0.0,797.5
4813,026c4a26106cc158,b1b0729d27936f2f,1ddb480b601cefb1,2018-06-01,0,1,0,900,4,3,130,45,125,5,0,0,5,5,31,25,94,40,102.5,777.0
4814,f71d46f804307bd2,34f88592c0ab7a54,f797f0c57a83353e,2018-05-27,0,0,0,900,0,0,138,37,134,4,0,0,4,3,55,40,79,34,11.3,623.6
4815,f71d46f804307bd2,f797f0c57a83353e,34f88592c0ab7a54,2018-05-27,0,0,0,900,11,3,81,14,76,5,0,0,5,3,33,27,43,11,35.4,626.7
4816,f6efb09c01e4cac6,040a74bb0a465c54,69f01b25dfabaf6b,2018-05-27,0,1,1,761,0,0,90,21,90,0,0,0,0,0,14,8,76,21,0.0,346.0
4817,f6efb09c01e4cac6,69f01b25dfabaf6b,040a74bb0a465c54,2018-05-27,0,0,0,761,12,6,56,13,49,7,1,0,6,3,9,7,40,10,406.0,297.0
4818,cd117bfce747184f,4a28cb716c19157a,9ce6d5a03af801b7,2018-05-27,0,0,0,1500,1,0,126,8,126,0,0,0,0,0,34,22,92,8,0.0,1500.0
4819,cd117bfce747184f,9ce6d5a03af801b7,4a28cb716c19157a,2018-05-27,1,0,0,1500,0,0,126,18,126,0,0,0,0,0,39,20,87,18,0.0,1486.0
4820,b3096e8dd4e90718,016a8d958883167c,2eeaefbfc7f9fcff,2018-05-27,0,0,0,900,2,2,89,10,89,0,0,0,0,0,38,28,51,10,0.0,719.0
4821,b3096e8dd4e90718,2eeaefbfc7f9fcff,016a8d958883167c,2018-05-27,0,0,0,900,1,1,75,13,75,0,0,0,0,0,31,27,44,13,0.0,449.0
4822,9dcf8ce308eaa050,49858bf46dabf6fb,6f7c616b98e18c29,2018-05-27,0,0,0,271,2,1,12,1,12,0,0,0,0,0,6,5,6,1,0.0,170.8
4823,9dcf8ce308eaa050,6f7c616b98e18c29,49858bf46dabf6fb,2018-05-27,0,1,1,271,3,1,39,11,20,19,0,0,19,9,12,7,8,2,89.2,163.0
4824,8b1dc96a00a8e881,1588b787bda7b540,bdcbb976816fd256,2018-05-27,1,0,0,213,0,0,44,21,42,2,0,0,2,1,3,2,39,20,1.0,212.0
4825,8b1dc96a00a8e881,bdcbb976816fd256,1588b787bda7b540,2018-05-27,0,0,0,213,0,0,28,1,28,0,0,0,0,0,9,5,19,1,0.0,212.0
4826,52565f62fb3822db,87a1dc546b1c5caf,bb1a2cdad6ff34db,2018-05-27,0,0,0,900,5,3,62,25,48,14,1,1,13,8,1,1,47,17,14.0,886.0
4827,52565f62fb3822db,bb1a2cdad6ff34db,87a1dc546b1c5caf,2018-05-27,2,1,0,900,1,0,88,10,88,0,0,0,0,0,36,19,52,10,0.0,472.0
4828,426ca5caeb857f1e,3dd949593346dbc3,84b3e7d38f2d2ec5,2018-05-27,0,0,0,272,2,0,17,1,17,0,0,0,0,0,7,5,10,1,0.0,63.599999999999994
4829,426ca5caeb857f1e,84b3e7d38f2d2ec5,3dd949593346dbc3,2018-05-27,1,0,0,272,2,0,29,14,12,17,2,1,15,12,5,3,7,2,99.4,155.0
4830,3e9ddcd30fdc5d85,198994b47f395af0,34e552520a934063,2018-05-27,0,0,0,900,4,3,179,39,176,3,0,0,3,2,42,28,134,37,86.0,813.7
4831,3e9ddcd30fdc5d85,34e552520a934063,198994b47f395af0,2018-05-27,1,0,0,900,0,0,155,32,154,1,0,0,1,1,51,26,103,31,0.3,813.0
4832,326c3eaa1e9e3dc4,38c7f72747f4f712,51018a31ddf31eb2,2018-05-27,0,1,1,425,4,2,50,16,34,16,0,0,16,12,1,1,33,4,272.0,153.0
4833,326c3eaa1e9e3dc4,51018a31ddf31eb2,38c7f72747f4f712,2018-05-27,0,0,0,425,0,0,33,10,33,0,0,0,0,0,1,0,32,10,0.0,151.0
4834,20b5de395c0f1375,a17ad5a5048e8c3f,b9664eae2ac75262,2018-05-27,1,0,0,407,0,0,90,26,80,10,0,0,10,5,10,8,70,21,9.4,392.0
4835,20b5de395c0f1375,b9664eae2ac75262,a17ad5a5048e8c3f,2018-05-27,0,0,0,407,4,0,75,11,75,0,0,0,0,0,9,4,66,11,0.0,334.6
4836,e6fdf9e67f84a0e0,01fcef7e3d051722,9ba2226646046b63,2018-05-19,0,1,0,900,0,0,104,25,104,0,0,0,0,0,22,19,82,25,0.0,773.9
4837,e6fdf9e67f84a0e0,9ba2226646046b63,01fcef7e3d051722,2018-05-19,1,0,0,900,10,4,120,36,103,17,0,0,17,10,39,30,64,26,118.1,650.0
4838,df0d4130944776d9,4ba8d454f762005d,e51fcd9cd84c0b93,2018-05-19,0,0,0,900,0,0,92,12,92,0,0,0,0,0,28,16,64,12,0.0,767.0
4839,df0d4130944776d9,e51fcd9cd84c0b93,4ba8d454f762005d,2018-05-19,0,0,0,900,9,3,76,20,76,0,0,0,0,0,17,10,59,20,0.0,736.0
4840,db8887f2085f7971,09f579be4520394a,d05412b513b19621,2018-05-19,0,1,0,900,5,2,46,10,45,1,0,0,1,1,23,12,22,9,12.2,564.4
4841,db8887f2085f7971,d05412b513b19621,09f579be4520394a,2018-05-19,0,1,0,900,3,1,53,12,44,9,0,0,9,8,18,13,26,4,152.6,531.8
4842,c571ac76ca45c1cb,5c126c6aac3ef364,a851c35f58199231,2018-05-19,1,0,0,33,0,0,13,7,6,7,0,0,7,6,3,2,3,1,5.0,28.0
4843,c571ac76ca45c1cb,a851c35f58199231,5c126c6aac3ef364,2018-05-19,0,0,0,33,0,0,3,0,3,0,0,0,0,0,2,2,1,0,0.0,28.0
4844,866b2c2e354aa27b,1b38a2b897f6209c,d747eb273a40a920,2018-05-19,1,0,0,743,1,1,130,48,81,49,9,7,40,29,20,15,61,19,153.2,483.0
4845,866b2c2e354aa27b,d747eb273a40a920,1b38a2b897f6209c,2018-05-19,0,1,1,743,7,2,49,11,44,5,1,1,4,3,7,4,37,8,88.0,501.8
4846,79c22394d9c2144d,2c2caf2f2bab9df5,436f970c9ea9169c,2018-05-19,0,1,0,39,0,0,2,1,2,0,0,0,0,0,1,1,1,1,0.0,15.0
4847,79c22394d9c2144d,436f970c9ea9169c,2c2caf2f2bab9df5,2018-05-19,1,0,0,39,1,1,19,7,6,13,1,1,12,6,1,1,5,1,24.0,15.0
4848,6222cdc86b12d251,05fa626cb33d15b8,4798e823ada58fe9,2018-05-19,0,2,0,900,5,3,93,17,68,25,15,7,10,8,41,32,27,9,228.3,351.6
4849,6222cdc86b12d251,4798e823ada58fe9,05fa626cb33d15b8,2018-05-19,0,1,0,900,1,1,73,17,63,10,6,1,4,0,7,6,56,17,64.4,568.7
4850,53febf2fb416f9de,be0b310a12eb80b4,cc351e408bbb7d43,2018-05-19,0,1,0,900,15,10,94,33,68,26,5,4,21,15,17,14,51,18,321.7,440.5
4851,53febf2fb416f9de,cc351e408bbb7d43,be0b310a12eb80b4,2018-05-19,0,0,0,900,1,0,87,18,86,1,0,0,1,0,15,11,71,18,26.5,525.3
4852,49b47b5b5f15c7c0,792be9a24df82ed6,a0f0004aadf10b71,2018-05-19,0,0,0,900,7,2,133,32,133,0,0,0,0,0,20,13,113,32,0.0,842.9
4853,49b47b5b5f15c7c0,a0f0004aadf10b71,792be9a24df82ed6,2018-05-19,0,0,0,900,0,0,168,58,160,8,0,0,8,7,35,21,125,51,41.1,828.0
4854,47f42aa7cf851a29,427b5953ac8e3a27,f1b2aa7853d1ed6e,2018-05-19,0,0,0,1500,15,0,87,26,86,1,0,0,1,1,2,1,84,25,60.5,1178.9
4855,47f42aa7cf851a29,f1b2aa7853d1ed6e,427b5953ac8e3a27,2018-05-19,1,0,0,1500,0,0,209,49,192,17,2,1,15,9,26,16,166,40,200.1,1180.5
4856,47c140debc977214,6d4b63c767106d3a,c03a5022f8439f2a,2018-05-19,1,0,0,256,0,0,35,9,31,4,0,0,4,3,9,5,22,6,0.0,256.0
4857,47c140debc977214,c03a5022f8439f2a,6d4b63c767106d3a,2018-05-19,0,0,0,256,1,0,29,6,29,0,0,0,0,0,8,7,21,6,0.0,205.0
4858,24f2d2dd9fea5d79,b08012bbe542592a,e8b731feff72294b,2018-05-19,0,1,1,164,3,2,9,1,8,1,0,0,1,1,2,1,6,0,101.0,63.0
4859,24f2d2dd9fea5d79,e8b731feff72294b,b08012bbe542592a,2018-05-19,0,0,0,164,0,0,8,4,6,2,1,1,1,1,2,1,4,3,0.0,63.0
4860,1290d7eb0fefd3f3,13a0275fa13c4d26,2e19380f34871c6a,2018-05-19,0,0,0,175,0,0,21,4,21,0,0,0,0,0,3,2,18,4,0.0,175.0
4861,1290d7eb0fefd3f3,2e19380f34871c6a,13a0275fa13c4d26,2018-05-19,1,0,0,175,1,0,52,7,52,0,0,0,0,0,19,13,33,7,0.0,175.0
4862,d86e31793564cd31,7a703c565ccaa18f,8c0580d4fff106c1,2018-05-12,0,1,0,900,9,1,115,42,101,14,0,0,14,14,31,22,70,28,116.5,674.5
4863,d86e31793564cd31,8c0580d4fff106c1,7a703c565ccaa18f,2018-05-12,1,0,0,900,0,0,145,44,135,10,0,0,10,3,12,9,123,41,17.5,748.5
4864,c8fdd3f7178fbfa4,37d5b176d438d2a5,dbc17725b887860a,2018-05-12,0,0,0,285,0,0,6,3,5,1,0,0,1,1,1,1,4,2,0.0,25.0
4865,c8fdd3f7178fbfa4,dbc17725b887860a,37d5b176d438d2a5,2018-05-12,0,1,1,285,3,2,6,4,1,5,1,1,4,3,0,0,1,1,260.0,25.0
4866,b152646345037056,7be14eaed4c74856,c268b2cfebccf652,2018-05-12,0,0,0,823,6,1,137,41,136,1,0,0,1,1,25,9,111,40,8.6,749.5
4867,b152646345037056,c268b2cfebccf652,7be14eaed4c74856,2018-05-12,2,1,0,823,0,0,233,65,223,10,1,1,9,5,59,36,164,60,30.5,747.4
4868,7ec70261afdecda8,7447e9f28508106a,d4a31850a7457f1b,2018-05-12,1,1,1,147,0,0,32,14,24,8,1,1,7,5,1,0,23,9,9.0,138.0
4869,7ec70261afdecda8,d4a31850a7457f1b,7447e9f28508106a,2018-05-12,0,0,0,147,0,0,25,5,25,0,0,0,0,0,1,1,24,5,0.0,138.0
4870,7072a324a82c4297,0ee783aa00e468f0,f7a7f7118d4b01b6,2018-05-12,0,0,0,360,0,0,12,2,12,0,0,0,0,0,1,0,11,2,0.0,360.0
4871,7072a324a82c4297,f7a7f7118d4b01b6,0ee783aa00e468f0,2018-05-12,1,0,0,360,0,0,22,2,22,0,0,0,0,0,14,9,8,2,0.0,360.0
4872,6b325792b8fb1f46,0d8011111be000b2,8adcbd525fab8d9b,2018-05-12,0,0,0,220,0,0,36,13,36,0,0,0,0,0,1,1,35,13,0.0,214.0
4873,6b325792b8fb1f46,8adcbd525fab8d9b,0d8011111be000b2,2018-05-12,1,0,0,220,1,0,58,9,45,13,0,0,13,6,17,6,28,3,6.0,214.0
4874,5f1a828f8d4c3b01,2ac4628c08ec5125,984d15d5dc7bfcf9,2018-05-12,0,2,1,268,1,1,4,3,1,3,0,0,3,3,1,1,0,0,147.8,51.3
4875,5f1a828f8d4c3b01,984d15d5dc7bfcf9,2ac4628c08ec5125,2018-05-12,0,0,0,268,1,0,6,1,5,1,0,0,1,1,3,2,2,0,19.7,61.19999999999999
4876,5ea39e0fc3b64e83,0052de90691d4a93,2816ced060a21be3,2018-05-12,0,1,1,255,1,1,12,5,11,1,0,0,1,1,3,1,8,4,130.0,125.0
4877,5ea39e0fc3b64e83,2816ced060a21be3,0052de90691d4a93,2018-05-12,0,0,0,255,0,0,6,1,6,0,0,0,0,0,0,0,6,1,0.0,118.0
4878,53d6a7634c7fc036,4b1d46a1b5c0fd11,abd5fb12437eda21,2018-05-12,0,0,0,900,5,1,82,5,81,1,0,0,1,0,17,7,64,5,1.7,691.0
4879,53d6a7634c7fc036,abd5fb12437eda21,4b1d46a1b5c0fd11,2018-05-12,0,0,0,900,6,3,84,28,66,18,0,0,18,11,17,11,49,17,204.0,592.3
4880,3dcb1a7b081afbe1,98c23cb6da5b3352,c482c8605455a213,2018-05-12,0,1,1,105,3,0,17,6,17,0,0,0,0,0,5,4,12,6,0.0,90.0
4881,3dcb1a7b081afbe1,c482c8605455a213,98c23cb6da5b3352,2018-05-12,0,0,0,105,1,1,15,7,15,0,0,0,0,0,4,3,11,7,0.0,93.0
4882,3454f5c7203467aa,80fa8218c99f9c58,fc169c387b4b465d,2018-05-12,1,0,0,1356,4,3,254,72,238,16,0,0,16,13,83,52,155,59,123.0,1072.2
4883,3454f5c7203467aa,fc169c387b4b465d,80fa8218c99f9c58,2018-05-12,0,0,0,1356,8,1,169,49,168,1,0,0,1,1,21,15,147,48,14.8,1100.0
4884,25da6035f591c245,d317a5e2b3f88c5f,e70de1859b7ee78e,2018-05-12,1,0,0,600,1,0,50,7,50,0,0,0,0,0,30,22,20,7,0.0,396.0
4885,25da6035f591c245,e70de1859b7ee78e,d317a5e2b3f88c5f,2018-05-12,0,0,0,600,3,1,28,10,28,0,0,0,0,0,4,2,24,10,0.0,473.0
4886,014f7dc96c90c199,0a1942069c9ad6b6,cfb65863d5099327,2018-05-12,1,1,0,730,3,3,56,25,32,24,0,0,24,19,13,10,19,6,116.3,200.60000000000002
4887,014f7dc96c90c199,cfb65863d5099327,0a1942069c9ad6b6,2018-05-12,0,3,0,730,9,3,17,5,10,7,0,0,7,4,6,6,4,1,403.4,152.7
4888,ef86720364837f68,4c7781da8c6cae93,a2b12c3f3d60ff69,2018-04-21,0,0,0,900,6,1,48,5,44,4,4,4,0,0,17,15,27,5,107.2,601.2
4889,ef86720364837f68,a2b12c3f3d60ff69,4c7781da8c6cae93,2018-04-21,0,0,0,900,7,5,54,6,53,1,0,0,1,1,8,5,45,5,30.8,546.8
4890,dbed6292db8b0212,9ccf8371fd80d45d,aec185309b4843d0,2018-04-21,0,0,0,460,1,0,37,7,35,2,0,0,2,1,11,4,24,6,102.7,231.0
4891,dbed6292db8b0212,aec185309b4843d0,9ccf8371fd80d45d,2018-04-21,1,0,0,460,1,1,64,20,55,9,0,0,9,7,13,13,42,13,75.0,257.3
4892,dbb0ca0198ac514a,64a50dad704d1d49,ee9ebceabfd16fa7,2018-04-21,0,0,0,1338,1,0,106,26,104,2,0,0,2,2,33,25,71,24,5.0,427.0
4893,dbb0ca0198ac514a,ee9ebceabfd16fa7,64a50dad704d1d49,2018-04-21,1,0,0,1338,9,4,241,138,122,119,5,4,114,92,0,0,122,46,901.0,432.0
4894,d2b5ce5548b71668,5331b25a60417ffb,65ddc8a9ac4e8531,2018-04-21,0,2,0,900,0,0,133,48,130,3,0,0,3,3,9,8,121,45,8.0,868.0
4895,d2b5ce5548b71668,65ddc8a9ac4e8531,5331b25a60417ffb,2018-04-21,0,0,0,900,5,2,83,16,83,0,0,0,0,0,13,8,70,16,0.0,794.0
4896,bef2a2e68fb4dfa8,01b352b6a9074d5c,ce1e867808ef5fce,2018-04-21,0,0,0,900,0,0,137,34,136,1,0,0,1,1,47,35,89,33,7.2,644.7
4897,bef2a2e68fb4dfa8,ce1e867808ef5fce,01b352b6a9074d5c,2018-04-21,1,0,0,900,2,1,109,68,89,20,0,0,20,17,8,8,81,51,133.3,712.8
4898,a22add1024153ddb,5e4eec08896c9423,e51e5cb722bd47a8,2018-04-21,0,0,0,900,13,12,119,56,107,12,4,3,8,7,8,5,99,49,170.1,416.5
4899,a22add1024153ddb,e51e5cb722bd47a8,5e4eec08896c9423,2018-04-21,0,0,0,900,1,0,99,24,98,1,0,0,1,1,14,7,84,23,1.5,699.9
4900,a017d5806eaa6018,5987b2458f4b5290,c03520b5c88ed6b4,2018-04-21,1,1,0,900,7,2,103,25,102,1,0,0,1,1,12,9,90,24,20.8,723.9
4901,a017d5806eaa6018,c03520b5c88ed6b4,5987b2458f4b5290,2018-04-21,1,0,0,900,22,6,210,42,209,1,0,0,1,0,25,19,184,42,10.1,717.2
4902,6dd0874dec826397,cb696ebfb6598724,ec52462a1b41f714,2018-04-21,0,0,0,900,9,3,152,40,135,17,2,1,15,9,62,48,73,31,28.4,818.0
4903,6dd0874dec826397,ec52462a1b41f714,cb696ebfb6598724,2018-04-21,0,0,0,900,5,1,89,23,89,0,0,0,0,0,10,4,79,23,0.0,480.6
4904,6d8ce1abde550bc6,d247691a6c0e9034,f2688492b9a525a3,2018-04-21,0,0,0,900,0,0,130,32,130,0,0,0,0,0,20,16,110,32,0.0,900.0
4905,6d8ce1abde550bc6,f2688492b9a525a3,d247691a6c0e9034,2018-04-21,0,0,0,900,8,0,136,33,136,0,0,0,0,0,30,25,106,33,0.0,849.0
4906,62aab95c866a9c5b,d2c55d1d2e67773b,dea070ed4a2a8281,2018-04-21,1,0,0,150,1,0,15,5,11,4,0,0,4,4,1,0,10,1,2.0,148.0
4907,62aab95c866a9c5b,dea070ed4a2a8281,d2c55d1d2e67773b,2018-04-21,0,0,0,150,0,0,29,4,29,0,0,0,0,0,12,10,17,4,0.0,148.0
4908,0f88658e787815c8,193b9d1858bc4df3,d1941565abf50b16,2018-04-21,1,0,0,180,0,0,44,15,43,1,0,0,1,1,11,9,32,14,13.0,167.0
4909,0f88658e787815c8,d1941565abf50b16,193b9d1858bc4df3,2018-04-21,0,0,0,180,2,1,20,6,20,0,0,0,0,0,4,4,16,6,0.0,140.0
4910,e18a8b333529cc09,57b10fca4f9c9a7a,f9f07bb5a43535ed,2018-04-14,0,1,1,497,3,3,23,8,8,15,1,1,14,7,0,0,8,1,224.0,102.0
4911,e18a8b333529cc09,f9f07bb5a43535ed,57b10fca4f9c9a7a,2018-04-14,0,1,0,497,1,1,18,6,11,7,1,1,6,5,5,5,6,1,171.0,102.0
4912,bfae2fb50efbdb0f,029eaff01e6bb8f0,9e8f6c728eb01124,2018-04-14,1,0,0,933,5,0,351,142,351,0,0,0,0,0,37,32,314,142,0.0,927.0
4913,bfae2fb50efbdb0f,9e8f6c728eb01124,029eaff01e6bb8f0,2018-04-14,0,0,0,933,0,0,212,56,212,0,0,0,0,0,69,59,143,56,0.0,869.0
4914,bd1e01de1f24962b,2fc7e9701642ca38,80daefbed11ce998,2018-04-14,0,2,0,522,7,3,36,14,34,2,0,0,2,2,8,8,26,12,124.0,336.0
4915,bd1e01de1f24962b,80daefbed11ce998,2fc7e9701642ca38,2018-04-14,1,0,0,522,1,0,100,27,100,0,0,0,0,0,21,17,79,27,0.0,370.0
4916,b8b9a8e504d51ba5,1338e2c7480bdf9e,7acbb0972e75281a,2018-04-14,0,0,0,900,1,0,123,31,123,0,0,0,0,0,31,26,92,31,0.0,900.0
4917,b8b9a8e504d51ba5,7acbb0972e75281a,1338e2c7480bdf9e,2018-04-14,0,0,0,900,6,2,154,20,154,0,0,0,0,0,32,26,122,20,0.0,702.0
4918,85060e6e71ed14e4,122ac9b816d8b71c,f923e012414c883e,2018-04-14,0,0,0,900,4,1,206,34,206,0,0,0,0,0,48,34,158,34,0.0,818.7
4919,85060e6e71ed14e4,f923e012414c883e,122ac9b816d8b71c,2018-04-14,0,0,0,900,2,2,156,31,154,2,0,0,2,0,37,27,117,31,37.3,732.0
4920,59363451049c929d,23024fdfc966410a,66e98b3bb5fc5250,2018-04-14,1,0,0,359,2,2,65,22,59,6,0,0,6,2,10,9,49,20,63.0,275.0
4921,59363451049c929d,66e98b3bb5fc5250,23024fdfc966410a,2018-04-14,0,0,0,359,0,0,58,10,58,0,0,0,0,0,15,10,43,10,0.0,296.0
4922,57d05d28e3fbee4f,5f179af5fffeb9f6,eb04b9d31e938edb,2018-04-14,0,3,0,900,1,0,96,22,91,5,0,0,5,5,17,14,74,17,36.4,545.5
4923,57d05d28e3fbee4f,eb04b9d31e938edb,5f179af5fffeb9f6,2018-04-14,0,0,0,900,4,3,84,30,68,16,0,0,16,14,35,31,33,16,252.5,500.6
4924,5164f1c4103616fd,52e76bb4b3e852f3,c80095f6092271a7,2018-04-14,0,1,1,268,2,1,48,23,36,12,0,0,12,9,8,8,28,14,77.1,178.0
4925,5164f1c4103616fd,c80095f6092271a7,52e76bb4b3e852f3,2018-04-14,0,0,0,268,0,0,18,4,18,0,0,0,0,0,4,3,14,4,0.0,185.9
4926,47fc0736929125bd,7e511f8d842a109d,efa1f6b42c86793c,2018-04-14,0,0,0,419,3,2,18,9,12,6,0,0,6,3,0,0,12,6,272.6,101.0
4927,47fc0736929125bd,efa1f6b42c86793c,7e511f8d842a109d,2018-04-14,0,1,1,419,0,0,27,2,23,4,0,0,4,2,13,11,10,0,0.0,146.39999999999998
4928,4210f9b11debf1fc,39330403ad27c2bb,96428b9e9bd048ea,2018-04-14,0,0,0,900,5,1,109,15,109,0,0,0,0,0,53,46,56,15,0.0,837.5
4929,4210f9b11debf1fc,96428b9e9bd048ea,39330403ad27c2bb,2018-04-14,1,0,0,900,0,0,140,44,138,2,1,1,1,1,18,14,120,43,7.5,821.0
4930,418a7100e490e791,acff437707625fc7,e9213f53ddeca978,2018-04-14,0,0,0,900,13,6,19,14,3,16,1,1,15,12,0,0,3,2,750.0,148.0
4931,418a7100e490e791,e9213f53ddeca978,acff437707625fc7,2018-04-14,0,0,0,900,0,0,24,6,22,2,0,0,2,2,8,5,14,4,2.0,145.0
4932,17c53d93d549cb03,447f9858ae78f921,9b1e3fb4f8cbd5b7,2018-04-14,1,0,0,552,2,0,48,10,45,3,0,0,3,3,16,15,29,7,15.0,532.0
4933,17c53d93d549cb03,9b1e3fb4f8cbd5b7,447f9858ae78f921,2018-04-14,0,0,0,552,1,0,44,6,44,0,0,0,0,0,18,13,26,6,0.0,532.0
4934,15aee8ad5d9e9d58,5aedf14771ca82d2,92437c6775b3f7d1,2018-04-14,0,0,0,900,16,8,61,6,61,0,0,0,0,0,9,6,52,6,0.0,414.6
4935,15aee8ad5d9e9d58,92437c6775b3f7d1,5aedf14771ca82d2,2018-04-14,0,1,0,900,0,0,91,30,83,8,0,0,8,6,18,16,65,24,22.4,858.0
4936,01c9acf719298187,0c6d9ea8306c029e,4e06913c91da5200,2018-04-14,1,0,0,736,1,0,96,23,86,10,0,0,10,6,32,23,54,17,76.0,584.0
4937,01c9acf719298187,4e06913c91da5200,0c6d9ea8306c029e,2018-04-14,0,0,0,736,3,0,74,18,74,0,0,0,0,0,12,6,62,18,0.0,615.0
4938,eab7b76e177e1903,032cc3922d871c7f,59279a7c978f7da0,2018-04-07,0,1,0,1500,15,6,304,122,255,49,3,3,46,31,14,9,241,91,633.0,867.0
4939,eab7b76e177e1903,59279a7c978f7da0,032cc3922d871c7f,2018-04-07,0,0,0,1500,1,0,141,27,141,0,0,0,0,0,24,14,117,27,0.0,867.0
4940,bab65d16fa74fc5b,3bad7ef643840f67,feaf00f3373435d6,2018-04-07,0,0,0,600,2,0,137,40,135,2,0,0,2,2,12,8,123,38,0.0,583.7
4941,bab65d16fa74fc5b,feaf00f3373435d6,3bad7ef643840f67,2018-04-07,1,0,0,600,0,0,196,72,183,13,9,8,4,1,52,48,131,71,16.3,502.0
4942,95edc0b6438f2592,751de04455cfaac0,b6452706b373eea1,2018-04-07,0,0,0,900,2,0,140,35,140,0,0,0,0,0,9,6,131,35,0.0,899.0
4943,95edc0b6438f2592,b6452706b373eea1,751de04455cfaac0,2018-04-07,0,0,0,900,0,0,206,60,206,0,0,0,0,0,73,56,133,60,0.0,900.0
4944,8803935990adafc1,55ee431411ccf07a,e5c9de15bb58b1c6,2018-04-07,1,0,0,53,0,0,18,9,14,4,0,0,4,2,4,4,10,7,2.2,46.0
4945,8803935990adafc1,e5c9de15bb58b1c6,55ee431411ccf07a,2018-04-07,0,0,0,53,0,0,14,4,14,0,0,0,0,0,0,0,14,4,0.0,50.8
4946,829b3ee4145a1ae6,3d6749c4267da18f,47b63240018d5d86,2018-04-07,0,0,0,1500,0,0,356,64,356,0,0,0,0,0,99,81,257,64,0.0,1500.0
4947,829b3ee4145a1ae6,47b63240018d5d86,3d6749c4267da18f,2018-04-07,0,0,0,1500,2,1,301,85,301,0,0,0,0,0,31,20,270,85,0.0,1444.0
4948,6c5f7f98ec0b6f17,87aa9fb63d6b51a1,c5af5750e8bae4f0,2018-04-07,0,0,0,900,11,5,217,75,209,8,0,0,8,7,29,22,180,68,182.4,672.0
4949,6c5f7f98ec0b6f17,c5af5750e8bae4f0,87aa9fb63d6b51a1,2018-04-07,0,0,0,900,2,0,163,34,163,0,0,0,0,0,14,9,149,34,0.0,677.6
4950,5315bd4542b21c4b,b6850671a008bf9a,d7c3816669784109,2018-04-07,0,0,0,900,5,0,216,62,216,0,0,0,0,0,35,24,181,62,0.0,791.2
4951,5315bd4542b21c4b,d7c3816669784109,b6850671a008bf9a,2018-04-07,0,0,0,900,3,0,248,82,245,3,0,0,3,3,57,44,188,79,3.8,829.0
4952,28f7ba820350e3a3,907e60fd13407e1e,fc6e681bf6658faf,2018-04-07,0,0,0,900,0,0,195,46,195,0,0,0,0,0,48,42,147,46,0.0,890.7
4953,28f7ba820350e3a3,fc6e681bf6658faf,907e60fd13407e1e,2018-04-07,0,0,0,900,4,1,331,81,330,1,1,1,0,0,54,34,276,81,0.3,893.0
4954,12563423bf15e75d,18b602842a24f7c5,cc7040fe76f0ef91,2018-04-07,0,0,0,900,0,0,66,17,64,2,0,0,2,2,27,23,37,15,2.5,588.0
4955,12563423bf15e75d,cc7040fe76f0ef91,18b602842a24f7c5,2018-04-07,0,0,0,900,11,7,64,30,48,16,2,2,14,12,24,18,24,18,274.0,212.5
4956,fe9ee00fa47dd7b3,31a13532e724ca2b,633a45d131192ffe,2018-03-17,0,1,0,900,4,3,62,18,53,9,1,1,8,6,9,5,44,12,81.8,567.2
4957,fe9ee00fa47dd7b3,633a45d131192ffe,31a13532e724ca2b,2018-03-17,0,0,0,900,4,2,54,7,43,11,8,8,3,1,24,18,19,6,232.8,564.2
4958,f8ee14dbf966b9e6,76ee3d666c648f6b,e9ac7bfb65c25497,2018-03-17,0,1,1,238,1,1,14,11,1,13,0,0,13,11,0,0,1,0,233.0,5.0
4959,f8ee14dbf966b9e6,e9ac7bfb65c25497,76ee3d666c648f6b,2018-03-17,0,0,0,238,0,0,1,0,1,0,0,0,0,0,0,0,1,0,0.0,5.0
4960,e84fa12d87993ec5,1fcfc3709fe58151,f1fac969a1d70b08,2018-03-17,0,0,0,899,4,1,43,8,43,0,0,0,0,0,9,8,34,8,0.0,347.9
4961,e84fa12d87993ec5,f1fac969a1d70b08,1fcfc3709fe58151,2018-03-17,1,0,0,899,2,1,86,37,51,35,0,0,35,25,8,5,43,12,487.1,398.0
4962,e835e9a4564db497,279566840aa55bf2,492b202d2064e7a9,2018-03-17,1,0,0,998,2,2,90,37,76,14,2,2,12,11,13,9,63,26,78.1,510.0
4963,e835e9a4564db497,492b202d2064e7a9,279566840aa55bf2,2018-03-17,0,0,0,998,9,3,88,30,43,45,7,4,38,21,15,14,28,9,382.0,520.9
4964,848e7af760788418,ba5e253af86db1a8,e979c76341f19b22,2018-03-17,0,0,0,900,6,2,267,60,258,9,1,1,8,7,32,24,226,53,41.7,812.0
4965,848e7af760788418,e979c76341f19b22,ba5e253af86db1a8,2018-03-17,0,0,0,900,3,0,153,28,153,0,0,0,0,0,49,39,104,28,0.0,853.3
4966,714d6fc1eaca9624,d802174b0c0c1f4e,eabf206b162b3b83,2018-03-17,0,0,0,899,0,0,96,36,55,41,13,13,28,18,13,10,42,18,317.0,473.2
4967,714d6fc1eaca9624,eabf206b162b3b83,d802174b0c0c1f4e,2018-03-17,0,1,1,899,7,2,50,2,48,2,0,0,2,0,20,16,28,2,23.8,475.0
4968,5f19b0135414b454,1e1dbd1cc5a7469e,99df7d0a2a08a8a8,2018-03-17,0,0,0,900,2,0,110,16,110,0,0,0,0,0,31,21,79,16,0.0,884.8
4969,5f19b0135414b454,99df7d0a2a08a8a8,1e1dbd1cc5a7469e,2018-03-17,1,0,0,900,6,1,191,81,190,1,0,0,1,1,20,16,170,80,13.2,728.0
4970,2fd0c6d914b77205,85ff1b9471d35238,ad56b3f00ca38dfd,2018-03-17,0,2,1,569,3,2,40,22,26,14,1,1,13,12,7,5,19,10,162.3,146.8
4971,2fd0c6d914b77205,ad56b3f00ca38dfd,85ff1b9471d35238,2018-03-17,0,0,0,569,1,0,37,11,21,16,5,5,11,9,8,8,13,2,167.2,197.7
4972,288c942b0ad152a6,330bafba312face4,a6cba6bb66c1a8c9,2018-03-17,0,0,0,132,1,0,12,1,12,0,0,0,0,0,8,6,4,1,0.0,107.0
4973,288c942b0ad152a6,a6cba6bb66c1a8c9,330bafba312face4,2018-03-17,1,0,0,132,0,0,10,2,9,1,1,1,0,0,1,1,8,2,1.0,130.0
4974,0b4583d204797d19,2c9d00968f818270,f7d73e452b064bf2,2018-03-17,0,0,0,39,0,0,3,1,3,0,0,0,0,0,2,2,1,1,0.0,26.0
4975,0b4583d204797d19,f7d73e452b064bf2,2c9d00968f818270,2018-03-17,1,1,1,39,0,0,5,2,4,1,1,0,0,0,0,0,4,2,13.0,26.0
4976,efe055854f19a1d7,b50a426a33da0012,d0e50a3d1b250708,2018-03-03,0,3,0,900,0,0,111,41,102,9,3,3,6,6,25,19,77,35,45.0,520.1
4977,efe055854f19a1d7,d0e50a3d1b250708,b50a426a33da0012,2018-03-03,0,0,0,900,7,4,60,7,51,9,6,5,3,3,17,13,34,4,324.9,494.0
4978,ead2ca0d2afb46be,7447e9f28508106a,b4c6c904a9ffc5e8,2018-03-03,0,1,0,900,6,1,143,39,134,9,0,0,9,8,32,31,102,31,105.0,550.0
4979,ead2ca0d2afb46be,b4c6c904a9ffc5e8,7447e9f28508106a,2018-03-03,1,0,0,900,0,0,142,27,142,0,0,0,0,0,33,25,109,27,0.0,753.0
4980,c73b81e7c1c1cccc,6bd02119599741a4,99506df1af6c8b3b,2018-03-03,0,0,0,900,1,1,172,39,170,2,2,2,0,0,52,28,118,39,17.7,838.0
4981,c73b81e7c1c1cccc,99506df1af6c8b3b,6bd02119599741a4,2018-03-03,0,0,0,900,0,0,184,47,184,0,0,0,0,0,33,29,151,47,0.0,882.3
4982,c6c975ca66a7f91a,47cd337b86b1af92,f5990c11974d8e9c,2018-03-03,1,0,0,154,0,0,50,18,29,21,1,1,20,12,9,3,20,6,20.0,134.0
4983,c6c975ca66a7f91a,f5990c11974d8e9c,47cd337b86b1af92,2018-03-03,0,0,0,154,0,0,20,1,20,0,0,0,0,0,5,3,15,1,0.0,134.0
4984,bfb7d17161aec938,3738e68d2261e60f,ebc1f40e00e0c481,2018-03-03,0,0,0,900,9,4,88,12,85,3,2,2,1,0,44,32,41,12,135.5,552.0
4985,bfb7d17161aec938,ebc1f40e00e0c481,3738e68d2261e60f,2018-03-03,0,0,0,900,3,0,74,9,69,5,0,0,5,2,34,25,35,7,77.0,687.5
4986,9e21a8dea9663e26,08af939f41b5a57b,262a7d06203657e6,2018-03-03,0,0,0,42,0,0,11,2,11,0,0,0,0,0,4,2,7,2,0.0,41.0
4987,9e21a8dea9663e26,262a7d06203657e6,08af939f41b5a57b,2018-03-03,1,0,0,42,0,0,13,5,11,2,0,0,2,2,3,3,8,3,1.0,41.0
4988,84f236d6c57d7cfb,72ffecf712673af1,99bcdf5eac39898f,2018-03-03,0,0,0,900,0,0,133,47,132,1,0,0,1,1,12,11,120,46,0.0,900.0
4989,84f236d6c57d7cfb,99bcdf5eac39898f,72ffecf712673af1,2018-03-03,0,0,0,900,11,2,106,44,106,0,0,0,0,0,18,15,88,44,0.0,467.0
4990,6c2f05c47f494e15,5d7bdab5e03e3216,db1f2ed63b54b9a7,2018-03-03,0,0,0,300,0,0,19,4,19,0,0,0,0,0,12,9,7,4,0.0,300.0
4991,6c2f05c47f494e15,db1f2ed63b54b9a7,5d7bdab5e03e3216,2018-03-03,1,0,0,300,0,0,33,8,33,0,0,0,0,0,15,11,18,8,0.0,300.0
4992,4960379abe6ed525,3143bf892608139a,634bb0de2eb043b4,2018-03-03,0,0,0,205,4,1,11,2,10,1,0,0,1,1,7,3,3,1,70.5,48.6
4993,4960379abe6ed525,634bb0de2eb043b4,3143bf892608139a,2018-03-03,1,0,0,205,1,1,43,22,21,22,3,2,19,13,9,9,12,9,15.4,113.5
4994,2361b51aa72e5551,def8166ff24bd237,f2688492b9a525a3,2018-03-03,1,0,0,284,0,0,76,21,74,2,0,0,2,2,5,4,69,19,0.4,282.0
4995,2361b51aa72e5551,f2688492b9a525a3,def8166ff24bd237,2018-03-03,0,0,0,284,1,0,77,12,77,0,0,0,0,0,18,15,59,12,0.0,283.6
4996,1f52e665587dc645,3ecd936bd8814108,b9706f80d005036c,2018-03-03,0,0,0,900,2,0,106,33,93,13,3,2,10,7,33,24,60,26,4.9,559.8
4997,1f52e665587dc645,b9706f80d005036c,3ecd936bd8814108,2018-03-03,0,1,0,900,2,2,71,32,56,15,3,3,12,12,8,6,48,20,326.2,286.1
4998,12a64dfb8147566b,5ef0088c1b19beeb,bf7ad5628363eec9,2018-03-03,0,0,0,900,23,1,168,50,167,1,0,0,1,1,12,9,155,49,14.2,601.0
4999,12a64dfb8147566b,bf7ad5628363eec9,5ef0088c1b19beeb,2018-03-03,0,0,0,900,1,0,166,67,166,0,0,0,0,0,34,28,132,67,0.0,885.8
5000,e22a887ce4ab30eb,2c99576fefe53c7c,7be14eaed4c74856,2018-02-24,0,0,0,900,2,0,228,78,228,0,0,0,0,0,61,38,167,78,0.0,767.0
5001,e22a887ce4ab30eb,7be14eaed4c74856,2c99576fefe53c7c,2018-02-24,0,0,0,900,4,1,203,74,203,0,0,0,0,0,28,20,175,74,0.0,634.0
5002,bf8f747e57d6d1c7,94527830000ab715,f50d95223751e6ca,2018-02-24,0,2,1,752,3,2,20,1,5,15,14,14,1,1,2,2,3,0,599.0,153.0
5003,bf8f747e57d6d1c7,f50d95223751e6ca,94527830000ab715,2018-02-24,0,0,0,752,1,1,8,0,8,0,0,0,0,0,3,2,5,0,0.0,131.0
5004,9c79433a4686f3fc,50db8711c70196cd,e9a3aeb207578eea,2018-02-24,0,0,0,228,0,0,24,2,24,0,0,0,0,0,6,5,18,2,0.0,210.9
5005,9c79433a4686f3fc,e9a3aeb207578eea,50db8711c70196cd,2018-02-24,1,1,1,228,0,0,41,11,35,6,0,0,6,5,16,14,19,6,17.1,208.0
5006,519dcb290e6db845,18968f97ad34f15c,fba03cd6cc28dc41,2018-02-24,1,0,0,395,0,0,57,18,49,8,0,0,8,5,11,6,38,13,9.0,365.0
5007,519dcb290e6db845,fba03cd6cc28dc41,18968f97ad34f15c,2018-02-24,1,0,0,395,0,0,40,9,32,8,2,2,6,3,8,7,24,6,21.0,365.0
5008,4d9d371b8db6fb91,31ef8b67e13495b3,6a1901c62ab3870f,2018-02-24,0,0,0,900,2,2,150,54,146,4,1,1,3,2,17,14,129,52,5.4,616.0
5009,4d9d371b8db6fb91,6a1901c62ab3870f,31ef8b67e13495b3,2018-02-24,0,0,0,900,12,10,178,46,139,39,24,24,15,14,30,22,109,32,261.0,459.6
5010,424a20da52b4f956,b0d6a1d8ac3d563d,f2b6fdb20675b11c,2018-02-24,1,0,0,900,1,0,168,58,164,4,0,0,4,3,30,20,134,55,19.2,876.0
5011,424a20da52b4f956,f2b6fdb20675b11c,b0d6a1d8ac3d563d,2018-02-24,0,0,0,900,4,1,110,23,110,0,0,0,0,0,33,22,77,23,0.0,802.8
5012,3cf4582b48302bb6,7be74a12d7352df2,c7d297714d9ab1a4,2018-02-24,0,0,0,520,5,2,49,5,49,0,0,0,0,0,7,4,42,5,0.0,202.9
5013,3cf4582b48302bb6,c7d297714d9ab1a4,7be74a12d7352df2,2018-02-24,0,1,1,520,0,0,39,23,26,13,0,0,13,11,1,0,25,12,6.1,513.0
5014,0f2611c3ec4661dd,a0c64f272b65d441,ab2b4ff41d6ebe0f,2018-02-24,0,0,0,900,2,0,109,30,100,9,1,1,8,8,10,10,90,22,1.6,665.8
5015,0f2611c3ec4661dd,ab2b4ff41d6ebe0f,a0c64f272b65d441,2018-02-24,0,0,0,900,9,5,82,15,77,5,1,1,4,3,17,13,60,12,232.2,480.4
5016,093ebd3375591101,484acc7b0f856ce9,cf65d56b0755ed3b,2018-02-24,0,0,0,458,0,0,79,21,78,1,0,0,1,0,19,12,59,21,0.2,453.3
5017,093ebd3375591101,cf65d56b0755ed3b,484acc7b0f856ce9,2018-02-24,2,0,0,458,0,0,141,53,138,3,1,1,2,1,31,24,107,52,1.7,439.8
5018,04970dfa4d531e39,6370c1c1e12723d5,d156513a19acf856,2018-02-24,0,0,0,263,0,0,24,3,24,0,0,0,0,0,14,12,10,3,0.0,198.5
5019,04970dfa4d531e39,d156513a19acf856,6370c1c1e12723d5,2018-02-24,2,0,0,263,1,1,19,3,18,1,0,0,1,0,7,7,11,3,50.5,162.0
5020,037c68d03c970609,b4192a975027aab6,f0feeb2192937424,2018-02-24,0,0,0,900,2,0,321,39,320,1,0,0,1,0,80,45,240,39,1.8,855.6
5021,037c68d03c970609,f0feeb2192937424,b4192a975027aab6,2018-02-24,0,0,0,900,2,1,209,63,206,3,0,0,3,3,65,51,141,60,13.4,777.2
5022,0328754c15ecd37c,2dc1bc1a02961656,544d7460b3e44393,2018-02-24,0,3,1,453,5,1,28,12,19,9,0,0,9,6,0,0,19,6,116.0,117.0
5023,0328754c15ecd37c,544d7460b3e44393,2dc1bc1a02961656,2018-02-24,0,0,0,453,1,1,54,16,43,11,1,1,10,6,3,2,40,10,220.0,117.0
5024,f73dfeb48b09e6a6,c9cf753cfdf77fc2,d3df1add9d9a7efb,2018-02-18,0,1,0,768,2,1,56,19,25,31,6,6,25,17,18,12,7,2,372.9,216.0
5025,f73dfeb48b09e6a6,d3df1add9d9a7efb,c9cf753cfdf77fc2,2018-02-18,2,0,0,768,2,1,45,27,17,28,1,1,27,19,2,2,15,8,119.0,259.1
5026,d07dd6239afe1cb0,1cf7ccf64a5bf24e,990bd63726a577f8,2018-02-18,1,0,0,114,0,0,22,13,14,8,0,0,8,7,4,4,10,6,4.0,110.0
5027,d07dd6239afe1cb0,990bd63726a577f8,1cf7ccf64a5bf24e,2018-02-18,0,0,0,114,0,0,18,4,18,0,0,0,0,0,6,4,12,4,0.0,110.0
5028,aeac1209f15157ed,51e86de150ee8be6,ed9d8ee3a4239b1c,2018-02-18,0,1,0,900,5,4,66,21,63,3,0,0,3,3,17,7,46,18,371.0,463.1
5029,aeac1209f15157ed,ed9d8ee3a4239b1c,51e86de150ee8be6,2018-02-18,0,0,0,900,9,1,138,32,124,14,2,2,12,11,34,29,90,21,65.9,416.0
5030,a8d189f56de9b451,b93c06d09d1c4ac0,cc351e408bbb7d43,2018-02-18,0,0,0,900,10,1,286,55,283,3,2,2,1,0,27,16,256,55,21.6,786.4
5031,a8d189f56de9b451,cc351e408bbb7d43,b93c06d09d1c4ac0,2018-02-18,0,0,0,900,1,0,285,83,284,1,0,0,1,0,42,31,242,83,5.6,839.4
5032,8f7a73d05387b159,1d00756835ca67c9,813550bc53b15fb0,2018-02-18,3,0,0,298,1,0,57,16,53,4,0,0,4,3,12,12,41,13,16.8,277.0
5033,8f7a73d05387b159,813550bc53b15fb0,1d00756835ca67c9,2018-02-18,0,0,0,298,0,0,79,17,79,0,0,0,0,0,9,8,70,17,0.0,264.2
5034,6f981a44898fb4ff,546f8599a63c29da,b12fc8a41e82d3a2,2018-02-18,0,1,1,110,3,3,3,1,3,0,0,0,0,0,1,1,2,1,0.0,20.0
5035,6f981a44898fb4ff,b12fc8a41e82d3a2,546f8599a63c29da,2018-02-18,0,0,0,110,0,0,5,1,5,0,0,0,0,0,0,0,5,1,0.0,110.0
5036,6ae96d1de3bb0506,6256b2b1562cb8e1,a8283a4f415e1eb9,2018-02-18,1,0,0,900,2,1,158,24,153,5,1,1,4,3,57,43,96,21,12.3,873.0
5037,6ae96d1de3bb0506,a8283a4f415e1eb9,6256b2b1562cb8e1,2018-02-18,0,1,0,900,3,3,90,10,90,0,0,0,0,0,23,16,67,10,0.0,791.7
5038,5edd1cd479f3919e,6da99156486ed6c2,cdb96af67d096b1e,2018-02-18,0,0,0,132,0,0,13,0,13,0,0,0,0,0,8,4,5,0,0.0,126.0
5039,5edd1cd479f3919e,cdb96af67d096b1e,6da99156486ed6c2,2018-02-18,1,1,1,132,0,0,19,2,19,0,0,0,0,0,7,5,12,2,0.0,131.0
5040,4335683beee93652,1999ffb5cebc314f,b997be68943010fc,2018-02-18,0,0,0,168,0,0,29,3,29,0,0,0,0,0,7,4,22,3,0.0,168.0
5041,4335683beee93652,b997be68943010fc,1999ffb5cebc314f,2018-02-18,0,1,1,168,0,0,31,11,31,0,0,0,0,0,3,3,28,11,0.0,101.0
5042,357a5bc5de4f545d,31ee470ef5dc8d7f,f1928a52590c5532,2018-02-18,0,0,0,557,1,1,106,3,106,0,0,0,0,0,43,30,63,3,0.0,528.0
5043,357a5bc5de4f545d,f1928a52590c5532,31ee470ef5dc8d7f,2018-02-18,2,0,0,557,0,0,106,31,100,6,0,0,6,3,21,16,79,28,15.0,542.0
5044,0bfb221a0944f8e0,3cf66c62d9069f43,539ed332b3078821,2018-02-18,2,0,0,900,0,0,134,70,99,35,0,0,35,22,6,5,93,48,249.3,347.6
5045,0bfb221a0944f8e0,539ed332b3078821,3cf66c62d9069f43,2018-02-18,0,2,0,900,5,2,121,33,72,49,7,6,42,22,6,4,66,11,260.4,363.7
5046,07f234a488661125,7026eca45f65377b,f53d4f21d1b5f2dc,2018-02-18,0,0,0,118,1,0,17,8,17,0,0,0,0,0,0,0,17,8,0.0,100.0
5047,07f234a488661125,f53d4f21d1b5f2dc,7026eca45f65377b,2018-02-18,1,0,0,118,0,0,60,24,44,16,0,0,16,16,6,5,38,8,18.0,100.0
5048,f8fce67abe0ab922,840d2c82ea68b9aa,b102c26727306ab6,2018-02-10,0,0,0,703,0,0,65,8,64,1,0,0,1,1,19,13,45,7,3.4,465.8
5049,f8fce67abe0ab922,b102c26727306ab6,840d2c82ea68b9aa,2018-02-10,1,1,1,703,4,2,49,24,34,15,0,0,15,14,5,3,29,10,182.2,456.6
5050,f3a60ca18747aeac,68f6e96c5fa6e044,e1248941344b3288,2018-02-10,0,0,0,597,3,0,25,7,18,7,0,0,7,7,1,1,17,0,28.0,128.2
5051,f3a60ca18747aeac,e1248941344b3288,68f6e96c5fa6e044,2018-02-10,1,0,0,597,3,2,120,57,17,103,8,8,95,56,9,8,8,1,440.8,94.0
5052,e8f2902be7b350ad,35faad160d346839,4f732e58ed907eff,2018-02-10,0,0,0,900,1,0,213,49,213,0,0,0,0,0,37,28,176,49,0.0,894.0
5053,e8f2902be7b350ad,4f732e58ed907eff,35faad160d346839,2018-02-10,0,0,0,900,0,0,176,31,176,0,0,0,0,0,42,27,134,31,0.0,900.0
5054,cd67f6ddb2920193,eef9b891edbd4604,fa6796c55d6c5440,2018-02-10,1,0,0,900,0,0,32,13,31,1,0,0,1,1,1,1,30,12,2.3,329.29999999999995
5055,cd67f6ddb2920193,fa6796c55d6c5440,eef9b891edbd4604,2018-02-10,0,0,0,900,14,10,105,46,55,50,5,5,45,39,5,5,50,7,563.7,322.7
5056,b6e086dd8093355d,49e96ff8ab781589,88d7b6d8230e1f3f,2018-02-10,0,1,1,234,1,0,23,6,23,0,0,0,0,0,6,6,17,6,0.0,213.2
5057,b6e086dd8093355d,88d7b6d8230e1f3f,49e96ff8ab781589,2018-02-10,0,0,0,234,5,2,22,6,20,2,0,0,2,1,2,2,18,5,19.8,155.0
5058,9444cfe0c7c0f6a7,00e11b5c8b7bfeeb,f77c68bb4be8516d,2018-02-10,0,0,0,708,0,0,119,22,119,0,0,0,0,0,32,23,87,22,0.0,707.6
5059,9444cfe0c7c0f6a7,f77c68bb4be8516d,00e11b5c8b7bfeeb,2018-02-10,1,0,0,708,0,0,92,23,91,1,0,0,1,1,32,22,59,22,0.4,700.0
5060,6cb9bc7c86ae43b9,98a6b2361045898f,d024ed963e8bf7ea,2018-02-10,0,0,0,900,0,0,153,43,153,0,0,0,0,0,39,24,114,43,0.0,900.0
5061,6cb9bc7c86ae43b9,d024ed963e8bf7ea,98a6b2361045898f,2018-02-10,0,0,0,900,0,0,123,16,123,0,0,0,0,0,42,30,81,16,0.0,900.0
5062,58286d3126cc5263,36549928f90f1d36,88cd34d836b4ebcd,2018-02-10,0,0,0,900,7,2,98,16,98,0,0,0,0,0,39,33,59,16,0.0,699.0
5063,58286d3126cc5263,88cd34d836b4ebcd,36549928f90f1d36,2018-02-10,1,0,0,900,4,1,109,8,109,0,0,0,0,0,32,25,77,8,0.0,875.0
5064,3112430100d2d0be,9be6020024133293,c62fbc117d57b943,2018-02-10,0,0,0,138,0,0,11,2,11,0,0,0,0,0,1,1,10,2,0.0,138.0
5065,3112430100d2d0be,c62fbc117d57b943,9be6020024133293,2018-02-10,1,0,0,138,0,0,51,30,51,0,0,0,0,0,8,8,43,30,0.0,113.0
5066,1cd5d5e271b646a3,1338e2c7480bdf9e,826475cc758e60e6,2018-02-10,1,0,0,517,0,0,75,35,75,0,0,0,0,0,19,17,56,35,0.0,517.0
5067,1cd5d5e271b646a3,826475cc758e60e6,1338e2c7480bdf9e,2018-02-10,0,0,0,517,15,3,46,6,46,0,0,0,0,0,24,16,22,6,0.0,271.0
5068,194d3950076b2f83,4c288a2b250bb576,5140122c3eecd307,2018-02-10,0,0,0,900,1,1,130,35,125,5,2,1,3,2,35,27,90,33,5.4,879.2
5069,194d3950076b2f83,5140122c3eecd307,4c288a2b250bb576,2018-02-10,0,0,0,900,1,0,171,43,159,12,0,0,12,8,27,20,132,35,7.8,877.6
5070,0d7dc1ed5eb995e4,a845f0735bc67405,e64b96c07d7ce999,2018-02-10,2,1,0,900,4,2,127,61,91,36,0,0,36,24,6,2,85,37,185.4,644.3
5071,0d7dc1ed5eb995e4,e64b96c07d7ce999,a845f0735bc67405,2018-02-10,0,0,0,900,1,0,152,35,138,14,1,1,13,4,17,13,121,31,49.7,643.6
5072,fa77134e0d90da3b,2f95a3c6d58b2aad,a4e85a58fbce64b2,2018-02-03,1,0,0,66,0,0,30,13,19,11,0,0,11,8,4,4,15,5,5.1,60.0
5073,fa77134e0d90da3b,a4e85a58fbce64b2,2f95a3c6d58b2aad,2018-02-03,0,0,0,66,1,0,2,1,2,0,0,0,0,0,1,0,1,1,0.0,60.9
5074,ee1c1e9037fee21e,e51fcd9cd84c0b93,f046d724d2a84ac5,2018-02-03,0,3,0,900,8,3,72,22,58,14,1,1,13,12,19,13,39,10,156.7,665.0
5075,ee1c1e9037fee21e,f046d724d2a84ac5,e51fcd9cd84c0b93,2018-02-03,0,0,0,900,6,3,61,9,61,0,0,0,0,0,25,24,36,9,0.0,578.3
5076,eb0f7127f22457e9,1bcaac2d99b90fce,4b47e71384a9522f,2018-02-03,0,0,0,900,1,0,192,70,192,0,0,0,0,0,24,17,168,70,0.0,831.7
5077,eb0f7127f22457e9,4b47e71384a9522f,1bcaac2d99b90fce,2018-02-03,1,0,0,900,0,0,274,91,269,5,2,2,3,2,43,36,226,89,68.3,818.0
5078,bc767f1eb6176dfb,d4c9dcd330403612,dea070ed4a2a8281,2018-02-03,0,0,0,363,3,1,22,10,21,1,0,0,1,1,0,0,21,9,25.0,127.69999999999999
5079,bc767f1eb6176dfb,dea070ed4a2a8281,d4c9dcd330403612,2018-02-03,2,0,0,363,1,0,82,33,28,54,18,17,36,25,8,8,20,8,185.3,139.0
5080,a0ec4eac058e6050,3a314d9fa7c6825d,7c7332319c14094c,2018-02-03,0,0,0,900,3,1,232,55,230,2,0,0,2,1,52,42,178,54,8.8,864.8
5081,a0ec4eac058e6050,7c7332319c14094c,3a314d9fa7c6825d,2018-02-03,0,0,0,900,0,0,191,28,190,1,0,0,1,0,53,44,137,28,0.2,890.2
5082,7bfb92f7ea59dbbd,2fee10d5cf86bfca,9673a497a9da119a,2018-02-03,0,0,0,230,1,1,11,1,11,0,0,0,0,0,5,5,6,1,0.0,56.2
5083,7bfb92f7ea59dbbd,9673a497a9da119a,2fee10d5cf86bfca,2018-02-03,0,3,1,230,2,1,18,11,10,8,0,0,8,7,2,1,8,4,84.8,124.0
5084,59b384dcc3ab49b2,38c626ca912c7bac,cd7763bcadb5d4c8,2018-02-03,0,1,0,900,0,0,25,5,21,4,0,0,4,3,17,15,4,2,12.0,216.5
5085,59b384dcc3ab49b2,cd7763bcadb5d4c8,38c626ca912c7bac,2018-02-03,0,0,0,900,15,9,45,20,22,23,1,1,22,16,9,7,13,4,635.5,142.0
5086,420dd305cd1d062f,cad24459b28592ca,f7a7f7118d4b01b6,2018-02-03,0,0,0,1500,11,3,77,18,75,2,0,0,2,1,14,14,61,17,26.7,1189.3
5087,420dd305cd1d062f,f7a7f7118d4b01b6,cad24459b28592ca,2018-02-03,0,0,0,1500,0,0,112,18,101,11,3,2,8,5,52,42,49,13,83.7,1336.3
5088,1fd5bf36c42ff1a2,2fe9032955c2e013,aa72b0f831d0bfe5,2018-02-03,0,0,0,574,1,0,32,5,21,11,0,0,11,2,8,4,13,3,0.0,211.0
5089,1fd5bf36c42ff1a2,aa72b0f831d0bfe5,2fe9032955c2e013,2018-02-03,1,1,0,574,2,2,62,25,27,35,5,5,30,15,6,1,21,10,363.0,211.0
5090,10f5bb70feb1df53,132deb59abae64b1,b1e5bcaad32a3cac,2018-02-03,0,2,1,565,2,2,113,87,20,93,7,7,86,77,3,1,17,10,512.0,53.0
5091,10f5bb70feb1df53,b1e5bcaad32a3cac,132deb59abae64b1,2018-02-03,0,0,0,565,0,0,12,2,12,0,0,0,0,0,0,0,12,2,0.0,53.0
5092,0da43c3ec0e11650,ac29d508d78384c9,cc900af167fbedfd,2018-02-03,0,0,0,900,0,0,87,40,87,0,0,0,0,0,20,19,67,40,0.0,836.0
5093,0da43c3ec0e11650,cc900af167fbedfd,ac29d508d78384c9,2018-02-03,0,0,0,900,6,0,146,42,146,0,0,0,0,0,44,35,102,42,0.0,552.0
5094,fa7cde1e2d3ae338,65f09bacd3957381,bf0e700106d00e55,2018-01-27,1,0,0,528,1,1,147,47,123,24,3,3,21,12,40,30,83,35,48.4,413.0
5095,fa7cde1e2d3ae338,bf0e700106d00e55,65f09bacd3957381,2018-01-27,0,0,0,528,1,1,90,29,90,0,0,0,0,0,6,3,84,29,0.0,411.6
5096,f23e2bed86b62462,519e4fe37ce9ff75,764342d39cdaa54a,2018-01-27,0,0,0,900,6,0,322,96,312,10,0,0,10,5,60,49,252,91,8.6,796.1
5097,f23e2bed86b62462,764342d39cdaa54a,519e4fe37ce9ff75,2018-01-27,0,0,0,900,3,3,223,80,217,6,1,1,5,0,28,25,189,80,78.9,707.4
5098,d571486369996a39,84ff027394f7e470,c07efc18b231f170,2018-01-27,1,0,0,286,2,1,55,31,20,35,2,2,33,26,2,1,18,5,216.8,63.0
5099,d571486369996a39,c07efc18b231f170,84ff027394f7e470,2018-01-27,0,0,0,286,0,0,16,5,16,0,0,0,0,0,2,2,14,5,0.0,69.19999999999999
5100,ce4314886c57718b,ae7fe94f117f98cf,c77a953488e5607d,2018-01-27,0,0,0,900,0,0,100,30,100,0,0,0,0,0,21,15,79,30,0.0,900.0
5101,ce4314886c57718b,c77a953488e5607d,ae7fe94f117f98cf,2018-01-27,0,0,0,900,4,1,186,24,186,0,0,0,0,0,51,36,135,24,0.0,851.0
5102,c5f0c83e303d80bf,82cbb809d5ee565c,e872e9a9a902c045,2018-01-27,0,0,0,900,3,1,211,46,211,0,0,0,0,0,41,33,170,46,0.0,865.0
5103,c5f0c83e303d80bf,e872e9a9a902c045,82cbb809d5ee565c,2018-01-27,0,1,0,900,1,0,252,37,252,0,0,0,0,0,40,31,212,37,0.0,900.0
5104,b8648b32caf36c5a,cbd3e590a85b18c5,fa37628269132d1a,2018-01-27,1,0,0,167,0,0,33,7,29,4,0,0,4,3,9,5,20,4,4.0,163.0
5105,b8648b32caf36c5a,fa37628269132d1a,cbd3e590a85b18c5,2018-01-27,0,0,0,167,0,0,17,2,17,0,0,0,0,0,5,3,12,2,0.0,163.0
5106,6e65bec924996b5a,928ae2e5b5f7a9ec,a20f234df70f2182,2018-01-27,0,0,0,900,0,0,203,43,203,0,0,0,0,0,71,53,132,43,0.0,900.0
5107,6e65bec924996b5a,a20f234df70f2182,928ae2e5b5f7a9ec,2018-01-27,0,0,0,900,0,0,215,60,215,0,0,0,0,0,14,8,201,60,0.0,900.0
5108,5a096f2acb44c776,4a57ebb14315b251,75a6a390fd5dca46,2018-01-27,0,0,0,900,7,2,65,11,47,18,6,6,12,7,34,29,13,4,194.8,348.0
5109,5a096f2acb44c776,75a6a390fd5dca46,4a57ebb14315b251,2018-01-27,0,0,0,900,2,1,37,5,37,0,0,0,0,0,26,13,11,5,0.0,515.2
5110,4fcbee643660d679,6c7e25571490aa3b,d8da10db80131bec,2018-01-27,0,0,0,561,6,1,61,15,42,19,3,2,16,8,5,4,37,7,145.7,314.7
5111,4fcbee643660d679,d8da10db80131bec,6c7e25571490aa3b,2018-01-27,0,3,1,561,5,2,47,13,40,7,1,1,6,5,12,10,28,8,62.3,237.3
5112,3a94bf34e62ae5fd,7a703c565ccaa18f,b1a3e0aca758b322,2018-01-27,1,0,0,230,1,0,21,7,18,3,0,0,3,2,11,2,7,5,3.0,226.0
5113,3a94bf34e62ae5fd,b1a3e0aca758b322,7a703c565ccaa18f,2018-01-27,0,0,0,230,0,0,34,5,34,0,0,0,0,0,6,3,28,5,0.0,227.0
5114,27901ef9e82d5690,6f242453c91a5af0,8fd808923cffff82,2018-01-27,0,0,0,900,11,1,196,56,196,0,0,0,0,0,58,47,138,56,0.0,709.0
5115,27901ef9e82d5690,8fd808923cffff82,6f242453c91a5af0,2018-01-27,0,0,0,900,12,4,229,70,229,0,0,0,0,0,15,10,214,70,0.0,850.0
5116,04a1c5b7993fe4d5,887961364be5ceb3,99bd87a300079ed9,2018-01-27,0,0,0,900,5,1,194,48,170,24,3,3,21,15,75,59,95,33,71.6,627.9
5117,04a1c5b7993fe4d5,99bd87a300079ed9,887961364be5ceb3,2018-01-27,0,0,0,900,1,1,146,45,135,11,0,0,11,8,17,11,118,37,75.1,712.4
5118,f91709b071e8295a,71f048adbfed5b49,eae431e70064e046,2018-01-20,0,0,0,227,2,1,25,3,25,0,0,0,0,0,6,5,19,3,0.0,163.0
5119,f91709b071e8295a,eae431e70064e046,71f048adbfed5b49,2018-01-20,1,0,0,227,0,0,33,11,33,0,0,0,0,0,4,2,29,11,0.0,225.0
5120,ea66be2688f542be,c5af5750e8bae4f0,cc351e408bbb7d43,2018-01-20,0,0,0,900,15,3,132,29,132,0,0,0,0,0,15,4,117,29,0.0,670.0
5121,ea66be2688f542be,cc351e408bbb7d43,c5af5750e8bae4f0,2018-01-20,0,0,0,900,1,1,112,19,112,0,0,0,0,0,25,19,87,19,0.0,892.0
5122,b9726184624ac076,275aca31f61ba28c,75e5fec9f72910ef,2018-01-20,1,0,0,57,0,0,6,2,4,2,0,0,2,1,1,1,3,1,1.0,56.0
5123,b9726184624ac076,75e5fec9f72910ef,275aca31f61ba28c,2018-01-20,0,0,0,57,0,0,4,1,4,0,0,0,0,0,2,1,2,1,0.0,56.0
5124,9f96d11017f9c824,0845c81e37d3bcb3,d967f0128c323de6,2018-01-20,0,0,0,420,0,0,82,23,82,0,0,0,0,0,19,15,63,23,0.0,364.9
5125,9f96d11017f9c824,d967f0128c323de6,0845c81e37d3bcb3,2018-01-20,1,1,0,420,3,2,61,30,54,7,0,0,7,5,2,2,52,25,48.1,317.0
5126,889207e3c622a5aa,05339613bf8e9808,2b074403b7c6cdb4,2018-01-20,2,0,0,444,3,1,132,35,126,6,0,0,6,4,12,6,114,31,17.7,382.0
5127,889207e3c622a5aa,2b074403b7c6cdb4,05339613bf8e9808,2018-01-20,0,0,0,444,0,0,90,11,90,0,0,0,0,0,24,13,66,11,0.0,422.3
5128,8238f9d2fd961757,8d03ce87ca14e778,d28dee5c705991df,2018-01-20,0,1,0,1500,1,0,113,17,113,0,0,0,0,0,7,4,106,17,0.0,719.3
5129,8238f9d2fd961757,d28dee5c705991df,8d03ce87ca14e778,2018-01-20,0,0,0,1500,14,6,95,45,58,37,4,4,33,24,24,21,34,21,778.7,595.0
5130,5f617d6c19d3a281,751de04455cfaac0,98d961097baaf308,2018-01-20,1,0,0,632,1,0,194,73,184,10,0,0,10,5,20,12,164,68,10.8,619.0
5131,5f617d6c19d3a281,98d961097baaf308,751de04455cfaac0,2018-01-20,0,0,0,632,0,0,186,46,186,0,0,0,0,0,60,43,126,46,0.0,621.2
5132,5cf56c22cbc24758,b69f24c500d783e7,fcd448a2fe1a23cc,2018-01-20,0,0,0,900,0,0,128,38,128,0,0,0,0,0,42,36,86,38,0.0,900.0
5133,5cf56c22cbc24758,fcd448a2fe1a23cc,b69f24c500d783e7,2018-01-20,0,0,0,900,0,0,209,57,209,0,0,0,0,0,25,17,184,57,0.0,900.0
5134,50385add37239184,1291edf2d566a71a,82a5152216251682,2018-01-20,0,0,0,900,0,0,201,60,198,3,0,0,3,3,17,12,181,57,7.8,856.0
5135,50385add37239184,82a5152216251682,1291edf2d566a71a,2018-01-20,0,0,0,900,13,1,113,15,113,0,0,0,0,0,35,20,78,15,0.0,816.2
5136,1b0fa021b1158121,0b8d512c79b4baf3,be0b310a12eb80b4,2018-01-20,0,0,0,900,0,0,146,27,146,0,0,0,0,0,33,16,113,27,0.0,626.0
5137,1b0fa021b1158121,be0b310a12eb80b4,0b8d512c79b4baf3,2018-01-20,0,0,0,900,10,5,122,25,98,24,4,2,20,10,35,28,63,15,274.0,626.0
5138,0990ac7065412e76,a0f0004aadf10b71,f53c1f4ceeed8c08,2018-01-20,0,2,0,900,1,1,49,13,46,3,1,1,2,2,7,5,39,11,262.8,288.0
5139,0990ac7065412e76,f53c1f4ceeed8c08,a0f0004aadf10b71,2018-01-20,0,0,0,900,12,7,80,19,68,12,5,5,7,4,16,12,52,15,174.0,347.2
5140,f8bb0aed83bd8638,27b164b0d1833df0,f72465a784c1b084,2018-01-14,0,1,0,900,2,1,70,28,56,14,1,1,13,12,11,9,45,16,40.1,535.3
5141,f8bb0aed83bd8638,f72465a784c1b084,27b164b0d1833df0,2018-01-14,0,6,0,900,4,3,49,20,38,11,0,0,11,7,7,5,31,13,301.7,475.9
5142,f767243bb48ab9d7,103b06d8707895a9,f1b2aa7853d1ed6e,2018-01-14,0,2,0,900,0,0,67,20,52,15,2,1,13,8,11,9,41,12,1.6,247.89999999999998
5143,f767243bb48ab9d7,f1b2aa7853d1ed6e,103b06d8707895a9,2018-01-14,0,0,0,900,19,8,66,29,23,43,13,13,30,21,9,8,14,8,650.1,127.4
5144,d85c76a61a820be9,511e82663651438d,92a9aa9c93192871,2018-01-14,0,0,0,442,0,0,98,29,98,0,0,0,0,0,24,16,74,29,0.0,381.5
5145,d85c76a61a820be9,92a9aa9c93192871,511e82663651438d,2018-01-14,0,1,1,442,4,1,64,13,62,2,0,0,2,1,7,5,55,12,60.5,321.0
5146,c4ecf4b894ccbced,69f01b25dfabaf6b,bc656db347f31e19,2018-01-14,0,1,0,900,7,3,34,20,16,18,0,0,18,14,0,0,16,6,523.9,227.8
5147,c4ecf4b894ccbced,bc656db347f31e19,69f01b25dfabaf6b,2018-01-14,0,2,0,900,3,3,79,34,57,22,1,1,21,15,22,16,35,19,119.2,105.10000000000002
5148,9f10afab94cafc45,6fd953151d981979,b76c6268dc1d3c05,2018-01-14,0,0,0,900,5,1,150,47,149,1,0,0,1,0,13,7,136,47,14.0,788.0
5149,9f10afab94cafc45,b76c6268dc1d3c05,6fd953151d981979,2018-01-14,0,0,0,900,1,0,136,21,135,1,0,0,1,1,29,17,106,20,0.0,886.0
5150,738e0ccad2c9224b,578ef12674df1e6a,5b2325cd70dbe2ea,2018-01-14,0,0,0,900,2,1,171,57,145,26,6,5,20,16,12,8,133,41,72.1,528.4
5151,738e0ccad2c9224b,5b2325cd70dbe2ea,578ef12674df1e6a,2018-01-14,0,0,0,900,11,1,87,31,75,12,1,1,11,7,17,14,58,24,285.6,470.9
5152,51e684bfce8d94aa,18968f97ad34f15c,e93b04e308913c2e,2018-01-14,1,0,0,456,0,0,133,32,127,6,0,0,6,4,22,17,105,28,7.3,445.0
5153,51e684bfce8d94aa,e93b04e308913c2e,18968f97ad34f15c,2018-01-14,0,0,0,456,0,0,79,24,79,0,0,0,0,0,28,20,51,24,0.0,444.7
5154,4843f369dc8b5de5,dccb63727f2f5f74,edd02825c29028fe,2018-01-14,0,0,0,60,0,0,30,5,30,0,0,0,0,0,4,4,26,5,0.0,60.0
5155,4843f369dc8b5de5,edd02825c29028fe,dccb63727f2f5f74,2018-01-14,2,0,0,60,0,0,39,17,38,1,0,0,1,1,1,1,37,16,0.0,60.0
5156,3b1453df439a5024,8f6a18831a120817,c17041f1bb5768d8,2018-01-14,0,2,0,900,11,3,67,30,45,22,0,0,22,16,7,5,38,14,558.2,260.1
5157,3b1453df439a5024,c17041f1bb5768d8,8f6a18831a120817,2018-01-14,0,0,0,900,1,1,127,42,106,21,0,0,21,15,18,14,88,27,30.9,288.79999999999995
5158,1bf1a6fc9c9acc26,a7897d200692ab64,d05412b513b19621,2018-01-14,0,1,1,293,2,1,11,3,9,2,0,0,2,1,2,0,7,2,25.3,211.5
5159,1bf1a6fc9c9acc26,d05412b513b19621,a7897d200692ab64,2018-01-14,0,0,0,293,2,1,39,12,34,5,0,0,5,5,10,7,24,7,43.5,180.7
5160,0820a29a03d58282,4d5197f331c47290,6c8072b61c276e67,2018-01-14,0,0,0,900,2,0,118,29,103,15,1,1,14,11,42,24,61,18,127.5,529.6
5161,0820a29a03d58282,6c8072b61c276e67,4d5197f331c47290,2018-01-14,0,1,0,900,3,2,98,36,78,20,2,2,18,14,25,17,53,22,217.4,435.5
5162,f77e3c681fe1b04e,98215d037be5bcb7,d910665038efc639,2017-12-30,0,0,0,900,3,1,112,35,99,13,0,0,2,0,3,0,69,0,201.1,627.3
5163,f77e3c681fe1b04e,d910665038efc639,98215d037be5bcb7,2017-12-30,0,1,0,900,9,2,138,27,132,6,0,0,2,0,3,0,85,0,9.7,677.9
5164,e3a2bf2d9ee83318,0d65c432720accb9,749f572d1d3161fb,2017-12-30,0,0,0,900,3,2,130,40,124,6,0,0,6,6,41,36,83,34,0.0,900.0
5165,e3a2bf2d9ee83318,749f572d1d3161fb,0d65c432720accb9,2017-12-30,0,1,0,900,0,0,180,37,180,0,0,0,0,0,27,15,153,37,0.0,900.0
5166,c381ad2c0bf34dd9,84b3e7d38f2d2ec5,f9f07bb5a43535ed,2017-12-30,0,0,0,900,9,6,114,14,111,3,0,0,1,0,13,0,68,0,77.2,591.0
5167,c381ad2c0bf34dd9,f9f07bb5a43535ed,84b3e7d38f2d2ec5,2017-12-30,0,0,0,900,0,0,112,10,112,0,0,0,0,0,43,27,69,10,0.0,778.8
5168,a88a4c126d585320,032cc3922d871c7f,64a50dad704d1d49,2017-12-30,0,0,0,900,13,4,177,77,99,78,2,0,21,0,1,0,64,0,608.6,268.0
5169,a88a4c126d585320,64a50dad704d1d49,032cc3922d871c7f,2017-12-30,0,0,0,900,0,0,76,6,76,0,0,0,0,0,29,19,47,6,0.0,291.4
5170,8f40ac90544d0003,c96d9178c9ed9e62,f57dd0bfa8c17813,2017-12-30,0,2,1,401,1,1,24,10,6,18,1,0,6,0,3,0,2,0,334.0,36.0
5171,8f40ac90544d0003,f57dd0bfa8c17813,c96d9178c9ed9e62,2017-12-30,0,0,0,401,0,0,4,0,3,1,1,1,0,0,1,1,2,0,31.0,36.0
5172,7e9ed49a1831056f,1a31ef98efce7a79,d2bc285ead803db0,2017-12-30,3,2,0,900,4,3,172,47,150,22,8,8,14,7,50,32,100,40,259.0,641.0
5173,7e9ed49a1831056f,d2bc285ead803db0,1a31ef98efce7a79,2017-12-30,0,0,0,900,1,0,159,20,159,0,0,0,0,0,43,29,116,20,0.0,640.0
5174,3d76ed7e224e9c99,193b9d1858bc4df3,32c355b04fc57f3a,2017-12-30,0,1,1,642,3,2,40,3,40,0,0,0,0,0,24,14,16,3,0.0,450.0
5175,3d76ed7e224e9c99,32c355b04fc57f3a,193b9d1858bc4df3,2017-12-30,0,0,0,642,5,0,69,9,69,0,0,0,0,0,35,15,34,9,0.0,619.0
5176,279b4190d9ef1379,634bb0de2eb043b4,634e2fb70bde3fd5,2017-12-30,0,0,0,1500,0,0,223,70,223,0,0,0,0,0,59,48,164,70,0.0,1456.0
5177,279b4190d9ef1379,634e2fb70bde3fd5,634bb0de2eb043b4,2017-12-30,0,0,0,1500,0,0,227,33,227,0,0,0,0,0,24,11,203,33,0.0,1296.0
5178,147d2ab0230af48d,08e908ed6d18d6a0,814ff3018127e8fc,2017-12-30,0,0,0,900,3,2,83,27,75,8,1,1,7,4,26,13,49,23,142.5,578.7
5179,147d2ab0230af48d,814ff3018127e8fc,08e908ed6d18d6a0,2017-12-30,0,0,0,900,4,0,83,6,81,2,0,0,2,2,30,8,51,4,36.3,630.5
5180,0be6540982a5b0cd,16690d100f995f8f,7acbb0972e75281a,2017-12-30,0,0,0,900,2,0,174,39,174,0,0,0,0,0,22,12,152,39,0.0,768.5
5181,0be6540982a5b0cd,7acbb0972e75281a,16690d100f995f8f,2017-12-30,0,2,0,900,1,0,161,56,154,7,0,0,3,0,2,0,90,0,39.5,776.0
5182,e83046dd074ec0fa,67f272324a030d00,7ff97850e8c32bda,2017-12-16,0,0,0,165,0,0,43,15,43,0,0,0,0,0,7,6,36,15,0.0,110.0
5183,e83046dd074ec0fa,7ff97850e8c32bda,67f272324a030d00,2017-12-16,1,1,0,165,1,1,21,12,10,11,0,0,11,11,2,1,8,1,44.0,121.0
5184,d9375ede2ec2f924,6a2f7c151031653d,f2925e6db404bf1d,2017-12-16,0,0,0,1500,7,2,291,100,281,10,0,0,10,10,92,72,189,90,53.8,1027.0
5185,d9375ede2ec2f924,f2925e6db404bf1d,6a2f7c151031653d,2017-12-16,0,0,0,1500,0,0,212,53,212,0,0,0,0,0,41,33,171,53,0.0,1182.2
5186,a6fbd8964400dd89,2aa49b3766a59bcd,5866fc86183a9fb8,2017-12-16,0,1,0,900,4,3,127,44,74,53,3,1,50,22,8,6,66,22,384.9,428.0
5187,a6fbd8964400dd89,5866fc86183a9fb8,2aa49b3766a59bcd,2017-12-16,0,0,0,900,3,0,48,5,48,0,0,0,0,0,10,8,38,5,0.0,475.1
5188,9a1a57b0abcd4599,c21a036b4e012f1c,e14b5aa06eea9653,2017-12-16,1,0,0,900,0,0,104,17,104,0,0,0,0,0,51,30,53,17,0.0,900.0
5189,9a1a57b0abcd4599,e14b5aa06eea9653,c21a036b4e012f1c,2017-12-16,0,0,0,900,6,1,91,23,91,0,0,0,0,0,9,6,82,23,0.0,803.0
5190,71dc4379c738450f,49858bf46dabf6fb,a6cba6bb66c1a8c9,2017-12-16,1,0,0,59,0,0,5,3,4,1,0,0,1,1,2,2,2,2,0.0,59.0
5191,71dc4379c738450f,a6cba6bb66c1a8c9,49858bf46dabf6fb,2017-12-16,0,0,0,59,0,0,4,0,4,0,0,0,0,0,3,1,1,0,0.0,59.0
5192,6f350d91fb07a819,3974fa35c917af1d,fba03cd6cc28dc41,2017-12-16,0,0,0,273,0,0,37,3,37,0,0,0,0,0,19,14,18,3,0.0,273.0
5193,6f350d91fb07a819,fba03cd6cc28dc41,3974fa35c917af1d,2017-12-16,1,0,0,273,0,0,38,6,38,0,0,0,0,0,6,4,32,6,0.0,273.0
5194,5b8d693bd1780102,8a56ea383fd26e52,c03a5022f8439f2a,2017-12-16,1,0,0,250,0,0,26,13,7,19,0,0,19,10,0,0,7,3,0.0,108.0
5195,5b8d693bd1780102,c03a5022f8439f2a,8a56ea383fd26e52,2017-12-16,1,0,0,250,1,1,39,20,5,34,0,0,34,20,1,0,4,0,142.0,108.0
5196,535b8e5494cbc580,a17ad5a5048e8c3f,d0e1b42d41dab603,2017-12-16,0,0,0,462,6,4,58,28,57,1,0,0,1,0,5,5,52,28,8.5,241.7
5197,535b8e5494cbc580,d0e1b42d41dab603,a17ad5a5048e8c3f,2017-12-16,0,3,1,462,3,0,64,29,54,10,3,2,7,5,1,1,53,24,15.3,401.5
5198,1e3c67921162561d,04b39f4e8eb59d7c,77d7295d1b22c694,2017-12-16,0,0,0,434,1,0,17,5,17,0,0,0,0,0,6,5,11,5,0.0,434.0
5199,1e3c67921162561d,77d7295d1b22c694,04b39f4e8eb59d7c,2017-12-16,1,0,0,434,1,1,37,4,37,0,0,0,0,0,7,2,30,4,0.0,432.0
5200,11b8d7e801713abc,6d1bffff14897645,f2b6fdb20675b11c,2017-12-16,1,0,0,900,3,3,200,56,189,11,6,6,5,4,17,16,172,52,108.2,782.0
5201,11b8d7e801713abc,f2b6fdb20675b11c,6d1bffff14897645,2017-12-16,0,0,0,900,1,1,136,34,136,0,0,0,0,0,24,17,112,34,0.0,762.8
5202,01619207a811ef01,13a0275fa13c4d26,99df7d0a2a08a8a8,2017-12-16,0,0,0,900,0,0,87,17,81,6,0,0,6,3,19,9,62,14,16.5,732.3
5203,01619207a811ef01,99df7d0a2a08a8a8,13a0275fa13c4d26,2017-12-16,1,0,0,900,5,4,127,35,121,6,0,0,6,3,19,15,102,32,145.7,713.5
5204,fbce8f52689bce87,96428b9e9bd048ea,d0e50a3d1b250708,2017-12-09,0,0,0,366,1,0,67,19,67,0,0,0,0,0,6,4,61,19,0.0,257.0
5205,fbce8f52689bce87,d0e50a3d1b250708,96428b9e9bd048ea,2017-12-09,1,0,0,366,0,0,49,16,40,9,0,0,9,7,5,4,35,9,0.0,366.0
5206,f9536ea60551b840,0052de90691d4a93,feaf00f3373435d6,2017-12-09,0,1,1,650,9,5,124,49,118,6,1,1,5,1,6,5,112,48,73.6,409.5
5207,f9536ea60551b840,feaf00f3373435d6,0052de90691d4a93,2017-12-09,0,0,0,650,0,0,97,25,93,4,1,1,3,2,27,20,66,23,7.5,561.4
5208,c9e19742c4146bff,2ac4628c08ec5125,cad24459b28592ca,2017-12-09,0,1,0,900,5,2,60,12,53,7,2,1,5,3,19,17,34,9,16.3,598.1
5209,c9e19742c4146bff,cad24459b28592ca,2ac4628c08ec5125,2017-12-09,0,0,0,900,4,2,141,62,96,45,3,2,42,27,21,15,75,35,252.9,411.7
5210,bc84680df666c96d,544d7460b3e44393,773f7feacf96153e,2017-12-09,0,0,0,900,1,0,198,45,198,0,0,0,0,0,44,33,154,45,0.0,718.0
5211,bc84680df666c96d,773f7feacf96153e,544d7460b3e44393,2017-12-09,1,1,0,900,0,0,187,55,187,0,0,0,0,0,43,23,144,55,0.0,847.0
5212,ab853176cfe20b01,9ba2226646046b63,c03520b5c88ed6b4,2017-12-09,0,0,0,900,3,0,106,22,104,2,0,0,2,2,43,36,61,20,0.8,853.6
5213,ab853176cfe20b01,c03520b5c88ed6b4,9ba2226646046b63,2017-12-09,0,0,0,900,23,11,118,34,116,2,1,1,1,1,19,12,97,33,27.4,433.2
5214,7a57289563f9d974,b27a1fcb56a3035a,fae67903c4fe636b,2017-12-09,1,0,0,747,0,0,113,62,113,0,0,0,0,0,9,8,104,62,0.0,529.0
5215,7a57289563f9d974,fae67903c4fe636b,b27a1fcb56a3035a,2017-12-09,0,0,0,747,5,2,73,10,71,2,1,1,1,1,12,7,59,9,194.0,553.0
5216,6fe21a4cb2d839fd,18e8b7070228e728,df1eb4354d18a906,2017-12-09,0,0,0,900,1,1,63,28,53,10,1,1,9,7,8,7,45,21,32.3,407.3
5217,6fe21a4cb2d839fd,df1eb4354d18a906,18e8b7070228e728,2017-12-09,0,0,0,900,11,7,82,28,52,30,4,4,26,20,18,17,34,8,392.7,278.7
5218,1ed266bed8005bbe,2f95a3c6d58b2aad,80daefbed11ce998,2017-12-09,0,0,0,900,3,0,99,9,99,0,0,0,0,0,36,29,63,9,0.0,891.0
5219,1ed266bed8005bbe,80daefbed11ce998,2f95a3c6d58b2aad,2017-12-09,0,0,0,900,3,0,97,16,97,0,0,0,0,0,25,19,72,16,0.0,845.0
5220,1d166488129030d0,d247691a6c0e9034,def8166ff24bd237,2017-12-09,0,0,0,502,0,0,97,24,97,0,0,0,0,0,40,36,57,24,0.0,488.0
5221,1d166488129030d0,def8166ff24bd237,d247691a6c0e9034,2017-12-09,0,2,1,502,1,0,70,12,70,0,0,0,0,0,14,12,56,12,0.0,472.0
5222,1aaa1a9ceecd6063,cb696ebfb6598724,fea79f9bc8c68769,2017-12-09,0,0,0,67,0,0,10,1,8,2,0,0,2,0,3,2,5,1,0.0,54.0
5223,1aaa1a9ceecd6063,fea79f9bc8c68769,cb696ebfb6598724,2017-12-09,2,0,0,67,0,0,14,6,12,2,0,0,2,2,1,1,11,4,13.0,54.0
5224,10a1947cb3feabc1,4c2d90e335e6df19,51a0c09cbe9b8472,2017-12-09,0,2,0,900,3,1,63,10,54,9,2,2,7,5,17,11,37,5,131.2,321.8
5225,10a1947cb3feabc1,51a0c09cbe9b8472,4c2d90e335e6df19,2017-12-09,0,0,0,900,4,4,71,29,53,18,5,5,13,12,20,15,33,17,228.2,375.8
5226,0a444f30cae13d8f,436f970c9ea9169c,bb1a2cdad6ff34db,2017-12-09,0,0,0,900,0,0,192,61,185,7,0,0,7,4,29,24,156,57,77.0,823.0
5227,0a444f30cae13d8f,bb1a2cdad6ff34db,436f970c9ea9169c,2017-12-09,0,0,0,900,9,1,181,22,181,0,0,0,0,0,21,14,160,22,0.0,759.0
5228,061081f46950fdb0,2a4200ead401a9ce,ab2b4ff41d6ebe0f,2017-12-09,0,0,0,414,2,0,28,7,28,0,0,0,0,0,1,1,27,7,0.0,232.8
5229,061081f46950fdb0,ab2b4ff41d6ebe0f,2a4200ead401a9ce,2017-12-09,0,3,1,414,4,2,40,13,29,11,1,1,10,7,14,10,15,6,126.2,196.0
5230,ea674e0285fb77f5,31ef8b67e13495b3,eb04b9d31e938edb,2017-12-02,0,0,0,900,2,1,173,72,155,18,0,0,18,17,30,23,125,55,87.1,623.0
5231,ea674e0285fb77f5,eb04b9d31e938edb,31ef8b67e13495b3,2017-12-02,0,0,0,900,3,2,138,29,134,4,2,2,2,1,30,25,104,28,40.0,542.9
5232,cc2809e10315a6b5,056c493bbd76a918,de75d1c45a39e221,2017-12-02,0,0,0,900,5,3,83,18,59,24,11,9,13,8,11,9,48,10,511.1,325.0
5233,cc2809e10315a6b5,de75d1c45a39e221,056c493bbd76a918,2017-12-02,0,0,0,900,1,0,98,19,94,4,0,0,4,1,7,6,87,18,0.0,388.9
5234,c83487136636e9bf,07225ba28ae309b6,e5010b1b94ca5755,2017-12-02,0,2,0,546,3,2,13,3,7,6,0,0,6,2,5,3,2,1,129.0,110.69999999999999
5235,c83487136636e9bf,e5010b1b94ca5755,07225ba28ae309b6,2017-12-02,1,0,0,546,0,0,46,26,8,38,5,4,33,22,1,1,7,4,263.3,126.0
5236,a3b7cbdb6d2607f4,2e19380f34871c6a,917a5cb9821df261,2017-12-02,0,1,1,219,1,1,28,13,5,23,0,0,23,13,3,3,2,0,127.0,62.0
5237,a3b7cbdb6d2607f4,917a5cb9821df261,2e19380f34871c6a,2017-12-02,0,0,0,219,4,1,6,4,5,1,0,0,1,1,0,0,5,3,30.0,32.0
5238,6c25f8fd66f16d7e,bd878a638e0e3be3,d4a31850a7457f1b,2017-12-02,0,0,0,574,1,0,31,3,30,1,0,0,1,1,12,9,18,2,0.0,129.10000000000002
5239,6c25f8fd66f16d7e,d4a31850a7457f1b,bd878a638e0e3be3,2017-12-02,1,1,0,574,3,1,60,34,22,38,3,3,35,31,3,3,19,3,444.9,94.0
5240,6aea6d3e6944999c,71f048adbfed5b49,eae431e70064e046,2017-12-02,0,0,0,261,2,0,60,23,55,5,0,0,5,5,18,16,37,18,2.0,250.0
5241,6aea6d3e6944999c,eae431e70064e046,71f048adbfed5b49,2017-12-02,1,0,0,261,3,1,61,22,61,0,0,0,0,0,6,5,55,22,0.0,122.0
5242,676320a61f800f10,2747c60e42d9d75f,7cbf7c78d3b34218,2017-12-02,0,0,0,900,3,1,137,16,136,1,0,0,1,1,56,36,80,15,9.8,849.7
5243,676320a61f800f10,7cbf7c78d3b34218,2747c60e42d9d75f,2017-12-02,0,0,0,900,7,2,100,22,99,1,0,0,1,1,18,17,81,21,1.3,874.2
5244,54c5284c1b792912,57b10fca4f9c9a7a,813550bc53b15fb0,2017-12-02,2,0,0,722,5,2,161,61,158,3,0,0,3,1,44,32,114,60,16.3,509.8
5245,54c5284c1b792912,813550bc53b15fb0,57b10fca4f9c9a7a,2017-12-02,2,0,0,722,1,1,151,56,138,13,1,1,12,10,23,18,115,46,27.2,638.7
5246,4712708adb1507aa,8d03ce87ca14e778,b4ad3a06ee4d660c,2017-12-02,1,0,0,102,0,0,14,4,13,1,0,0,1,1,2,2,11,3,15.8,39.0
5247,4712708adb1507aa,b4ad3a06ee4d660c,8d03ce87ca14e778,2017-12-02,0,0,0,102,1,0,4,1,4,0,0,0,0,0,0,0,4,1,0.0,86.2
5248,40d9b5b47acf260b,a9d6e047ce48ab63,ce1e867808ef5fce,2017-12-02,0,0,0,153,0,0,38,6,38,0,0,0,0,0,9,9,29,6,0.0,152.8
5249,40d9b5b47acf260b,ce1e867808ef5fce,a9d6e047ce48ab63,2017-12-02,1,0,0,153,0,0,44,21,42,2,0,0,2,2,1,1,41,19,0.2,151.0
5250,23e5acd1549b538a,33a331684283900f,9e8f6c728eb01124,2017-12-02,1,0,0,839,2,1,356,113,353,3,0,0,3,3,57,42,296,110,1.9,818.1
5251,23e5acd1549b538a,9e8f6c728eb01124,33a331684283900f,2017-12-02,0,0,0,839,1,0,237,69,234,3,0,0,3,1,57,53,177,68,0.9,831.1
5252,21f7fc538ea646e8,150ff4cc642270b9,d0f3959b4a9747e6,2017-12-02,1,0,0,891,0,0,397,135,374,23,0,0,23,14,48,39,326,121,26.4,844.0
5253,21f7fc538ea646e8,d0f3959b4a9747e6,150ff4cc642270b9,2017-12-02,0,0,0,891,1,0,163,65,163,0,0,0,0,0,30,22,133,65,0.0,862.6
5254,1a502852b706f674,5f179af5fffeb9f6,b6850671a008bf9a,2017-12-02,0,0,0,900,0,0,233,68,232,1,0,0,1,0,25,23,207,68,1.8,845.5
5255,1a502852b706f674,b6850671a008bf9a,5f179af5fffeb9f6,2017-12-02,0,0,0,900,2,1,262,47,261,1,0,0,1,0,43,29,218,47,47.5,803.2
5256,f9830f1c23ac92d0,80d8aed0ca9b00f3,c7be22a47a58365a,2017-12-01,0,1,1,120,0,0,17,3,17,0,0,0,0,0,4,3,13,3,0.0,86.8
5257,f9830f1c23ac92d0,c7be22a47a58365a,80d8aed0ca9b00f3,2017-12-01,0,0,0,120,1,1,17,6,16,1,0,0,1,0,4,4,12,6,8.2,79.0
5258,f0e0effb1b2de6ae,122ac9b816d8b71c,b96939f2b8d88e82,2017-12-01,1,0,0,473,0,0,95,19,95,0,0,0,0,0,25,15,70,19,0.0,473.0
5259,f0e0effb1b2de6ae,b96939f2b8d88e82,122ac9b816d8b71c,2017-12-01,0,0,0,473,0,0,102,8,102,0,0,0,0,0,50,27,52,8,0.0,464.0
5260,dd0c8e9880c6fa24,472f6f6e6d962f40,729d4bd5a6cd0a97,2017-12-01,0,2,0,900,0,0,236,55,236,0,0,0,0,0,20,16,216,55,0.0,879.0
5261,dd0c8e9880c6fa24,729d4bd5a6cd0a97,472f6f6e6d962f40,2017-12-01,0,0,0,900,2,2,197,49,197,0,0,0,0,0,13,10,184,49,0.0,692.0
5262,c4785ee94698e532,404ecb2700844072,8c020156779f7888,2017-12-01,0,1,0,900,11,0,81,25,80,1,0,0,1,1,27,22,53,24,24.6,308.2
5263,c4785ee94698e532,8c020156779f7888,404ecb2700844072,2017-12-01,1,0,0,900,0,0,117,34,115,2,0,0,2,0,19,15,96,34,1.8,851.4
5264,c11b2cbe2460db0c,b50a426a33da0012,ba5e253af86db1a8,2017-12-01,0,0,0,900,6,3,252,119,248,4,0,0,4,4,28,22,220,115,9.8,873.0
5265,c11b2cbe2460db0c,ba5e253af86db1a8,b50a426a33da0012,2017-12-01,0,0,0,900,2,0,288,59,288,0,0,0,0,0,47,29,241,59,0.0,821.2
5266,b40bed83fc062380,b59037262c8fe060,fccf811c1e8b01c7,2017-12-01,1,0,0,658,0,0,267,121,267,0,0,0,0,0,41,38,226,121,0.0,594.3
5267,b40bed83fc062380,fccf811c1e8b01c7,b59037262c8fe060,2017-12-01,2,0,0,658,7,3,183,90,174,9,1,1,8,6,9,5,165,84,49.7,531.0
5268,8b79a80f775d9f03,01784fbc27c68b14,2db0c114414d4f06,2017-12-01,0,1,1,100,1,1,13,1,13,0,0,0,0,0,3,2,10,1,0.0,64.0
5269,8b79a80f775d9f03,2db0c114414d4f06,01784fbc27c68b14,2017-12-01,0,0,0,100,2,0,10,2,10,0,0,0,0,0,0,0,10,2,0.0,78.0
5270,52db9c816eb99800,6ac9bc2953c47345,b9664eae2ac75262,2017-12-01,1,0,0,438,0,0,85,30,83,2,0,0,2,2,8,6,75,28,14.7,227.4
5271,52db9c816eb99800,b9664eae2ac75262,6ac9bc2953c47345,2017-12-01,0,1,0,438,5,1,31,15,25,6,0,0,6,5,3,2,22,10,188.6,203.3
5272,37835a0f9bbb4d4e,a4e85a58fbce64b2,ec52462a1b41f714,2017-12-01,0,0,0,30,1,0,0,0,0,0,0,0,0,0,0,0,0,0,0.0,30.0
5273,37835a0f9bbb4d4e,ec52462a1b41f714,a4e85a58fbce64b2,2017-12-01,0,1,1,30,0,0,9,1,9,0,0,0,0,0,0,0,9,1,0.0,30.0
5274,2f1f16c86a8cc6e2,1de9ad94de18eeaf,4498b382c65a7faa,2017-12-01,0,1,0,1500,6,3,456,138,440,16,3,3,13,12,56,45,384,126,174.6,1098.2
5275,2f1f16c86a8cc6e2,4498b382c65a7faa,1de9ad94de18eeaf,2017-12-01,0,1,0,1500,9,2,403,112,401,2,0,0,2,2,30,20,371,110,30.8,1140.4
5276,1eccf793b54b84f8,38c7f72747f4f712,b3d21b2610dcfaeb,2017-12-01,0,1,1,132,1,1,6,2,6,0,0,0,0,0,0,0,6,2,0.0,72.0
5277,1eccf793b54b84f8,b3d21b2610dcfaeb,38c7f72747f4f712,2017-12-01,0,0,0,132,0,0,15,7,14,1,0,0,1,1,2,2,12,6,11.0,99.0
5278,e5fbb99bc3907516,016a8d958883167c,fdbefee0827e1567,2017-11-25,0,0,0,900,7,5,65,23,56,9,1,1,8,7,18,14,38,16,138.4,394.0
5279,e5fbb99bc3907516,fdbefee0827e1567,016a8d958883167c,2017-11-25,0,0,0,900,2,1,51,7,50,1,0,0,1,1,21,15,29,6,14.0,523.6
5280,c8609059d2d87724,efb96bf3e9ada36f,efd2b3e9bb7965a4,2017-11-25,1,1,1,256,0,0,29,6,27,2,0,0,2,1,6,2,21,5,8.0,248.0
5281,c8609059d2d87724,efd2b3e9bb7965a4,efb96bf3e9ada36f,2017-11-25,0,0,0,256,1,0,30,1,30,0,0,0,0,0,8,2,22,1,0.0,248.0
5282,9f428684f3db247f,447f9858ae78f921,a2b12c3f3d60ff69,2017-11-25,0,0,0,502,0,0,27,4,27,0,0,0,0,0,11,6,16,4,0.0,361.0
5283,9f428684f3db247f,a2b12c3f3d60ff69,447f9858ae78f921,2017-11-25,0,1,1,502,7,3,24,6,21,3,0,0,3,2,0,0,21,4,141.0,314.0
5284,903feee04bc91c59,2296125b6c362355,55ed59d541f8b90c,2017-11-25,0,0,0,900,11,4,60,11,60,0,0,0,0,0,9,6,51,11,0.0,632.9
5285,903feee04bc91c59,55ed59d541f8b90c,2296125b6c362355,2017-11-25,1,0,0,900,1,0,99,11,92,7,2,1,5,4,26,14,66,7,64.1,781.0
5286,62eaf9f2436bef25,7aa3d6964eff4877,dd12382f28296f7b,2017-11-25,0,0,0,900,0,0,123,22,123,0,0,0,0,0,32,27,91,22,0.0,858.8
5287,62eaf9f2436bef25,dd12382f28296f7b,7aa3d6964eff4877,2017-11-25,1,0,0,900,3,0,164,30,152,12,0,0,12,8,58,41,94,22,19.2,876.0
5288,52bae6f01ea9f926,47cd337b86b1af92,e64b96c07d7ce999,2017-11-25,0,0,0,177,0,0,17,2,17,0,0,0,0,0,5,3,12,2,0.0,164.0
5289,52bae6f01ea9f926,e64b96c07d7ce999,47cd337b86b1af92,2017-11-25,1,0,0,177,0,0,50,15,37,13,0,0,13,9,12,11,25,6,13.0,164.0
5290,4d5c3ddc740b89ca,01b352b6a9074d5c,2f5cbecbbe18bac4,2017-11-25,0,0,0,84,0,0,13,4,13,0,0,0,0,0,1,1,12,4,0.0,84.0
5291,4d5c3ddc740b89ca,2f5cbecbbe18bac4,01b352b6a9074d5c,2017-11-25,1,0,0,84,0,0,10,5,10,0,0,0,0,0,2,1,8,5,0.0,83.0
5292,4ba97e13df33388b,0d62719b1dcf7c40,87aa9fb63d6b51a1,2017-11-25,0,0,0,870,0,0,31,7,30,1,0,0,1,1,14,11,16,6,8.0,270.0
5293,4ba97e13df33388b,87aa9fb63d6b51a1,0d62719b1dcf7c40,2017-11-25,0,1,1,870,15,11,70,28,37,33,2,1,31,19,11,5,26,9,592.0,270.0
5294,47628ab025f19796,05b43e0ead3df345,c41d426cc7326d1b,2017-11-25,0,0,0,900,6,2,134,33,123,11,2,1,9,4,22,18,101,29,181.9,436.6
5295,47628ab025f19796,c41d426cc7326d1b,05b43e0ead3df345,2017-11-25,0,0,0,900,0,0,211,80,207,4,0,0,4,2,20,16,187,78,0.4,715.1
5296,43ae6a9daa51ed93,32490e80ddab1e5a,7dfb56f24fe5ddea,2017-11-25,1,0,0,15,0,0,14,13,2,12,0,0,12,12,1,1,1,1,6.0,9.0
5297,43ae6a9daa51ed93,7dfb56f24fe5ddea,32490e80ddab1e5a,2017-11-25,0,0,0,15,0,0,3,0,3,0,0,0,0,0,1,1,2,0,0.0,9.0
5298,34c39a5a5917e0ec,9be6020024133293,f1175ea3aafbf351,2017-11-25,0,1,1,453,4,4,35,19,19,16,1,1,15,15,1,0,18,4,328.9,76.0
5299,34c39a5a5917e0ec,f1175ea3aafbf351,9be6020024133293,2017-11-25,0,1,0,453,0,0,18,6,16,2,0,0,2,2,3,2,13,4,7.0,110.10000000000002
5300,32ad75f6c8ca7e9f,2b93ebd9f5417ad2,8c0580d4fff106c1,2017-11-25,0,0,0,150,0,0,24,5,24,0,0,0,0,0,2,2,22,5,0.0,144.0
5301,32ad75f6c8ca7e9f,8c0580d4fff106c1,2b93ebd9f5417ad2,2017-11-25,1,0,0,150,0,0,27,7,21,6,0,0,6,4,8,7,13,3,6.0,143.0
5302,fd2c018aade60a14,6fb1ba67bef41b37,b6e6c3b1dcaae0a1,2017-11-18,0,1,1,425,2,0,82,15,82,0,0,0,0,0,24,19,58,15,0.0,379.0
5303,fd2c018aade60a14,b6e6c3b1dcaae0a1,6fb1ba67bef41b37,2017-11-18,0,1,0,425,4,2,78,42,78,0,0,0,0,0,8,7,70,42,0.0,380.0
5304,c06eaf92bdfde8e6,a0c64f272b65d441,ec664422b22d9787,2017-11-18,0,0,0,900,7,5,116,71,32,84,11,10,73,60,5,5,27,11,535.0,304.1
5305,c06eaf92bdfde8e6,ec664422b22d9787,a0c64f272b65d441,2017-11-18,0,2,0,900,2,1,30,4,24,6,0,0,6,3,2,1,22,1,60.9,294.0
5306,b90a5b9061ec54a5,20999e27ddd94bda,e9bc5748e6a76bb6,2017-11-18,1,0,0,758,1,0,93,40,89,4,0,0,4,4,7,5,82,36,1.3,756.0
5307,b90a5b9061ec54a5,e9bc5748e6a76bb6,20999e27ddd94bda,2017-11-18,0,0,0,758,3,0,101,20,101,0,0,0,0,0,30,22,71,20,0.0,734.7
5308,823797bc6d532b52,764342d39cdaa54a,d024ed963e8bf7ea,2017-11-18,0,0,0,900,5,1,299,137,298,1,0,0,1,1,22,17,276,136,4.9,743.1
5309,823797bc6d532b52,d024ed963e8bf7ea,764342d39cdaa54a,2017-11-18,0,1,0,900,7,2,251,72,250,1,0,0,1,1,38,32,212,71,18.9,763.1
5310,6971094300073d47,c62fbc117d57b943,d1528ac5675558b1,2017-11-18,1,0,0,275,2,0,36,16,34,2,0,0,2,2,7,6,27,14,13.5,192.6
5311,6971094300073d47,d1528ac5675558b1,c62fbc117d57b943,2017-11-18,0,0,0,275,2,0,19,2,17,2,0,0,2,0,8,8,9,2,8.4,223.5
5312,5ebe8d3849273776,4b47e71384a9522f,b1b0729d27936f2f,2017-11-18,0,0,0,900,1,0,234,49,234,0,0,0,0,0,56,42,178,49,0.0,900.0
5313,5ebe8d3849273776,b1b0729d27936f2f,4b47e71384a9522f,2017-11-18,0,0,0,900,5,1,221,72,221,0,0,0,0,0,22,16,199,72,0.0,879.0
5314,569e2c02f7699c0d,34f88592c0ab7a54,bdcbb976816fd256,2017-11-18,0,0,0,900,0,0,250,49,250,0,0,0,0,0,106,69,144,49,0.0,846.0
5315,569e2c02f7699c0d,bdcbb976816fd256,34f88592c0ab7a54,2017-11-18,0,1,0,900,7,2,120,37,120,0,0,0,0,0,8,5,112,37,0.0,842.0
5316,51ec53f442d2cc9b,c727c7d31c50c4cf,efa1f6b42c86793c,2017-11-18,0,0,0,900,9,2,57,6,42,15,12,12,3,3,17,14,25,3,299.3,430.1
5317,51ec53f442d2cc9b,efa1f6b42c86793c,c727c7d31c50c4cf,2017-11-18,0,0,0,900,1,0,95,23,88,7,0,0,7,5,21,19,67,18,50.9,469.7
5318,4b0aa5c67e69ce74,492b202d2064e7a9,c9cf753cfdf77fc2,2017-11-18,0,0,0,1500,7,1,265,104,262,3,1,1,2,2,55,50,207,102,27.8,1257.4
5319,4b0aa5c67e69ce74,c9cf753cfdf77fc2,492b202d2064e7a9,2017-11-18,0,0,0,1500,1,1,257,83,256,1,0,0,1,1,55,44,201,82,1.6,1448.2
5320,344bfe9c1ff511bb,a845f0735bc67405,fcce75a25c14a804,2017-11-18,0,0,0,900,11,4,34,18,26,8,0,0,8,8,3,2,23,10,379.6,375.7
5321,344bfe9c1ff511bb,fcce75a25c14a804,a845f0735bc67405,2017-11-18,0,1,0,900,1,1,48,20,41,7,0,0,7,6,7,4,34,14,97.3,242.39999999999998
5322,23b6ffc0223f8cce,26b63bc5c0c1f65d,6e7506127408aa9e,2017-11-18,0,0,0,900,7,4,70,28,56,14,6,6,8,8,17,11,39,20,341.2,405.0
5323,23b6ffc0223f8cce,6e7506127408aa9e,26b63bc5c0c1f65d,2017-11-18,0,6,0,900,1,0,105,25,97,8,0,0,8,5,40,27,57,20,32.0,470.8
5324,2060e8172f820d80,6c8072b61c276e67,907e60fd13407e1e,2017-11-18,0,1,0,900,3,2,174,61,167,7,0,0,7,7,48,40,119,54,139.6,510.0
5325,2060e8172f820d80,907e60fd13407e1e,6c8072b61c276e67,2017-11-18,0,1,0,900,3,2,145,58,142,3,0,0,3,3,15,7,127,55,71.0,618.4
5326,d3c78cc516417797,0d8011111be000b2,523fa774700d7d3f,2017-11-11,0,1,0,900,3,3,254,77,237,17,0,0,17,12,7,1,230,65,138.6,716.8
5327,d3c78cc516417797,523fa774700d7d3f,0d8011111be000b2,2017-11-11,0,0,0,900,11,0,260,19,259,1,0,0,1,0,80,43,179,19,20.2,660.4
5328,b6b5ec324449befd,31123249b0bbf52e,82e7929bf6c2b689,2017-11-11,1,0,0,224,0,0,34,14,34,0,0,0,0,0,4,4,30,14,0.0,223.0
5329,b6b5ec324449befd,82e7929bf6c2b689,31123249b0bbf52e,2017-11-11,0,0,0,224,3,0,20,7,20,0,0,0,0,0,8,5,12,7,0.0,134.0
5330,b55605791a4d72b9,029eaff01e6bb8f0,cbb682f5fcc44bfc,2017-11-11,1,0,0,728,6,5,100,47,72,28,2,2,26,18,6,4,66,29,302.8,229.7
5331,b55605791a4d72b9,cbb682f5fcc44bfc,029eaff01e6bb8f0,2017-11-11,0,4,0,728,1,1,54,29,44,10,1,1,9,9,8,4,36,20,87.3,329.2
5332,935f559ab0521c27,3bad7ef643840f67,c47df9303d318c67,2017-11-11,0,0,0,67,0,0,7,1,7,0,0,0,0,0,0,0,7,1,0.0,34.0
5333,935f559ab0521c27,c47df9303d318c67,3bad7ef643840f67,2017-11-11,1,0,0,67,0,0,40,20,10,30,1,1,29,17,3,3,7,3,33.0,34.0
5334,7ad85c84025c0db0,a8e6a69796280f17,dbc17725b887860a,2017-11-11,1,0,0,900,2,0,65,22,59,6,0,0,6,6,16,14,43,16,17.6,618.7
5335,7ad85c84025c0db0,dbc17725b887860a,a8e6a69796280f17,2017-11-11,0,0,0,900,4,2,81,14,70,11,7,7,4,4,33,26,37,10,240.3,598.4
5336,78e554aa129711ba,92fa1401b7927da3,d761b3766e38c5db,2017-11-11,0,0,0,900,2,0,247,55,242,5,0,0,5,4,48,39,194,51,29.6,820.6
5337,78e554aa129711ba,d761b3766e38c5db,92fa1401b7927da3,2017-11-11,0,1,0,900,9,1,140,49,139,1,0,0,1,0,18,10,121,49,8.4,803.4
5338,7006a98fe9944571,d343df8ba11f4c4e,f0feeb2192937424,2017-11-11,0,0,0,900,1,0,309,81,307,2,0,0,2,1,79,62,228,80,0.2,898.0
5339,7006a98fe9944571,f0feeb2192937424,d343df8ba11f4c4e,2017-11-11,0,0,0,900,0,0,230,68,230,0,0,0,0,0,57,39,173,68,0.0,891.8
5340,60de5efe5b439c8b,5e84a859c6a82288,ed9d8ee3a4239b1c,2017-11-11,0,0,0,900,0,0,161,13,161,0,0,0,0,0,58,42,103,13,0.0,900.0
5341,60de5efe5b439c8b,ed9d8ee3a4239b1c,5e84a859c6a82288,2017-11-11,0,0,0,900,5,3,161,45,161,0,0,0,0,0,48,34,113,45,0.0,857.0
5342,603354ffe9cc0755,3738e68d2261e60f,c482c8605455a213,2017-11-11,0,0,0,900,1,0,203,52,203,0,0,0,0,0,46,40,157,52,0.0,898.0
5343,603354ffe9cc0755,c482c8605455a213,3738e68d2261e60f,2017-11-11,0,0,0,900,1,0,106,35,106,0,0,0,0,0,18,13,88,35,0.0,683.0
5344,5db3e2fdd18129a4,b08012bbe542592a,d50382dc0565a9e1,2017-11-11,0,0,0,900,5,4,106,45,34,72,12,12,60,45,17,14,17,0,709.6,147.0
5345,5db3e2fdd18129a4,d50382dc0565a9e1,b08012bbe542592a,2017-11-11,0,1,0,900,0,0,23,10,17,6,0,0,6,4,5,3,12,6,4.0,184.39999999999998
5346,5519d7fe2cee8353,99506df1af6c8b3b,fea79f9bc8c68769,2017-11-11,1,0,0,900,4,2,105,24,104,1,0,0,1,1,22,19,82,23,6.8,873.0
5347,5519d7fe2cee8353,fea79f9bc8c68769,99506df1af6c8b3b,2017-11-11,0,1,0,900,2,1,131,21,131,0,0,0,0,0,39,24,92,21,0.0,828.2
5348,4b202bae6c87b98b,37d5b176d438d2a5,a17ad5a5048e8c3f,2017-11-11,0,2,1,221,1,1,23,12,18,5,1,0,4,3,5,5,13,9,26.4,147.0
5349,4b202bae6c87b98b,a17ad5a5048e8c3f,37d5b176d438d2a5,2017-11-11,0,0,0,221,1,0,20,3,20,0,0,0,0,0,11,3,9,3,0.0,160.6
5350,151c597d2e609a4e,2f13e4020cea5b38,2fc7e9701642ca38,2017-11-11,1,0,0,710,0,0,154,24,154,0,0,0,0,0,31,22,123,24,0.0,709.0
5351,151c597d2e609a4e,2fc7e9701642ca38,2f13e4020cea5b38,2017-11-11,0,0,0,710,4,1,93,16,93,0,0,0,0,0,25,18,68,16,0.0,681.0
5352,fc29884851f9cebb,3d6749c4267da18f,47b63240018d5d86,2017-11-04,0,0,0,183,0,0,42,2,42,0,0,0,0,0,5,3,37,2,0.0,159.4
5353,fc29884851f9cebb,47b63240018d5d86,3d6749c4267da18f,2017-11-04,1,0,0,183,0,0,34,14,24,10,0,0,10,7,2,1,22,7,23.6,157.0
5354,e686df21c24c6c03,9e50097a89442158,c6aee362c7a7d482,2017-11-04,0,2,0,900,2,0,16,7,11,5,0,0,5,4,0,0,11,3,265.0,162.0
5355,e686df21c24c6c03,c6aee362c7a7d482,9e50097a89442158,2017-11-04,0,0,0,900,1,1,70,35,27,43,1,1,42,29,5,5,22,6,473.0,107.0
5356,d361b51952944a26,2b93ebd9f5417ad2,6506c1d34da9c013,2017-11-04,0,0,0,863,0,0,106,20,104,2,0,0,2,2,14,7,90,18,0.0,674.3
5357,d361b51952944a26,6506c1d34da9c013,2b93ebd9f5417ad2,2017-11-04,1,1,1,863,4,3,119,41,93,26,0,0,26,19,27,18,66,22,188.7,667.0
5358,b3a304eadb9f7fb4,c849740a3ff51931,d8c7c61b176e3994,2017-11-04,2,0,0,461,1,0,81,12,74,7,0,0,7,6,32,8,42,6,7.0,450.0
5359,b3a304eadb9f7fb4,d8c7c61b176e3994,c849740a3ff51931,2017-11-04,1,0,0,461,0,0,53,16,50,3,0,0,3,1,6,2,44,15,4.0,450.0
5360,8c2fb17981464d8c,98c23cb6da5b3352,fa6796c55d6c5440,2017-11-04,0,0,0,399,0,0,68,22,68,0,0,0,0,0,15,12,53,22,0.0,348.7
5361,8c2fb17981464d8c,fa6796c55d6c5440,98c23cb6da5b3352,2017-11-04,1,0,0,399,4,4,101,33,96,5,1,1,4,3,5,5,91,30,35.3,286.0
5362,8375f311e8c6c079,03f982ca3735070c,ad56b3f00ca38dfd,2017-11-04,0,0,0,269,1,1,38,17,20,18,1,1,17,14,6,3,14,3,180.9,78.0
5363,8375f311e8c6c079,ad56b3f00ca38dfd,03f982ca3735070c,2017-11-04,0,0,0,269,0,0,15,2,15,0,0,0,0,0,2,1,13,2,0.0,88.1
5364,80572cac6ab57866,47b9e0e7703a4868,4a28cb716c19157a,2017-11-04,0,0,0,900,2,0,142,9,142,0,0,0,0,0,63,33,79,9,0.0,897.0
5365,80572cac6ab57866,4a28cb716c19157a,47b9e0e7703a4868,2017-11-04,1,0,0,900,0,0,156,49,156,0,0,0,0,0,39,21,117,49,0.0,896.0
5366,5cab50839f4a0d94,50db8711c70196cd,5e4eec08896c9423,2017-11-04,1,0,0,685,0,0,49,17,49,0,0,0,0,0,8,6,41,17,0.0,554.6
5367,5cab50839f4a0d94,5e4eec08896c9423,50db8711c70196cd,2017-11-04,0,0,0,685,10,4,45,19,39,6,1,1,5,5,13,10,26,14,128.4,257.0
5368,56d8cc470841f454,1ae8f3c723aacff4,24656ef4d605c96f,2017-11-04,1,0,0,718,5,3,94,30,90,4,0,0,4,4,20,12,70,26,29.6,681.0
5369,56d8cc470841f454,24656ef4d605c96f,1ae8f3c723aacff4,2017-11-04,0,0,0,718,1,0,105,38,105,0,0,0,0,0,10,8,95,38,0.0,588.4
5370,13635ba71963ad0c,6256b2b1562cb8e1,654ae722109a0d31,2017-11-04,1,0,0,599,0,0,137,27,130,7,1,1,6,3,29,14,101,24,2.5,595.0
5371,13635ba71963ad0c,654ae722109a0d31,6256b2b1562cb8e1,2017-11-04,0,0,0,599,2,2,66,9,66,0,0,0,0,0,24,16,42,9,0.0,566.5
5372,0a46cb2887890502,0941df56f6ac954b,2e5c2aa8e4ab9d82,2017-11-04,0,0,0,383,4,0,54,10,54,0,0,0,0,0,22,17,32,10,0.0,382.7
5373,0a46cb2887890502,2e5c2aa8e4ab9d82,0941df56f6ac954b,2017-11-04,1,0,0,383,0,0,90,25,88,2,1,1,1,0,27,23,61,25,0.3,382.0
5374,f9e07282f3444d09,7026eca45f65377b,ed209f6618c82e41,2017-10-28,0,0,0,900,7,2,210,92,127,83,0,0,83,61,19,9,108,31,309.1,535.0
5375,f9e07282f3444d09,ed209f6618c82e41,7026eca45f65377b,2017-10-28,0,1,0,900,3,0,106,28,106,0,0,0,0,0,8,4,98,28,0.0,553.9
5376,e11e290d816c119b,81d9df19e255b8b6,aa72b0f831d0bfe5,2017-10-28,0,0,0,900,11,7,52,26,31,21,1,1,20,16,5,3,26,10,304.2,451.0
5377,e11e290d816c119b,aa72b0f831d0bfe5,81d9df19e255b8b6,2017-10-28,0,5,0,900,4,1,48,9,48,0,0,0,0,0,17,10,31,9,0.0,529.8
5378,d4eb3614c7734781,7c7332319c14094c,c268b2cfebccf652,2017-10-28,0,0,0,900,0,0,117,21,117,0,0,0,0,0,49,28,68,21,0.0,847.2
5379,d4eb3614c7734781,c268b2cfebccf652,7c7332319c14094c,2017-10-28,0,0,0,900,0,0,171,33,156,15,1,1,14,11,74,43,82,22,52.8,805.0
5380,bed03663bc577f02,a8283a4f415e1eb9,d1941565abf50b16,2017-10-28,0,0,0,900,1,1,140,40,121,19,2,2,17,11,22,21,99,29,177.3,540.4
5381,bed03663bc577f02,d1941565abf50b16,a8283a4f415e1eb9,2017-10-28,0,0,0,900,5,1,80,18,74,6,0,0,6,5,23,16,51,13,79.6,576.7
5382,9dd9affa41eead4c,8adcbd525fab8d9b,b0d6a1d8ac3d563d,2017-10-28,0,0,0,900,5,0,176,56,159,17,0,0,17,9,39,28,120,47,40.4,731.5
5383,9dd9affa41eead4c,b0d6a1d8ac3d563d,8adcbd525fab8d9b,2017-10-28,2,0,0,900,1,0,133,41,125,8,0,0,8,6,23,10,102,35,16.5,791.6
5384,7a5baef71925258c,427b5953ac8e3a27,dc9572dd6ec74859,2017-10-28,0,0,0,900,13,0,151,53,151,0,0,0,0,0,2,0,149,53,0.0,858.0
5385,7a5baef71925258c,dc9572dd6ec74859,427b5953ac8e3a27,2017-10-28,0,0,0,900,0,0,317,65,312,5,0,0,5,3,31,23,281,62,40.0,796.0
5386,72d703db67371e1d,045f25b3a4c08e81,52e76bb4b3e852f3,2017-10-28,0,0,0,270,0,0,15,0,15,0,0,0,0,0,2,1,13,0,0.0,98.19999999999999
5387,72d703db67371e1d,52e76bb4b3e852f3,045f25b3a4c08e81,2017-10-28,0,1,1,270,1,1,27,9,17,10,0,0,10,6,4,2,13,3,171.8,81.0
5388,4ffd88b2f00f4250,9123c54d0a2b72dd,ac29d508d78384c9,2017-10-28,0,0,0,128,0,0,8,1,8,0,0,0,0,0,1,1,7,1,0.0,80.8
5389,4ffd88b2f00f4250,ac29d508d78384c9,9123c54d0a2b72dd,2017-10-28,0,1,1,128,1,1,54,32,31,23,0,0,23,20,3,3,28,12,47.2,46.0
5390,4838bf4ca76c1c6b,6d4b63c767106d3a,d8da10db80131bec,2017-10-28,1,1,1,548,0,0,113,39,105,8,0,0,8,3,27,22,78,36,16.0,530.0
5391,4838bf4ca76c1c6b,d8da10db80131bec,6d4b63c767106d3a,2017-10-28,0,0,0,548,1,0,99,21,99,0,0,0,0,0,9,4,90,21,0.0,532.0
5392,405c0b8d3960016d,b1a3e0aca758b322,f7a7f7118d4b01b6,2017-10-28,1,0,0,150,0,0,24,8,19,5,0,0,5,5,7,2,12,3,3.0,147.0
5393,405c0b8d3960016d,f7a7f7118d4b01b6,b1a3e0aca758b322,2017-10-28,0,0,0,150,0,0,10,2,10,0,0,0,0,0,4,1,6,2,0.0,147.0
5394,23ea24013d15c09c,0a1942069c9ad6b6,dea070ed4a2a8281,2017-10-28,0,0,0,299,2,0,28,4,28,0,0,0,0,0,7,1,21,4,0.0,261.9
5395,23ea24013d15c09c,dea070ed4a2a8281,0a1942069c9ad6b6,2017-10-28,1,0,0,299,0,0,79,22,63,16,1,0,15,7,12,6,51,15,2.1,296.0
5396,0b557aeb2169b59f,05339613bf8e9808,6bd02119599741a4,2017-10-28,0,0,0,243,1,0,68,23,68,0,0,0,0,0,16,7,52,23,0.0,238.0
5397,0b557aeb2169b59f,6bd02119599741a4,05339613bf8e9808,2017-10-28,0,1,1,243,1,0,48,11,48,0,0,0,0,0,16,9,32,11,0.0,241.0
5398,fdfc700e56575d67,1cf7ccf64a5bf24e,cd01f0b768a32475,2017-10-21,1,3,0,900,3,1,93,40,77,16,0,0,16,14,21,16,56,26,142.9,641.0
5399,fdfc700e56575d67,cd01f0b768a32475,1cf7ccf64a5bf24e,2017-10-21,0,0,0,900,0,0,60,9,60,0,0,0,0,0,10,8,50,9,0.0,735.1
5400,f3f252b9810cff0d,2eeaefbfc7f9fcff,d4691518d012b9e7,2017-10-21,0,0,0,453,0,0,64,7,64,0,0,0,0,0,39,34,25,7,0.0,154.0
5401,f3f252b9810cff0d,d4691518d012b9e7,2eeaefbfc7f9fcff,2017-10-21,1,0,0,453,1,1,60,19,36,24,4,2,20,10,6,5,30,9,136.0,249.0
5402,d71ad0033de24fff,411539901068522f,d7c3816669784109,2017-10-21,0,0,0,900,1,0,175,37,171,4,2,2,2,2,57,26,114,35,32.0,826.7
5403,d71ad0033de24fff,d7c3816669784109,411539901068522f,2017-10-21,0,0,0,900,2,1,333,95,328,5,0,0,5,5,49,32,279,90,1.3,858.0
5404,aa7b1fca60a21f3a,1d00756835ca67c9,9ce6d5a03af801b7,2017-10-21,0,0,0,260,2,1,24,2,24,0,0,0,0,0,16,12,8,2,0.0,229.9
5405,aa7b1fca60a21f3a,9ce6d5a03af801b7,1d00756835ca67c9,2017-10-21,1,0,0,260,0,0,55,23,51,4,0,0,4,2,1,1,50,21,1.1,256.0
5406,9da4e06a403f0d27,abd5fb12437eda21,d156513a19acf856,2017-10-21,0,0,0,900,9,1,71,28,71,0,0,0,0,0,11,10,60,28,0.0,647.9
5407,9da4e06a403f0d27,d156513a19acf856,abd5fb12437eda21,2017-10-21,0,0,0,900,0,0,70,12,69,1,0,0,1,1,25,17,44,11,0.1,898.0
5408,8b10419db5bffe28,71002dbc1743b9a7,fba03cd6cc28dc41,2017-10-21,0,0,0,900,1,0,134,32,134,0,0,0,0,0,15,11,119,32,0.0,735.0
5409,8b10419db5bffe28,fba03cd6cc28dc41,71002dbc1743b9a7,2017-10-21,4,0,0,900,2,1,211,43,163,48,4,4,44,18,25,20,138,25,165.0,735.0
5410,88f36fa2945ccac5,cbf1c7ba5408a66f,d317a5e2b3f88c5f,2017-10-21,0,0,0,900,0,0,74,12,74,0,0,0,0,0,35,23,39,12,0.0,845.5
5411,88f36fa2945ccac5,d317a5e2b3f88c5f,cbf1c7ba5408a66f,2017-10-21,0,0,0,900,7,2,95,15,93,2,0,0,2,1,41,23,52,14,37.5,675.0
5412,6a315ef5bf22af29,99df7d0a2a08a8a8,cc7040fe76f0ef91,2017-10-21,0,1,1,482,1,1,44,14,39,5,0,0,5,5,21,19,18,9,67.1,321.0
5413,6a315ef5bf22af29,cc7040fe76f0ef91,99df7d0a2a08a8a8,2017-10-21,0,0,0,482,2,0,43,6,43,0,0,0,0,0,15,9,28,6,0.0,389.9
5414,61070325bb440f58,b7b84ccd221be298,bf43fed8f29e1671,2017-10-21,1,0,0,900,1,1,75,18,73,2,0,0,2,1,12,9,61,17,32.4,423.4
5415,61070325bb440f58,bf43fed8f29e1671,b7b84ccd221be298,2017-10-21,0,1,0,900,10,3,89,17,81,8,0,0,8,4,5,2,76,13,395.6,422.6
5416,4dcd6ff5e32a3779,42a7e90605df3c8a,7be14eaed4c74856,2017-10-21,0,0,0,819,10,1,112,26,112,0,0,0,0,0,26,17,86,26,0.0,527.2
5417,4dcd6ff5e32a3779,7be14eaed4c74856,42a7e90605df3c8a,2017-10-21,1,1,0,819,1,1,147,55,121,26,3,3,23,20,26,21,95,35,186.8,546.0
5418,06287b822837a616,02f2a9702ba3d167,8fd808923cffff82,2017-10-21,0,0,0,900,2,0,116,17,116,0,0,0,0,0,48,38,68,17,0.0,658.7
5419,06287b822837a616,8fd808923cffff82,02f2a9702ba3d167,2017-10-21,1,0,0,900,6,5,145,32,136,9,1,1,8,5,26,22,110,27,219.3,632.0
5420,e08479759c296bb1,bf7ad5628363eec9,e979c76341f19b22,2017-10-07,0,0,0,900,5,4,168,33,163,5,1,1,4,4,49,32,114,29,46.9,731.0
5421,e08479759c296bb1,e979c76341f19b22,bf7ad5628363eec9,2017-10-07,0,0,0,900,1,1,98,22,98,0,0,0,0,0,17,11,81,22,0.0,836.1
5422,d97970009fbfca30,67c1d46f4ed16f9e,ec71a892fada28c7,2017-10-07,0,1,0,900,2,0,140,24,140,0,0,0,0,0,27,14,113,24,0.0,884.0
5423,d97970009fbfca30,ec71a892fada28c7,67c1d46f4ed16f9e,2017-10-07,0,0,0,900,1,1,109,14,109,0,0,0,0,0,29,20,80,14,0.0,888.0
5424,d042d18ad568190a,8a304bfd6bf04a57,a4de54ea806fb525,2017-10-07,0,2,1,1395,8,8,81,24,39,42,23,21,19,17,24,19,15,7,847.1,310.0
5425,d042d18ad568190a,a4de54ea806fb525,8a304bfd6bf04a57,2017-10-07,0,0,0,1395,10,3,29,8,28,1,0,0,1,1,8,5,20,7,16.0,419.9
5426,c46d51fb87a4f485,887961364be5ceb3,f9b200db02b488d9,2017-10-07,0,0,0,900,3,1,232,66,232,0,0,0,0,0,37,27,195,66,0.0,724.9
5427,c46d51fb87a4f485,f9b200db02b488d9,887961364be5ceb3,2017-10-07,1,1,0,900,5,4,232,67,215,17,0,0,17,9,52,37,163,58,45.1,831.0
5428,53ee6c3591483193,03f982ca3735070c,492b202d2064e7a9,2017-10-07,0,0,0,65,0,0,0,0,0,0,0,0,0,0,0,0,0,0,0.0,65.0
5429,53ee6c3591483193,492b202d2064e7a9,03f982ca3735070c,2017-10-07,0,1,1,65,1,1,1,0,1,0,0,0,0,0,0,0,1,0,0.0,34.0
5430,3f5f6c576046bf77,87f19d19f4cb73f8,92437c6775b3f7d1,2017-10-07,0,0,0,98,0,0,10,2,9,1,0,0,1,1,4,3,5,1,3.0,93.0
5431,3f5f6c576046bf77,92437c6775b3f7d1,87f19d19f4cb73f8,2017-10-07,1,0,0,98,1,0,14,3,13,1,0,0,1,1,6,5,7,2,2.0,93.0
5432,2fed4f1d91767eb1,08af939f41b5a57b,e5c9de15bb58b1c6,2017-10-07,1,0,0,900,0,0,157,60,126,31,2,2,29,21,21,19,105,39,118.6,724.0
5433,2fed4f1d91767eb1,e5c9de15bb58b1c6,08af939f41b5a57b,2017-10-07,0,0,0,900,7,1,115,32,115,0,0,0,0,0,6,4,109,32,0.0,587.4
5434,2142ff2a46d22741,0c6d9ea8306c029e,cfb65863d5099327,2017-10-07,1,0,0,900,0,0,136,43,129,7,1,1,6,4,28,26,101,39,45.2,771.8
5435,2142ff2a46d22741,cfb65863d5099327,0c6d9ea8306c029e,2017-10-07,0,0,0,900,7,0,132,31,131,1,0,0,1,0,20,15,111,31,44.2,677.8
5436,1ff3dff34d0b60b8,27b164b0d1833df0,82cbb809d5ee565c,2017-10-07,0,0,0,174,0,0,4,0,4,0,0,0,0,0,1,0,3,0,0.0,12.0
5437,1ff3dff34d0b60b8,82cbb809d5ee565c,27b164b0d1833df0,2017-10-07,0,1,1,174,1,1,5,2,3,2,0,0,2,2,1,1,2,0,162.0,12.0
5438,0f826e7bbb73b53f,1ebdcb7488d0ebee,5c126c6aac3ef364,2017-10-07,0,0,0,900,15,0,58,4,58,0,0,0,0,0,31,23,27,4,0.0,290.0
5439,0f826e7bbb73b53f,5c126c6aac3ef364,1ebdcb7488d0ebee,2017-10-07,0,0,0,900,1,1,105,44,105,0,0,0,0,0,30,23,75,44,0.0,843.0
5440,03aec9073946907f,22a92d7f62195791,ee9ebceabfd16fa7,2017-10-07,0,2,1,842,0,0,103,40,86,17,0,0,17,13,22,14,64,27,1.9,561.0
5441,03aec9073946907f,ee9ebceabfd16fa7,22a92d7f62195791,2017-10-07,0,0,0,842,6,3,119,41,91,28,3,2,25,18,15,12,76,23,279.0,551.1
5442,e8d59c27b467d716,6a1901c62ab3870f,ec34349e7dffcde7,2017-09-22,0,0,0,900,7,4,241,83,132,109,41,39,68,39,25,19,107,44,418.9,383.0
5443,e8d59c27b467d716,ec34349e7dffcde7,6a1901c62ab3870f,2017-09-22,0,2,0,900,7,0,91,41,86,5,0,0,5,3,4,1,82,38,2.0,473.1
5444,e0e4ce7595b5c26a,203c957eac95dd87,5140122c3eecd307,2017-09-22,0,0,0,900,0,0,133,26,133,0,0,0,0,0,25,17,108,26,0.0,897.3
5445,e0e4ce7595b5c26a,5140122c3eecd307,203c957eac95dd87,2017-09-22,1,0,0,900,1,1,183,35,177,6,1,1,5,5,45,27,132,30,2.7,895.0
5446,da7afd49fefe6a46,4665f9f909cd7214,4c288a2b250bb576,2017-09-22,0,0,0,900,12,1,95,36,91,4,0,0,4,1,27,15,64,35,22.5,681.0
5447,da7afd49fefe6a46,4c288a2b250bb576,4665f9f909cd7214,2017-09-22,0,0,0,900,0,0,95,29,95,0,0,0,0,0,25,20,70,29,0.0,754.5
5448,d1bee15e60ee6721,50db8711c70196cd,acff437707625fc7,2017-09-22,0,1,1,110,0,0,0,0,0,0,0,0,0,0,0,0,0,0,0.0,7.0
5449,d1bee15e60ee6721,acff437707625fc7,50db8711c70196cd,2017-09-22,0,1,0,110,1,0,0,0,0,0,0,0,0,0,0,0,0,0,0.0,110.0
5450,ba27835ff05df0c9,3be081c29bf734d9,98a6b2361045898f,2017-09-22,0,0,0,90,0,0,3,1,3,0,0,0,0,0,1,1,2,1,0.0,83.0
5451,ba27835ff05df0c9,98a6b2361045898f,3be081c29bf734d9,2017-09-22,1,0,0,90,0,0,20,8,9,11,1,1,10,4,4,4,5,4,7.0,83.0
5452,6be073563a421bca,55ed59d541f8b90c,88cd34d836b4ebcd,2017-09-22,0,0,0,900,0,0,85,30,81,4,0,0,4,2,24,18,57,28,0.2,561.3
5453,6be073563a421bca,88cd34d836b4ebcd,55ed59d541f8b90c,2017-09-22,1,0,0,900,6,2,98,32,61,37,5,3,32,20,16,15,45,12,337.7,543.8
5454,690ab86bdd94149b,4690d47bf725fd98,b0bd0c5425668b8f,2017-09-22,2,0,0,285,0,0,66,35,66,0,0,0,0,0,6,5,60,35,0.0,276.0
5455,690ab86bdd94149b,b0bd0c5425668b8f,4690d47bf725fd98,2017-09-22,0,0,0,285,1,0,45,16,45,0,0,0,0,0,5,4,40,16,0.0,253.0
5456,3b89556b3f177b7b,7c3c48cf54a2848e,b102c26727306ab6,2017-09-22,0,0,0,270,0,0,32,6,32,0,0,0,0,0,16,10,16,6,0.0,270.0
5457,3b89556b3f177b7b,b102c26727306ab6,7c3c48cf54a2848e,2017-09-22,0,2,1,270,1,1,22,6,22,0,0,0,0,0,4,3,18,6,0.0,177.0
5458,37cdf5bd5c975a5d,24174a3f44ce8e03,a851c35f58199231,2017-09-22,0,0,0,900,0,0,340,73,340,0,0,0,0,0,41,22,299,73,0.0,900.0
5459,37cdf5bd5c975a5d,a851c35f58199231,24174a3f44ce8e03,2017-09-22,0,0,0,900,0,0,284,100,284,0,0,0,0,0,40,35,244,100,0.0,900.0
5460,296cc69bcc3c1635,65ddc8a9ac4e8531,cdb96af67d096b1e,2017-09-22,0,0,0,900,2,2,86,11,86,0,0,0,0,0,26,16,60,11,0.0,855.0
5461,296cc69bcc3c1635,cdb96af67d096b1e,65ddc8a9ac4e8531,2017-09-22,0,0,0,900,0,0,123,32,123,0,0,0,0,0,10,6,113,32,0.0,900.0
5462,ff4cef86bef2d0aa,d4c9dcd330403612,db1f2ed63b54b9a7,2017-09-16,1,0,0,753,1,0,115,27,110,5,0,0,5,2,13,8,97,25,1.1,727.8
5463,ff4cef86bef2d0aa,db1f2ed63b54b9a7,d4c9dcd330403612,2017-09-16,0,0,0,753,2,1,134,26,128,6,0,0,6,3,44,39,84,23,22.2,655.9
5464,7b80dd233e200dd2,78d48d3874dacafd,ba1e6cb3d43f7430,2017-09-16,0,0,0,900,0,0,84,28,84,0,0,0,0,0,24,9,60,28,0.0,900.0
5465,7b80dd233e200dd2,ba1e6cb3d43f7430,78d48d3874dacafd,2017-09-16,0,0,0,900,0,0,126,35,126,0,0,0,0,0,2,1,124,35,0.0,900.0
5466,7864fc46de247f58,c727c7d31c50c4cf,f86cb5f25d545e0e,2017-09-16,0,0,0,24,0,0,1,0,1,0,0,0,0,0,0,0,1,0,0.0,22.0
5467,7864fc46de247f58,f86cb5f25d545e0e,c727c7d31c50c4cf,2017-09-16,1,0,0,24,1,1,6,5,2,4,0,0,4,4,1,0,1,1,2.0,22.0
5468,7094c05bf73eee81,4e06913c91da5200,65578a75fa7900e3,2017-09-16,1,1,0,445,2,1,90,40,69,21,0,0,21,14,5,4,64,26,60.4,301.0
5469,7094c05bf73eee81,65578a75fa7900e3,4e06913c91da5200,2017-09-16,1,0,0,445,0,0,44,15,33,11,1,1,10,6,11,10,22,9,6.0,378.6
5470,52e4f12eaeffd142,5331b25a60417ffb,55ee431411ccf07a,2017-09-16,0,1,0,900,0,0,41,13,37,4,0,0,4,4,4,2,33,9,207.3,355.2
5471,52e4f12eaeffd142,55ee431411ccf07a,5331b25a60417ffb,2017-09-16,0,0,0,900,7,4,46,10,36,10,3,2,7,5,10,8,26,5,233.8,388.7
5472,4c1fd940e1619e68,1bcaac2d99b90fce,f1b2aa7853d1ed6e,2017-09-16,0,0,0,168,0,0,27,10,27,0,0,0,0,0,4,3,23,10,0.0,163.0
5473,4c1fd940e1619e68,f1b2aa7853d1ed6e,1bcaac2d99b90fce,2017-09-16,1,0,0,168,0,0,48,8,46,2,0,0,2,1,13,8,33,7,5.0,163.0
5474,3dd22a9a0ea68cc6,dc07493a87dc0a6e,f2b6fdb20675b11c,2017-09-16,0,0,0,79,0,0,13,1,13,0,0,0,0,0,6,5,7,1,0.0,60.7
5475,3dd22a9a0ea68cc6,f2b6fdb20675b11c,dc07493a87dc0a6e,2017-09-16,1,0,0,79,0,0,18,10,17,1,0,0,1,1,1,1,16,9,0.3,77.0
5476,2ec12d4bbc0752db,23024fdfc966410a,4ac1ecf8ce59ef23,2017-09-16,1,0,0,595,3,2,95,27,88,7,2,1,5,4,16,14,72,23,38.3,462.6
5477,2ec12d4bbc0752db,4ac1ecf8ce59ef23,23024fdfc966410a,2017-09-16,0,0,0,595,2,1,92,11,87,5,0,0,5,3,32,24,55,8,39.4,493.7
5478,24438a644b975751,00e11b5c8b7bfeeb,d2c55d1d2e67773b,2017-09-16,1,0,0,545,5,2,85,40,39,46,0,0,46,34,24,18,15,6,192.7,323.0
5479,24438a644b975751,d2c55d1d2e67773b,00e11b5c8b7bfeeb,2017-09-16,0,0,0,545,2,1,56,13,56,0,0,0,0,0,14,12,42,13,0.0,214.3
5480,128e818254ebfabe,84ff027394f7e470,e45cfa47f504033a,2017-09-16,1,1,1,431,6,4,56,19,40,16,0,0,16,7,3,1,37,12,253.1,83.0
5481,128e818254ebfabe,e45cfa47f504033a,84ff027394f7e470,2017-09-16,0,0,0,431,0,0,43,17,41,2,0,0,2,1,7,5,34,16,0.0,177.9
5482,fdde8777c7ae9769,056c493bbd76a918,5aedf14771ca82d2,2017-09-09,1,0,0,325,2,2,58,24,44,14,1,0,13,8,10,10,34,16,37.1,280.0
5483,fdde8777c7ae9769,5aedf14771ca82d2,056c493bbd76a918,2017-09-09,0,0,0,325,1,0,25,4,25,0,0,0,0,0,1,1,24,4,0.0,287.9
5484,f597d2e69ab7c270,814ff3018127e8fc,da816417a579a0bd,2017-09-09,1,1,0,900,7,4,237,96,107,130,25,24,105,64,30,22,77,32,358.5,431.5
5485,f597d2e69ab7c270,da816417a579a0bd,814ff3018127e8fc,2017-09-09,0,1,0,900,4,0,82,14,79,3,0,0,3,2,13,9,66,12,2.5,526.5
5486,cce5b9dfe84630fa,633a45d131192ffe,7dcf06c1967801c1,2017-09-09,1,0,0,649,0,0,63,7,61,2,0,0,2,2,34,19,27,5,1.0,648.0
5487,cce5b9dfe84630fa,7dcf06c1967801c1,633a45d131192ffe,2017-09-09,0,1,0,649,0,0,31,8,31,0,0,0,0,0,10,8,21,8,0.0,638.0
5488,cb16346d93746ebc,132deb59abae64b1,80fa8218c99f9c58,2017-09-09,0,0,0,1500,1,0,194,30,189,5,0,0,5,4,56,42,133,26,0.0,1449.3
5489,cb16346d93746ebc,80fa8218c99f9c58,132deb59abae64b1,2017-09-09,0,0,0,1500,8,2,176,16,175,1,0,0,1,0,111,70,64,16,50.7,1348.0
5490,b6082b551288aa5a,6a2f7c151031653d,84b3e7d38f2d2ec5,2017-09-09,0,1,1,223,0,0,16,11,1,15,1,1,14,11,1,1,0,0,200.0,23.0
5491,b6082b551288aa5a,84b3e7d38f2d2ec5,6a2f7c151031653d,2017-09-09,0,0,0,223,0,0,5,0,5,0,0,0,0,0,2,1,3,0,0.0,23.0
5492,a773883743242df9,539ed332b3078821,fc6e681bf6658faf,2017-09-09,0,1,1,171,1,0,6,2,2,4,1,1,3,2,0,0,2,0,5.6,134.8
5493,a773883743242df9,fc6e681bf6658faf,539ed332b3078821,2017-09-09,0,0,0,171,0,0,9,1,8,1,0,0,1,1,4,2,4,0,29.2,19.4
5494,94c7e64ce88c9b9e,18968f97ad34f15c,aa5b4eff51bdc7d1,2017-09-09,5,0,0,900,0,0,250,53,239,11,3,3,8,7,50,40,189,46,41.9,820.0
5495,94c7e64ce88c9b9e,aa5b4eff51bdc7d1,18968f97ad34f15c,2017-09-09,0,0,0,900,0,0,129,27,126,3,2,0,1,0,5,2,121,27,0.0,858.1
5496,92eb0a297c7ea197,7be74a12d7352df2,b9706f80d005036c,2017-09-09,0,0,0,556,5,1,58,25,20,38,0,0,38,19,6,4,14,6,257.5,205.5
5497,92eb0a297c7ea197,b9706f80d005036c,7be74a12d7352df2,2017-09-09,0,2,1,556,1,1,21,16,18,3,0,0,3,3,1,1,17,13,18.5,193.5
5498,7020840980f723b9,7e511f8d842a109d,e5bda12faabfc850,2017-09-09,1,0,0,900,1,1,50,23,42,8,0,0,8,5,2,1,40,18,122.5,655.0
5499,7020840980f723b9,e5bda12faabfc850,7e511f8d842a109d,2017-09-09,0,0,0,900,0,0,114,18,114,0,0,0,0,0,19,14,95,18,0.0,777.5
5500,6afaf0ca45431a11,49e96ff8ab781589,e9a3aeb207578eea,2017-09-09,0,0,0,900,0,0,54,12,52,2,0,0,2,2,29,19,23,10,0.7,518.7
5501,6afaf0ca45431a11,e9a3aeb207578eea,49e96ff8ab781589,2017-09-09,0,0,0,900,5,4,79,38,44,35,3,3,32,24,3,3,41,14,377.3,457.3
5502,31c4518a1e71c050,c17041f1bb5768d8,c76ec2bc3a57666a,2017-09-09,3,0,0,576,0,0,115,46,112,3,0,0,3,1,15,11,97,45,1.1,559.1
5503,31c4518a1e71c050,c76ec2bc3a57666a,c17041f1bb5768d8,2017-09-09,0,0,0,576,4,0,83,11,82,1,0,0,1,0,42,17,40,11,1.9,548.9
5504,ecbc282542a395c2,87aa9fb63d6b51a1,bc656db347f31e19,2017-09-02,0,2,1,562,3,1,65,34,52,13,0,0,13,12,13,11,39,22,132.2,318.0
5505,ecbc282542a395c2,bc656db347f31e19,87aa9fb63d6b51a1,2017-09-02,0,0,0,562,7,2,67,6,67,0,0,0,0,0,27,18,40,6,0.0,284.8
5506,cfc550960a7ec353,279566840aa55bf2,ebc1f40e00e0c481,2017-09-02,1,0,0,810,2,2,253,84,225,28,0,0,28,18,75,51,150,66,41.6,752.0
5507,cfc550960a7ec353,ebc1f40e00e0c481,279566840aa55bf2,2017-09-02,0,0,0,810,0,0,162,26,162,0,0,0,0,0,37,15,125,26,0.0,768.4
5508,b7ab4cd6ce7a71dd,51e86de150ee8be6,66ab58d0b3783607,2017-09-02,1,0,0,268,0,0,86,37,78,8,0,0,8,4,9,4,69,33,7.5,238.0
5509,b7ab4cd6ce7a71dd,66ab58d0b3783607,51e86de150ee8be6,2017-09-02,0,0,0,268,6,0,54,14,54,0,0,0,0,0,15,8,39,14,0.0,260.5
5510,b3bf1b6ad2d1a533,1b38a2b897f6209c,8f5c8850b2484173,2017-09-02,0,0,0,84,0,0,7,0,7,0,0,0,0,0,1,0,6,0,0.0,84.0
5511,b3bf1b6ad2d1a533,8f5c8850b2484173,1b38a2b897f6209c,2017-09-02,1,0,0,84,0,0,4,1,4,0,0,0,0,0,2,1,2,1,0.0,83.0
5512,b1f7bc82f7dce1b9,9ce6d5a03af801b7,fcce75a25c14a804,2017-09-02,0,0,0,900,1,1,87,42,68,19,1,1,18,15,7,6,61,27,162.4,727.7
5513,b1f7bc82f7dce1b9,fcce75a25c14a804,9ce6d5a03af801b7,2017-09-02,0,0,0,900,3,0,144,16,142,2,1,1,1,1,34,17,108,15,1.3,735.6
5514,af5f287198f20eb4,37e03538c960bac6,d6285cba1d1052e0,2017-09-02,1,1,0,452,2,2,125,59,34,91,9,9,82,53,11,9,23,6,292.4,121.0
5515,af5f287198f20eb4,d6285cba1d1052e0,37e03538c960bac6,2017-09-02,0,0,0,452,0,0,13,1,12,1,0,0,1,0,1,0,11,1,0.0,159.60000000000002
5516,89f83750703d5fd3,333b9e5c723ac873,b69f24c500d783e7,2017-09-02,0,0,0,900,0,0,150,22,150,0,0,0,0,0,36,24,114,22,0.0,791.0
5517,89f83750703d5fd3,b69f24c500d783e7,333b9e5c723ac873,2017-09-02,0,0,0,900,14,2,55,14,53,2,0,0,2,2,16,10,37,12,96.0,804.0
5518,75a978e0ecce2536,826475cc758e60e6,aec185309b4843d0,2017-09-02,0,0,0,490,5,2,46,11,46,0,0,0,0,0,16,13,30,11,0.0,335.2
5519,75a978e0ecce2536,aec185309b4843d0,826475cc758e60e6,2017-09-02,3,1,0,490,0,0,81,36,59,22,0,0,22,11,7,7,52,25,16.8,461.0
5520,7303ae36077411d9,a331233f597090a5,f1fac969a1d70b08,2017-09-02,1,1,0,900,0,0,87,28,80,7,0,0,7,4,22,16,58,24,19.2,815.0
5521,7303ae36077411d9,f1fac969a1d70b08,a331233f597090a5,2017-09-02,0,3,0,900,6,3,51,13,51,0,0,0,0,0,11,10,40,13,0.0,392.8
5522,605c2ad801f594b3,9b7694d064a8a0ad,f046d724d2a84ac5,2017-09-02,0,0,0,900,11,3,108,22,108,0,0,0,0,0,18,12,90,22,0.0,835.0
5523,605c2ad801f594b3,f046d724d2a84ac5,9b7694d064a8a0ad,2017-09-02,0,0,0,900,2,1,111,22,111,0,0,0,0,0,31,25,80,22,0.0,880.0
5524,5afbc04a153d7efd,69f01b25dfabaf6b,e51fcd9cd84c0b93,2017-09-02,0,0,0,686,0,0,30,4,30,0,0,0,0,0,9,6,21,4,0.0,291.2
5525,5afbc04a153d7efd,e51fcd9cd84c0b93,69f01b25dfabaf6b,2017-09-02,0,1,1,686,6,4,48,21,36,12,0,0,12,11,10,5,26,10,374.8,155.0
5526,0ac25b4180406ca1,5b2325cd70dbe2ea,c7d297714d9ab1a4,2017-09-02,0,1,0,894,7,3,88,11,84,4,1,1,3,2,12,10,72,9,308.0,339.8
5527,0ac25b4180406ca1,c7d297714d9ab1a4,5b2325cd70dbe2ea,2017-09-02,1,5,0,894,0,0,127,47,79,48,0,0,48,23,11,10,68,24,169.2,378.0
5528,e02fca0d258283ce,74d35fbc9c6a61bd,c07efc18b231f170,2017-08-05,0,1,0,121,0,0,7,2,7,0,0,0,0,0,0,0,7,2,0.0,121.0
5529,e02fca0d258283ce,c07efc18b231f170,74d35fbc9c6a61bd,2017-08-05,0,1,1,121,0,0,12,3,12,0,0,0,0,0,7,3,5,3,0.0,98.0
5530,d5598322f81db6c9,4a57ebb14315b251,e8b731feff72294b,2017-08-05,0,0,0,900,11,4,113,40,100,13,0,0,13,10,7,5,93,30,141.2,635.0
5531,d5598322f81db6c9,e8b731feff72294b,4a57ebb14315b251,2017-08-05,0,0,0,900,0,0,157,44,153,4,0,0,4,4,24,20,129,40,26.0,628.8
5532,cd54325a9a538837,cf65d56b0755ed3b,d8da10db80131bec,2017-08-05,0,0,0,104,0,0,9,3,9,0,0,0,0,0,2,2,7,3,0.0,99.0
5533,cd54325a9a538837,d8da10db80131bec,cf65d56b0755ed3b,2017-08-05,1,0,0,104,0,0,19,6,13,6,1,1,5,3,3,3,10,3,5.0,99.0
5534,c8f619a71b714ec7,d156513a19acf856,ee779c43a8926d52,2017-08-05,0,0,0,900,0,0,87,24,87,0,0,0,0,0,18,16,69,24,0.0,895.0
5535,c8f619a71b714ec7,ee779c43a8926d52,d156513a19acf856,2017-08-05,0,0,0,900,8,2,45,8,45,0,0,0,0,0,13,9,32,8,0.0,631.0
5536,a3e4322f55454897,0a1942069c9ad6b6,34e552520a934063,2017-08-05,1,0,0,230,1,1,54,35,6,48,0,0,48,34,5,3,1,1,152.0,78.0
5537,a3e4322f55454897,34e552520a934063,0a1942069c9ad6b6,2017-08-05,0,1,0,230,0,0,4,0,4,0,0,0,0,0,1,0,3,0,0.0,78.0
5538,a3723f0f672b0912,2fe9032955c2e013,546f8599a63c29da,2017-08-05,1,1,1,236,0,0,22,12,6,16,0,0,16,10,0,0,6,2,54.2,33.0
5539,a3723f0f672b0912,546f8599a63c29da,2fe9032955c2e013,2017-08-05,0,0,0,236,1,1,6,2,3,3,0,0,3,1,1,0,2,1,142.0,39.8
5540,48f7e64b548806cd,80daefbed11ce998,d0e50a3d1b250708,2017-08-05,0,0,0,900,6,1,141,22,135,6,4,3,2,0,30,19,105,22,60.9,768.0
5541,48f7e64b548806cd,d0e50a3d1b250708,80daefbed11ce998,2017-08-05,3,0,0,900,0,0,107,26,107,0,0,0,0,0,21,17,86,26,0.0,830.1
5542,2f9b9ef5f6833aa1,2c2caf2f2bab9df5,9c44f290f5726d95,2017-08-05,1,0,0,26,0,0,7,3,5,2,0,0,2,2,2,2,3,1,2.0,24.0
5543,2f9b9ef5f6833aa1,9c44f290f5726d95,2c2caf2f2bab9df5,2017-08-05,0,0,0,26,0,0,3,0,3,0,0,0,0,0,2,1,1,0,0.0,24.0
5544,253e42894852b26a,792be9a24df82ed6,de75d1c45a39e221,2017-08-05,0,0,0,1500,8,4,161,26,151,10,0,0,10,6,31,19,120,20,334.3,1024.2
5545,253e42894852b26a,de75d1c45a39e221,792be9a24df82ed6,2017-08-05,0,0,0,1500,1,0,235,55,232,3,0,0,3,2,32,21,200,53,7.8,1152.7
5546,19348172178f42ed,01fcef7e3d051722,94527830000ab715,2017-08-05,0,0,0,121,0,0,0,0,0,0,0,0,0,0,0,0,0,0,0.0,22.0
5547,19348172178f42ed,94527830000ab715,01fcef7e3d051722,2017-08-05,0,2,1,121,2,1,4,1,3,1,0,0,1,1,2,2,1,0,99.0,22.0
5548,0b89c88d506da083,09f579be4520394a,36549928f90f1d36,2017-08-05,0,2,0,900,1,1,76,11,75,1,0,0,1,1,25,16,50,10,8.0,743.2
5549,0b89c88d506da083,36549928f90f1d36,09f579be4520394a,2017-08-05,0,0,0,900,4,1,112,34,96,16,3,2,13,8,28,23,68,26,140.8,716.0
5550,02732ebb104793d2,449c890bd90f3374,f53c1f4ceeed8c08,2017-08-05,0,0,0,15,0,0,6,1,6,0,0,0,0,0,0,0,6,1,0.0,13.0
5551,02732ebb104793d2,f53c1f4ceeed8c08,449c890bd90f3374,2017-08-05,1,0,0,15,0,0,10,7,6,4,1,1,3,3,0,0,6,4,2.0,13.0
5552,e80a8338d86e730b,05b43e0ead3df345,e76d9f656ceb82ab,2017-07-29,0,0,0,900,3,1,157,62,137,20,3,2,17,11,27,22,110,51,174.4,496.8
5553,e80a8338d86e730b,e76d9f656ceb82ab,05b43e0ead3df345,2017-07-29,0,0,0,900,8,5,181,60,163,18,0,0,18,15,31,22,132,45,63.2,574.6
5554,dffad417175400ba,3974fa35c917af1d,bb1a2cdad6ff34db,2017-07-29,1,0,0,274,1,1,62,37,49,13,2,2,11,8,5,3,44,29,104.6,97.0
5555,dffad417175400ba,bb1a2cdad6ff34db,3974fa35c917af1d,2017-07-29,0,0,0,274,1,0,35,7,33,2,0,0,2,1,2,1,31,6,0.0,169.4
5556,b8c967c742d3c107,1d00756835ca67c9,f2925e6db404bf1d,2017-07-29,0,0,0,900,10,1,166,50,165,1,1,1,0,0,38,31,127,50,2.3,806.0
5557,b8c967c742d3c107,f2925e6db404bf1d,1d00756835ca67c9,2017-07-29,0,0,0,900,1,0,156,47,156,0,0,0,0,0,40,30,116,47,0.0,876.7
5558,79817ab0129c5598,634bb0de2eb043b4,b12a1d19ee383b7c,2017-07-29,1,0,0,716,1,0,143,38,137,6,0,0,6,5,44,36,93,33,8.6,676.0
5559,79817ab0129c5598,b12a1d19ee383b7c,634bb0de2eb043b4,2017-07-29,0,0,0,716,4,1,85,13,85,0,0,0,0,0,31,19,54,13,0.0,659.4
5560,5ab286735ccee803,07f72a2a7591b409,d967f0128c323de6,2017-07-29,1,0,0,781,3,0,165,33,148,17,0,0,17,15,91,62,57,18,11.8,765.0
5561,5ab286735ccee803,d967f0128c323de6,07f72a2a7591b409,2017-07-29,0,0,0,781,3,0,140,29,140,0,0,0,0,0,41,29,99,29,0.0,769.2
5562,4f4806952ba2a72c,81d9df19e255b8b6,a0c64f272b65d441,2017-07-29,0,1,0,900,8,5,80,15,75,5,2,2,3,3,12,10,63,12,136.2,650.3
5563,4f4806952ba2a72c,a0c64f272b65d441,81d9df19e255b8b6,2017-07-29,0,1,0,900,2,1,87,26,75,12,1,1,11,10,7,4,68,16,31.7,726.8
5564,49694c2d00c581ed,0845c81e37d3bcb3,1e1dbd1cc5a7469e,2017-07-29,1,0,0,42,0,0,19,10,16,3,0,0,3,1,2,2,14,9,0.5,40.0
5565,49694c2d00c581ed,1e1dbd1cc5a7469e,0845c81e37d3bcb3,2017-07-29,0,0,0,42,0,0,4,0,4,0,0,0,0,0,2,2,2,0,0.0,26.5
5566,4924d7a980f4cde2,b6452706b373eea1,def8166ff24bd237,2017-07-29,0,0,0,779,2,2,252,91,252,0,0,0,0,0,23,18,229,91,0.0,759.0
5567,4924d7a980f4cde2,def8166ff24bd237,b6452706b373eea1,2017-07-29,0,1,1,779,2,0,220,49,220,0,0,0,0,0,22,16,198,49,0.0,779.0
5568,3d95b4f94ccffa96,751de04455cfaac0,8fd808923cffff82,2017-07-29,0,0,0,900,3,2,160,55,148,12,0,0,12,8,23,20,125,47,25.4,864.0
5569,3d95b4f94ccffa96,8fd808923cffff82,751de04455cfaac0,2017-07-29,0,0,0,900,2,0,202,51,202,0,0,0,0,0,29,22,173,51,0.0,874.6
5570,3636e085c098dbda,519e4fe37ce9ff75,6da99156486ed6c2,2017-07-29,1,0,0,184,1,0,29,5,28,1,0,0,1,1,12,10,16,4,8.4,117.0
5571,3636e085c098dbda,6da99156486ed6c2,519e4fe37ce9ff75,2017-07-29,0,0,0,184,1,0,18,4,18,0,0,0,0,0,11,7,7,4,0.0,175.6
5572,30553d630491094a,427b5953ac8e3a27,effd9de9937996f8,2017-07-29,0,0,0,1500,21,0,89,23,89,0,0,0,0,0,6,5,83,23,0.0,1448.0
5573,30553d630491094a,effd9de9937996f8,427b5953ac8e3a27,2017-07-29,1,0,0,1500,0,0,153,40,153,0,0,0,0,0,22,17,131,40,0.0,1494.0
5574,d83ae4a2e117b775,c482c8605455a213,cc900af167fbedfd,2017-07-22,1,0,0,171,0,0,35,11,32,3,0,0,3,2,12,10,20,9,0.3,170.0
5575,d83ae4a2e117b775,cc900af167fbedfd,c482c8605455a213,2017-07-22,0,0,0,171,0,0,41,7,41,0,0,0,0,0,17,12,24,7,0.0,89.7
5576,d0e5487f55c57ad2,4c7781da8c6cae93,57b10fca4f9c9a7a,2017-07-22,0,0,0,410,2,0,14,2,11,3,3,3,0,0,1,0,10,2,260.0,149.7
5577,d0e5487f55c57ad2,57b10fca4f9c9a7a,4c7781da8c6cae93,2017-07-22,1,1,0,410,1,0,21,4,20,1,0,0,1,0,4,4,16,4,0.3,149.0
5578,bcf842992f9accdc,68f6e96c5fa6e044,c5af5750e8bae4f0,2017-07-22,0,0,0,900,14,8,94,30,55,39,5,4,34,17,7,7,48,13,543.7,203.0
5579,bcf842992f9accdc,c5af5750e8bae4f0,68f6e96c5fa6e044,2017-07-22,0,0,0,900,0,0,54,13,51,3,0,0,3,1,11,10,40,12,0.0,356.29999999999995
5580,b2297232b9310ba5,96c336b463e0662c,c8097968da5e5f13,2017-07-22,0,0,0,900,5,3,63,6,54,9,8,8,1,0,15,8,39,6,137.1,281.5
5581,b2297232b9310ba5,c8097968da5e5f13,96c336b463e0662c,2017-07-22,0,2,0,900,8,3,43,16,32,11,1,1,10,8,11,6,21,8,420.5,265.9
5582,9f114a219523bf7d,98d961097baaf308,fa37628269132d1a,2017-07-22,3,0,0,900,1,1,197,87,180,17,1,1,16,11,17,14,163,76,28.3,845.0
5583,9f114a219523bf7d,fa37628269132d1a,98d961097baaf308,2017-07-22,0,0,0,900,14,0,177,40,177,0,0,0,0,0,18,11,159,40,0.0,781.7
5584,8028d5de087755dc,6f242453c91a5af0,92a9aa9c93192871,2017-07-22,0,0,0,900,6,1,160,39,159,1,0,0,1,0,34,30,125,39,4.5,728.3
5585,8028d5de087755dc,92a9aa9c93192871,6f242453c91a5af0,2017-07-22,0,2,0,900,10,3,154,42,151,3,2,2,1,1,33,26,118,41,15.7,649.5
5586,7e2bc09d866b3bd7,0dba4df5f34d5ff0,cad24459b28592ca,2017-07-22,0,0,0,174,1,0,23,8,23,0,0,0,0,0,7,6,16,8,0.0,133.8
5587,7e2bc09d866b3bd7,cad24459b28592ca,0dba4df5f34d5ff0,2017-07-22,1,0,0,174,2,1,29,22,15,14,1,1,13,10,0,0,15,12,40.2,128.0
5588,7c23770c639dcd22,2b074403b7c6cdb4,9c907996820d2d69,2017-07-22,0,0,0,900,0,0,167,36,167,0,0,0,0,0,46,36,121,36,0.0,853.7
5589,7c23770c639dcd22,9c907996820d2d69,2b074403b7c6cdb4,2017-07-22,2,0,0,900,6,2,160,38,156,4,0,0,4,4,46,32,110,34,30.3,794.0
5590,76d6789779d3721c,e51e5cb722bd47a8,fcd448a2fe1a23cc,2017-07-22,0,0,0,900,11,1,182,70,182,0,0,0,0,0,19,16,163,70,0.0,714.0
5591,76d6789779d3721c,fcd448a2fe1a23cc,e51e5cb722bd47a8,2017-07-22,0,0,0,900,0,0,196,66,190,6,0,0,6,5,7,6,183,61,0.0,900.0
5592,657fd7ab7bdf9f15,4e0692ad070976e4,8adcbd525fab8d9b,2017-07-22,0,0,0,900,1,1,165,57,164,1,0,0,1,1,19,18,145,56,1.5,863.0
5593,657fd7ab7bdf9f15,8adcbd525fab8d9b,4e0692ad070976e4,2017-07-22,0,0,0,900,7,1,219,56,219,0,0,0,0,0,38,27,181,56,0.0,826.5
5594,5be97c1fa222093d,3a8176e15b9887c1,8c0580d4fff106c1,2017-07-22,0,2,1,825,13,7,76,25,68,8,0,0,8,6,17,11,51,19,213.6,365.6
5595,5be97c1fa222093d,8c0580d4fff106c1,3a8176e15b9887c1,2017-07-22,1,0,0,825,0,0,47,21,37,10,0,0,10,10,5,5,32,11,5.4,604.4
5596,573908b71b361312,7be14eaed4c74856,7c7332319c14094c,2017-07-22,0,0,0,138,3,1,16,2,16,0,0,0,0,0,9,6,7,2,0.0,74.0
5597,573908b71b361312,7c7332319c14094c,7be14eaed4c74856,2017-07-22,0,2,1,138,0,0,15,2,15,0,0,0,0,0,4,3,11,2,0.0,131.0
5598,4f07c6724682cd00,01b352b6a9074d5c,3f11b5d4bd76a6d9,2017-07-22,0,0,0,900,0,0,228,61,228,0,0,0,0,0,60,50,168,61,0.0,888.0
5599,4f07c6724682cd00,3f11b5d4bd76a6d9,01b352b6a9074d5c,2017-07-22,0,0,0,900,5,0,188,40,188,0,0,0,0,0,38,28,150,40,0.0,899.0
5600,d49d2c810583a56a,3df5493bb279226f,76984112f697631f,2017-07-16,0,0,0,473,1,1,106,43,106,0,0,0,0,0,30,25,76,43,0.0,436.7
5601,d49d2c810583a56a,76984112f697631f,3df5493bb279226f,2017-07-16,1,0,0,473,0,0,192,74,190,2,0,0,2,1,35,27,155,73,2.3,385.0
5602,c62a90c19af6a0e2,31a13532e724ca2b,e5010b1b94ca5755,2017-07-16,0,0,0,237,1,0,9,2,9,0,0,0,0,0,3,3,6,2,0.0,89.6
5603,c62a90c19af6a0e2,e5010b1b94ca5755,31a13532e724ca2b,2017-07-16,1,0,0,237,0,0,35,14,17,18,1,1,17,11,10,8,7,3,42.4,171.0
5604,b7f6d05d3afbb266,12f91bfa8f1f723b,98215d037be5bcb7,2017-07-16,0,0,0,900,0,0,176,19,176,0,0,0,0,0,71,44,105,19,0.0,859.4
5605,b7f6d05d3afbb266,98215d037be5bcb7,12f91bfa8f1f723b,2017-07-16,0,2,0,900,5,2,111,21,108,3,1,1,2,1,59,32,49,20,23.6,837.0
5606,a77950d6a0a451f4,8d5350fa18b79e9a,ce1e867808ef5fce,2017-07-16,0,0,0,900,0,0,114,15,114,0,0,0,0,0,29,21,85,15,0.0,699.7
5607,a77950d6a0a451f4,ce1e867808ef5fce,8d5350fa18b79e9a,2017-07-16,0,0,0,900,4,3,91,40,80,11,1,1,10,9,17,11,63,31,160.3,696.0
5608,a0909aab15ba53c5,f7d73e452b064bf2,fbf0537e420e698e,2017-07-16,1,2,0,900,3,1,174,69,126,48,5,3,43,35,30,21,96,34,302.6,497.0
5609,a0909aab15ba53c5,fbf0537e420e698e,f7d73e452b064bf2,2017-07-16,0,0,0,900,2,0,129,44,120,9,6,5,3,2,24,20,96,42,50.0,447.4
5610,8fd14eb227688467,49a74b9fb2e45fdf,a0f0004aadf10b71,2017-07-16,0,0,0,751,2,0,183,72,179,4,0,0,4,2,13,10,166,70,0.7,741.0
5611,8fd14eb227688467,a0f0004aadf10b71,49a74b9fb2e45fdf,2017-07-16,1,1,1,751,1,1,227,57,226,1,0,0,1,1,82,62,144,56,6.0,482.3
5612,86892d114b204bf3,045f25b3a4c08e81,b59037262c8fe060,2017-07-16,0,0,0,900,0,0,217,55,217,0,0,0,0,0,39,20,178,55,0.0,900.0
5613,86892d114b204bf3,b59037262c8fe060,045f25b3a4c08e81,2017-07-16,0,0,0,900,0,0,189,58,189,0,0,0,0,0,37,25,152,58,0.0,796.0
5614,8417a20d56fe6776,6d1bffff14897645,fd55393021a8c255,2017-07-16,1,0,0,82,0,0,12,7,9,3,0,0,3,3,0,0,9,4,3.0,79.0
5615,8417a20d56fe6776,fd55393021a8c255,6d1bffff14897645,2017-07-16,0,0,0,82,0,0,7,4,7,0,0,0,0,0,1,1,6,4,0.0,79.0
5616,7e7fba47f511f8ad,8a56ea383fd26e52,e81dd0bb8a64b550,2017-07-16,1,0,0,130,1,1,25,6,21,4,0,0,4,2,7,4,14,4,3.0,127.0
5617,7e7fba47f511f8ad,e81dd0bb8a64b550,8a56ea383fd26e52,2017-07-16,0,0,0,130,1,0,12,2,12,0,0,0,0,0,3,1,9,2,0.0,119.0
5618,2fef7ac78df0cccc,544d7460b3e44393,ec52462a1b41f714,2017-07-16,0,0,0,900,0,0,115,20,109,6,0,0,6,5,8,8,101,15,0.0,207.0
5619,2fef7ac78df0cccc,ec52462a1b41f714,544d7460b3e44393,2017-07-16,0,1,0,900,5,3,104,52,54,50,1,1,49,36,5,3,49,16,693.0,207.0
5620,1ccde17f48fb709e,7dfb56f24fe5ddea,a6cba6bb66c1a8c9,2017-07-16,0,0,0,539,5,2,63,15,63,0,0,0,0,0,18,10,45,15,0.0,355.3
5621,1ccde17f48fb709e,a6cba6bb66c1a8c9,7dfb56f24fe5ddea,2017-07-16,1,0,0,539,1,0,65,14,62,3,0,0,3,1,19,10,43,13,2.7,529.0
5622,0f8b2f7299b5e114,749f572d1d3161fb,eabf206b162b3b83,2017-07-16,1,0,0,296,0,0,47,14,42,5,0,0,5,2,4,1,38,12,4.0,292.0
5623,0f8b2f7299b5e114,eabf206b162b3b83,749f572d1d3161fb,2017-07-16,0,0,0,296,1,0,29,1,29,0,0,0,0,0,23,16,6,1,0.0,292.0
5624,e1100fc357e61fba,984d15d5dc7bfcf9,b27a1fcb56a3035a,2017-07-08,0,0,0,474,1,0,24,1,23,1,0,0,1,1,5,4,18,0,8.0,148.7
5625,e1100fc357e61fba,b27a1fcb56a3035a,984d15d5dc7bfcf9,2017-07-08,1,0,0,474,5,5,53,34,16,37,4,4,33,26,4,3,12,8,317.3,123.0
5626,cf4c2b601c2228aa,470fedbc8563ac47,fa6796c55d6c5440,2017-07-08,0,0,0,900,1,0,132,29,132,0,0,0,0,0,27,22,105,29,0.0,785.3
5627,cf4c2b601c2228aa,fa6796c55d6c5440,470fedbc8563ac47,2017-07-08,0,0,0,900,13,0,168,41,155,13,11,11,2,2,22,20,133,39,111.7,565.0
5628,b67229e7675eed24,492b202d2064e7a9,b4ad3a06ee4d660c,2017-07-08,1,0,0,900,3,1,115,28,105,10,3,2,7,5,28,19,77,23,75.2,742.0
5629,b67229e7675eed24,b4ad3a06ee4d660c,492b202d2064e7a9,2017-07-08,0,0,0,900,0,0,38,15,38,0,0,0,0,0,6,6,32,15,0.0,744.8
5630,a5a065cb6d33ba9e,05339613bf8e9808,3a314d9fa7c6825d,2017-07-08,0,3,1,576,4,2,144,50,140,4,0,0,4,4,24,20,116,46,30.4,447.0
5631,a5a065cb6d33ba9e,3a314d9fa7c6825d,05339613bf8e9808,2017-07-08,0,0,0,576,2,2,93,16,93,0,0,0,0,0,25,12,68,16,0.0,535.6
5632,9298175cb2ad7d41,2aa49b3766a59bcd,b1b0729d27936f2f,2017-07-08,0,1,0,900,6,1,61,4,61,0,0,0,0,0,35,32,26,4,0.0,747.8
5633,9298175cb2ad7d41,b1b0729d27936f2f,2aa49b3766a59bcd,2017-07-08,0,0,0,900,12,4,110,30,103,7,1,1,6,4,22,14,81,26,116.2,485.0
5634,323fb015ca2444e3,6ac9bc2953c47345,dea070ed4a2a8281,2017-07-08,0,0,0,424,8,3,29,13,25,4,0,0,4,4,5,2,20,9,28.0,228.5
5635,323fb015ca2444e3,dea070ed4a2a8281,6ac9bc2953c47345,2017-07-08,1,0,0,424,0,0,115,48,48,67,5,4,62,35,8,8,40,13,125.5,263.0
5636,1f49b59e4058568f,cbb682f5fcc44bfc,d1941565abf50b16,2017-07-08,0,0,0,900,2,1,121,49,108,13,3,2,10,7,33,29,75,42,128.2,636.5
5637,1f49b59e4058568f,d1941565abf50b16,cbb682f5fcc44bfc,2017-07-08,0,0,0,900,4,1,110,13,99,11,0,0,11,4,45,35,54,9,46.5,661.8
5638,19eed5d9781b47ac,1999ffb5cebc314f,c03a5022f8439f2a,2017-07-08,0,0,0,687,0,0,182,29,182,0,0,0,0,0,22,18,160,29,0.0,667.8
5639,19eed5d9781b47ac,c03a5022f8439f2a,1999ffb5cebc314f,2017-07-08,1,0,0,687,1,1,179,31,170,9,2,2,7,5,50,43,120,26,19.2,655.0
5640,1645ed92dcdc5c03,ba5e253af86db1a8,bf7ad5628363eec9,2017-07-08,0,0,0,900,1,0,152,41,148,4,0,0,4,2,25,19,123,39,3.8,586.9
5641,1645ed92dcdc5c03,bf7ad5628363eec9,ba5e253af86db1a8,2017-07-08,0,0,0,900,12,8,160,74,110,50,1,1,49,35,24,19,86,39,297.1,486.2
5642,06cd9812e2b9b747,e1147d3d2dabe1ce,f77c68bb4be8516d,2017-07-08,0,0,0,1500,0,0,221,46,207,14,0,0,14,8,58,28,149,38,50.6,1226.0
5643,06cd9812e2b9b747,f77c68bb4be8516d,e1147d3d2dabe1ce,2017-07-08,0,0,0,1500,18,4,107,20,103,4,1,1,3,3,38,27,65,17,180.0,1134.4
5644,00b801e7e1679f2f,3236bf606fe9fa5b,98c23cb6da5b3352,2017-07-08,1,0,0,524,1,1,71,17,70,1,0,0,1,0,23,18,47,17,6.9,340.8
5645,00b801e7e1679f2f,98c23cb6da5b3352,3236bf606fe9fa5b,2017-07-08,1,2,1,524,4,3,85,35,69,16,0,0,16,14,18,18,51,21,100.2,304.1
5646,f0ac3761d3fdda3e,31ef8b67e13495b3,75a6a390fd5dca46,2017-07-07,0,1,1,353,7,0,23,5,21,2,0,0,2,1,12,10,9,4,41.6,149.7
5647,f0ac3761d3fdda3e,75a6a390fd5dca46,31ef8b67e13495b3,2017-07-07,0,0,0,353,3,1,31,1,29,2,0,0,2,0,8,5,21,1,16.3,262.4
5648,e97b609eefc5fd61,13a0275fa13c4d26,7195e2a932686f82,2017-07-07,1,0,0,728,1,1,150,75,141,9,0,0,9,9,10,9,131,66,9.6,694.0
5649,e97b609eefc5fd61,7195e2a932686f82,13a0275fa13c4d26,2017-07-07,0,0,0,728,0,0,160,22,160,0,0,0,0,0,19,6,141,22,0.0,704.4
5650,c94c3e4bbed24421,b4c6c904a9ffc5e8,f0feeb2192937424,2017-07-07,0,0,0,900,6,3,108,11,108,0,0,0,0,0,27,15,81,11,0.0,600.6
5651,c94c3e4bbed24421,f0feeb2192937424,b4c6c904a9ffc5e8,2017-07-07,0,0,0,900,1,1,100,20,96,4,0,0,4,3,33,27,63,17,99.4,726.0
5652,c7c7be3b0d65a7da,8f6a18831a120817,cc81c92fe2254935,2017-07-07,0,0,0,900,0,0,188,102,188,0,0,0,0,0,5,4,183,102,0.0,891.0
5653,c7c7be3b0d65a7da,cc81c92fe2254935,8f6a18831a120817,2017-07-07,0,0,0,900,9,1,200,24,200,0,0,0,0,0,42,29,158,24,0.0,840.0
5654,88c2da7b33cca8d4,7d96bc577e5178b2,88cd34d836b4ebcd,2017-07-07,0,2,0,900,11,11,24,8,7,17,6,5,11,7,3,3,4,1,630.6,119.8
5655,88c2da7b33cca8d4,88cd34d836b4ebcd,7d96bc577e5178b2,2017-07-07,0,0,0,900,0,0,13,3,12,1,0,0,1,1,6,5,6,2,1.2,263.4
5656,7f3bd3b913df61f4,06f36cf4bd97ec77,5d7bdab5e03e3216,2017-07-07,0,3,0,900,1,1,41,21,26,15,0,0,15,10,3,3,23,11,153.8,252.0
5657,7f3bd3b913df61f4,5d7bdab5e03e3216,06f36cf4bd97ec77,2017-07-07,0,1,0,900,6,6,72,38,27,45,5,4,40,28,12,12,15,10,484.0,176.2
5658,6f836a82a0530884,32c355b04fc57f3a,7cbf7c78d3b34218,2017-07-07,0,0,0,900,6,2,77,12,75,2,2,2,0,0,29,20,46,12,31.7,562.3
5659,6f836a82a0530884,7cbf7c78d3b34218,32c355b04fc57f3a,2017-07-07,0,0,0,900,7,3,79,10,67,12,3,2,9,3,33,27,34,7,147.7,548.3
5660,6ec0a046de95fe16,0c6d9ea8306c029e,34f88592c0ab7a54,2017-07-07,0,0,0,900,3,1,71,18,71,0,0,0,0,0,15,13,56,18,0.0,761.0
5661,6ec0a046de95fe16,34f88592c0ab7a54,0c6d9ea8306c029e,2017-07-07,0,0,0,900,7,3,82,18,81,1,0,0,1,1,31,16,50,17,12.0,647.0
5662,5934de85b9c53e7c,dd992d569aaebee6,e9213f53ddeca978,2017-07-07,0,2,1,343,3,2,24,21,1,23,0,0,23,20,0,0,1,1,330.0,13.0
5663,5934de85b9c53e7c,e9213f53ddeca978,dd992d569aaebee6,2017-07-07,1,0,0,343,0,0,4,4,1,3,0,0,3,3,0,0,1,1,0.0,13.0
5664,3e5a3ecd2b123fc2,99bcdf5eac39898f,d761b3766e38c5db,2017-07-07,0,0,0,900,6,2,139,39,129,10,0,0,10,6,8,3,121,33,73.3,790.0
5665,3e5a3ecd2b123fc2,d761b3766e38c5db,99bcdf5eac39898f,2017-07-07,0,0,0,900,3,0,103,28,103,0,0,0,0,0,29,25,74,28,0.0,826.7
5666,0d5356c506111a57,511e82663651438d,9e8f6c728eb01124,2017-07-07,0,0,0,588,3,1,200,47,197,3,0,0,3,1,54,44,143,46,4.2,554.0
5667,0d5356c506111a57,9e8f6c728eb01124,511e82663651438d,2017-07-07,1,0,0,588,0,0,174,62,174,0,0,0,0,0,50,42,124,62,0.0,577.8
5668,f7ae397fefa57c70,065eb44700e641a4,18e8b7070228e728,2017-06-25,0,2,0,900,3,0,79,15,66,13,7,6,6,6,30,22,36,9,82.3,484.9
5669,f7ae397fefa57c70,18e8b7070228e728,065eb44700e641a4,2017-06-25,0,2,0,900,0,0,76,31,53,23,2,2,21,14,4,4,49,17,301.1,385.7
5670,eafda776967c6444,1f4b04a926ef1287,5331b25a60417ffb,2017-06-25,0,0,0,900,1,0,254,51,254,0,0,0,0,0,59,41,195,51,0.0,848.0
5671,eafda776967c6444,5331b25a60417ffb,1f4b04a926ef1287,2017-06-25,0,1,0,900,2,1,226,70,224,2,0,0,2,2,15,12,209,68,0.0,900.0
5672,bd59c07a106d331b,928ae2e5b5f7a9ec,b6850671a008bf9a,2017-06-25,0,0,0,900,2,0,72,28,64,8,1,1,7,6,14,11,50,22,59.4,269.6
5673,bd59c07a106d331b,b6850671a008bf9a,928ae2e5b5f7a9ec,2017-06-25,0,1,0,900,5,2,93,40,65,28,0,0,28,22,7,7,58,18,526.4,276.6
5674,b53fd8bce62aa1c6,4b47e71384a9522f,a2b12c3f3d60ff69,2017-06-25,0,0,0,900,0,0,174,31,174,0,0,0,0,0,45,33,129,31,0.0,899.0
5675,b53fd8bce62aa1c6,a2b12c3f3d60ff69,4b47e71384a9522f,2017-06-25,0,0,0,900,5,0,151,26,151,0,0,0,0,0,12,6,139,26,0.0,871.0
5676,aebdb007f8d1348a,30ea504870f8597b,917a5cb9821df261,2017-06-25,0,0,0,81,1,0,12,1,12,0,0,0,0,0,4,3,8,1,0.0,51.5
5677,aebdb007f8d1348a,917a5cb9821df261,30ea504870f8597b,2017-06-25,1,0,0,81,0,0,25,13,12,13,0,0,13,8,4,4,8,5,6.5,73.0
5678,ae5c7517d9f2516c,2d447cc91bdaa545,2e19380f34871c6a,2017-06-25,0,0,0,29,1,0,3,1,3,0,0,0,0,0,0,0,3,1,0.0,23.0
5679,ae5c7517d9f2516c,2e19380f34871c6a,2d447cc91bdaa545,2017-06-25,1,0,0,29,0,0,16,10,10,6,0,0,6,6,3,3,7,4,6.0,23.0
5680,9a79a4b97a0f1e24,99bd87a300079ed9,c47df9303d318c67,2017-06-25,0,0,0,900,0,0,39,10,39,0,0,0,0,0,3,3,36,10,0.0,303.20000000000005
5681,9a79a4b97a0f1e24,c47df9303d318c67,99bd87a300079ed9,2017-06-25,0,0,0,900,8,2,87,33,33,54,4,4,50,29,4,1,29,4,561.8,307.0
5682,7013a95ea4014606,c58f51dedb310998,ee9ebceabfd16fa7,2017-06-25,0,0,0,277,0,0,9,3,7,2,0,0,0,0,0,0,5,0,8.0,56.0
5683,7013a95ea4014606,ee9ebceabfd16fa7,c58f51dedb310998,2017-06-25,0,1,1,277,1,1,30,19,4,26,0,0,26,19,3,3,1,0,213.0,56.0
5684,3d1f83264d87c529,4bcb6eb12b4ad4aa,7acbb0972e75281a,2017-06-25,0,0,0,900,1,0,161,13,161,0,0,0,0,0,69,38,92,13,0.0,812.0
5685,3d1f83264d87c529,7acbb0972e75281a,4bcb6eb12b4ad4aa,2017-06-25,0,0,0,900,7,3,161,50,160,1,0,0,1,1,23,19,137,49,75.0,675.0
5686,3a4d2a933a3c7291,5f87a5c00b3d17ed,73c7cfa551289285,2017-06-25,0,0,0,900,1,0,280,59,280,0,0,0,0,0,81,44,199,59,0.0,808.3
5687,3a4d2a933a3c7291,73c7cfa551289285,5f87a5c00b3d17ed,2017-06-25,1,0,0,900,0,0,107,47,99,8,3,3,5,1,9,7,90,46,80.7,779.0
5688,1e75ee0da189857b,5e84a859c6a82288,7026eca45f65377b,2017-06-25,0,0,0,564,0,0,78,6,78,0,0,0,0,0,23,10,55,6,0.0,309.9
5689,1e75ee0da189857b,7026eca45f65377b,5e84a859c6a82288,2017-06-25,1,0,0,564,6,4,121,54,70,51,2,2,49,34,17,11,53,20,254.1,285.0
5690,1bd52b0c01018f4a,b4192a975027aab6,d910665038efc639,2017-06-25,0,1,0,900,0,0,119,35,113,6,1,1,5,5,4,2,109,30,0.0,636.7
5691,1bd52b0c01018f4a,d910665038efc639,b4192a975027aab6,2017-06-25,0,0,0,900,14,6,95,32,73,22,8,4,14,9,6,4,67,23,263.3,517.0
5692,0ad57af26ddc7930,0941df56f6ac954b,c80095f6092271a7,2017-06-25,0,0,0,346,0,0,45,2,45,0,0,0,0,0,9,8,36,2,0.0,345.9
5693,0ad57af26ddc7930,c80095f6092271a7,0941df56f6ac954b,2017-06-25,1,0,0,346,0,0,68,19,67,1,0,0,1,1,27,22,40,18,0.1,345.0
5694,fc2585e234e49dee,3be081c29bf734d9,53ec9cb470e1a4ea,2017-06-17,0,0,0,72,0,0,5,0,5,0,0,0,0,0,1,0,4,0,0.0,46.7
5695,fc2585e234e49dee,53ec9cb470e1a4ea,3be081c29bf734d9,2017-06-17,0,1,1,72,0,0,13,6,9,4,0,0,4,3,1,1,8,3,25.3,34.0
5696,e7b5a8c97106ca60,199eb7cf6ae90294,2a4200ead401a9ce,2017-06-17,0,5,0,900,2,0,116,47,83,33,4,2,29,18,17,13,66,29,415.3,358.3
5697,e7b5a8c97106ca60,2a4200ead401a9ce,199eb7cf6ae90294,2017-06-17,0,0,0,900,4,2,74,19,69,5,0,0,5,2,21,11,48,17,25.7,407.7
5698,b66f4fa1b9b96b51,55ed59d541f8b90c,7aa3d6964eff4877,2017-06-17,0,0,0,600,4,1,65,9,65,0,0,0,0,0,21,11,44,9,0.0,476.9
5699,b66f4fa1b9b96b51,7aa3d6964eff4877,55ed59d541f8b90c,2017-06-17,1,1,0,600,0,0,93,38,87,6,2,1,4,3,16,12,71,35,38.1,492.0
5700,b6464850da8f3099,9bcf8603ceb25680,dc9572dd6ec74859,2017-06-17,0,0,0,900,4,2,54,16,52,2,0,0,2,2,4,3,48,14,34.0,798.1
5701,b6464850da8f3099,dc9572dd6ec74859,9bcf8603ceb25680,2017-06-17,0,0,0,900,15,8,105,18,103,2,2,2,0,0,44,27,59,18,33.9,256.0
5702,a71e4206f87ae74c,7c3c48cf54a2848e,9fa568ad2bf2cb0b,2017-06-17,0,1,1,499,3,2,41,11,37,4,1,0,3,1,13,10,24,10,30.2,135.10000000000002
5703,a71e4206f87ae74c,9fa568ad2bf2cb0b,7c3c48cf54a2848e,2017-06-17,1,0,0,499,2,1,62,28,36,26,1,1,25,19,10,8,26,9,295.9,138.8
5704,a69a155a25b84679,0749d968e932df53,6a2f7c151031653d,2017-06-17,0,0,0,900,1,1,139,34,139,0,0,0,0,0,27,26,112,34,0.0,634.7
5705,a69a155a25b84679,6a2f7c151031653d,0749d968e932df53,2017-06-17,0,1,0,900,5,1,158,35,151,7,1,1,6,4,58,45,93,31,44.3,691.0
5706,9072bf6135cad3e0,03f982ca3735070c,9be6020024133293,2017-06-17,1,0,0,104,0,0,41,17,20,21,0,0,21,14,6,4,14,3,24.0,80.0
5707,9072bf6135cad3e0,9be6020024133293,03f982ca3735070c,2017-06-17,0,0,0,104,0,0,14,1,14,0,0,0,0,0,3,1,11,1,0.0,80.0
5708,8984ab656cb1818d,764342d39cdaa54a,e64b96c07d7ce999,2017-06-17,0,0,0,900,1,1,120,32,120,0,0,0,0,0,6,3,114,32,0.0,861.0
5709,8984ab656cb1818d,e64b96c07d7ce999,764342d39cdaa54a,2017-06-17,0,0,0,900,7,2,176,54,176,0,0,0,0,0,56,40,120,54,0.0,827.0
5710,7d14f95d03afb359,3cf66c62d9069f43,a20f234df70f2182,2017-06-17,0,2,0,900,0,0,169,42,169,0,0,0,0,0,23,11,146,42,0.0,576.3
5711,7d14f95d03afb359,a20f234df70f2182,3cf66c62d9069f43,2017-06-17,0,0,0,900,1,0,162,42,158,4,0,0,4,0,23,18,135,42,16.7,825.0
5712,361e67af5f462aea,c13042265355a290,f50d95223751e6ca,2017-06-17,0,0,0,249,1,1,24,5,23,1,0,0,1,0,8,5,15,5,12.0,235.2
5713,361e67af5f462aea,f50d95223751e6ca,c13042265355a290,2017-06-17,1,0,0,249,0,0,46,13,38,8,0,0,8,4,9,4,29,9,1.8,235.0
5714,205ad947e8c94901,3738e68d2261e60f,c9cf753cfdf77fc2,2017-06-17,0,0,0,900,2,0,56,18,54,2,2,1,0,0,12,9,42,18,30.0,179.89999999999998
5715,205ad947e8c94901,c9cf753cfdf77fc2,3738e68d2261e60f,2017-06-17,0,0,0,900,3,2,92,46,27,65,1,1,64,41,8,4,19,5,480.1,353.0
5716,0096879f5708526b,634e2fb70bde3fd5,673ea7dcc786b1b3,2017-06-17,1,0,0,669,0,0,53,10,51,2,0,0,2,1,20,15,31,9,1.3,667.0
5717,0096879f5708526b,673ea7dcc786b1b3,634e2fb70bde3fd5,2017-06-17,0,0,0,669,0,0,65,4,65,0,0,0,0,0,21,11,44,4,0.0,654.7
5718,e4db3b1669d498c3,35faad160d346839,e1248941344b3288,2017-06-10,0,0,0,900,5,0,149,39,147,2,0,0,2,2,10,7,137,37,6.6,697.3
5719,e4db3b1669d498c3,e1248941344b3288,35faad160d346839,2017-06-10,1,0,0,900,7,4,139,55,113,26,0,0,26,23,42,32,71,32,179.7,575.4
5720,dc7ba55ca764cfbe,193b9d1858bc4df3,4f732e58ed907eff,2017-06-10,1,0,0,482,1,0,141,40,140,1,0,0,1,1,33,29,107,39,1.0,481.0
5721,dc7ba55ca764cfbe,4f732e58ed907eff,193b9d1858bc4df3,2017-06-10,0,0,0,482,0,0,88,15,88,0,0,0,0,0,29,23,59,15,0.0,479.0
5722,cd96998e837b0da1,d3df1add9d9a7efb,eef9b891edbd4604,2017-06-10,0,0,0,1131,3,0,139,34,139,0,0,0,0,0,27,17,112,34,0.0,1131.0
5723,cd96998e837b0da1,eef9b891edbd4604,d3df1add9d9a7efb,2017-06-10,1,0,0,1131,0,0,125,37,125,0,0,0,0,0,34,22,91,37,0.0,1131.0
5724,bd4a648bebaefab3,24174a3f44ce8e03,6fd953151d981979,2017-06-10,0,0,0,900,0,0,250,47,248,2,0,0,2,2,67,45,181,45,0.7,898.0
5725,bd4a648bebaefab3,6fd953151d981979,24174a3f44ce8e03,2017-06-10,0,0,0,900,0,0,245,71,245,0,0,0,0,0,36,27,209,71,0.0,899.3
5726,ad772f626b5dd31d,b1a3e0aca758b322,bdcbb976816fd256,2017-06-10,1,0,0,76,0,0,17,6,13,4,0,0,4,4,4,2,9,2,2.0,74.0
5727,ad772f626b5dd31d,bdcbb976816fd256,b1a3e0aca758b322,2017-06-10,0,0,0,76,0,0,4,0,4,0,0,0,0,0,1,1,3,0,0.0,74.0
5728,4507354cd97f10e5,b0bd0c5425668b8f,cd13728ae1151f46,2017-06-10,0,0,0,22,0,0,2,1,2,0,0,0,0,0,0,0,2,1,0.0,13.0
5729,4507354cd97f10e5,cd13728ae1151f46,b0bd0c5425668b8f,2017-06-10,1,0,0,22,0,0,18,15,6,12,0,0,12,11,0,0,6,4,9.0,13.0
5730,2dfa31667cee74c3,840d2c82ea68b9aa,c96d9178c9ed9e62,2017-06-10,0,1,1,49,1,1,7,3,7,0,0,0,0,0,0,0,7,3,0.0,18.0
5731,2dfa31667cee74c3,c96d9178c9ed9e62,840d2c82ea68b9aa,2017-06-10,0,0,0,49,2,0,4,0,4,0,0,0,0,0,2,1,2,0,0.0,49.0
5732,288b479c485c48b2,4c288a2b250bb576,68c11c27d4d56572,2017-06-10,0,0,0,900,0,0,83,27,83,0,0,0,0,0,17,13,66,27,0.0,671.2
5733,288b479c485c48b2,68c11c27d4d56572,4c288a2b250bb576,2017-06-10,0,0,0,900,11,1,83,25,73,10,1,1,9,8,26,18,47,17,130.8,560.0
5734,1b1d1900b4051344,47cd337b86b1af92,71df36d6d8cf0d74,2017-06-10,0,0,0,900,3,2,76,20,73,3,0,0,3,3,23,17,50,17,71.0,478.0
5735,1b1d1900b4051344,71df36d6d8cf0d74,47cd337b86b1af92,2017-06-10,0,0,0,900,5,2,47,11,41,6,1,1,5,4,18,13,23,7,280.0,409.0
5736,165d3a571fcc5e3c,c77a953488e5607d,d024ed963e8bf7ea,2017-06-10,1,0,0,217,0,0,38,13,33,5,0,0,5,3,9,6,24,10,1.4,215.0
5737,165d3a571fcc5e3c,d024ed963e8bf7ea,c77a953488e5607d,2017-06-10,0,0,0,217,0,0,56,16,56,0,0,0,0,0,5,5,51,16,0.0,215.6
5738,11cb7d7d774d5e6a,92437c6775b3f7d1,e9bc5748e6a76bb6,2017-06-10,0,4,0,900,2,2,87,46,43,44,0,0,44,36,14,10,29,10,387.7,304.0
5739,11cb7d7d774d5e6a,e9bc5748e6a76bb6,92437c6775b3f7d1,2017-06-10,0,0,0,900,3,1,23,2,21,2,0,0,2,2,12,10,9,0,129.0,383.3
5740,cb2844bb15d22cc6,2f95a3c6d58b2aad,7be14eaed4c74856,2017-06-03,0,0,0,108,1,1,28,8,28,0,0,0,0,0,7,4,21,8,0.0,101.0
5741,cb2844bb15d22cc6,7be14eaed4c74856,2f95a3c6d58b2aad,2017-06-03,0,1,1,108,0,0,15,1,15,0,0,0,0,0,7,3,8,1,0.0,108.0
5742,9ed0c3acc436eb56,150ff4cc642270b9,d0f3959b4a9747e6,2017-06-03,1,0,0,853,0,0,207,87,152,55,1,1,54,40,21,16,131,47,117.6,729.0
5743,9ed0c3acc436eb56,d0f3959b4a9747e6,150ff4cc642270b9,2017-06-03,0,0,0,853,0,0,113,41,113,0,0,0,0,0,20,14,93,41,0.0,735.4
5744,88e0de323a83f241,0c670b443c3d269f,9ccf8371fd80d45d,2017-06-03,0,0,0,588,2,0,160,24,160,0,0,0,0,0,14,8,146,24,0.0,573.9
5745,88e0de323a83f241,9ccf8371fd80d45d,0c670b443c3d269f,2017-06-03,1,1,1,588,2,0,157,72,154,3,0,0,3,3,29,23,125,69,7.1,569.0
5746,823e9449bd47e408,0ee783aa00e468f0,a8e6a69796280f17,2017-06-03,0,0,0,900,0,0,78,30,77,1,0,0,1,1,9,7,68,29,0.0,900.0
5747,823e9449bd47e408,a8e6a69796280f17,0ee783aa00e468f0,2017-06-03,0,0,0,900,2,1,113,21,113,0,0,0,0,0,39,36,74,21,0.0,837.0
5748,6c9fdcb95393a49c,5866fc86183a9fb8,813550bc53b15fb0,2017-06-03,0,0,0,421,1,0,56,12,56,0,0,0,0,0,23,17,33,12,0.0,413.7
5749,6c9fdcb95393a49c,813550bc53b15fb0,5866fc86183a9fb8,2017-06-03,1,0,0,421,0,0,94,26,86,8,0,0,8,5,12,7,74,21,7.3,410.0
5750,6b581bb1bc9289ef,04b39f4e8eb59d7c,2e5c2aa8e4ab9d82,2017-06-03,0,0,0,366,5,2,62,12,62,0,0,0,0,0,28,21,34,12,0.0,277.0
5751,6b581bb1bc9289ef,2e5c2aa8e4ab9d82,04b39f4e8eb59d7c,2017-06-03,1,0,0,366,1,0,80,24,59,21,0,0,21,13,23,19,36,11,7.0,351.0
5752,6486579eee778b4d,aa72b0f831d0bfe5,ec71a892fada28c7,2017-06-03,1,4,0,600,3,2,26,10,13,13,1,1,12,7,8,6,5,3,267.4,198.0
5753,6486579eee778b4d,ec71a892fada28c7,aa72b0f831d0bfe5,2017-06-03,0,0,0,600,0,0,40,11,24,16,2,1,14,6,5,4,19,5,114.0,218.60000000000002
5754,5bfaa389a67139fd,d7c3816669784109,ec34349e7dffcde7,2017-06-03,0,0,0,183,0,0,37,6,37,0,0,0,0,0,4,3,33,6,0.0,183.0
5755,5bfaa389a67139fd,ec34349e7dffcde7,d7c3816669784109,2017-06-03,0,1,1,183,2,1,28,6,28,0,0,0,0,0,4,2,24,6,0.0,137.0
5756,3ad3acca165a5d90,52e76bb4b3e852f3,b9664eae2ac75262,2017-06-03,0,2,1,529,1,1,23,9,8,15,3,2,12,9,1,1,7,0,270.0,206.0
5757,3ad3acca165a5d90,b9664eae2ac75262,52e76bb4b3e852f3,2017-06-03,0,0,0,529,2,1,26,17,6,20,0,0,20,16,0,0,6,1,35.0,224.0
5758,36f0c6d7126e09ee,2fc7e9701642ca38,528c24b99fbaab79,2017-06-03,1,0,0,177,1,1,57,43,12,45,0,0,45,39,0,0,12,4,76.0,101.0
5759,36f0c6d7126e09ee,528c24b99fbaab79,2fc7e9701642ca38,2017-06-03,0,1,0,177,0,0,30,11,30,0,0,0,0,0,7,5,23,11,0.0,101.0
5760,2fd43be584ef522b,882d62561063a927,d50382dc0565a9e1,2017-06-03,0,0,0,900,1,0,156,36,152,4,1,1,3,2,52,43,100,34,1.8,840.8
5761,2fd43be584ef522b,d50382dc0565a9e1,882d62561063a927,2017-06-03,0,0,0,900,0,0,208,66,200,8,0,0,8,3,25,14,175,63,50.2,785.2
5762,228879162d8be605,2f13e4020cea5b38,fea79f9bc8c68769,2017-06-03,0,0,0,900,1,0,134,21,134,0,0,0,0,0,39,22,95,21,0.0,900.0
5763,228879162d8be605,fea79f9bc8c68769,2f13e4020cea5b38,2017-06-03,0,0,0,900,2,0,150,15,150,0,0,0,0,0,37,29,113,15,0.0,900.0
5764,b166f1582946fbbc,38c626ca912c7bac,bf43fed8f29e1671,2017-05-28,1,0,0,607,1,0,30,12,29,1,0,0,1,1,2,2,27,11,11.0,291.7
5765,b166f1582946fbbc,bf43fed8f29e1671,38c626ca912c7bac,2017-05-28,0,1,0,607,4,4,66,30,50,16,0,0,16,12,1,1,49,18,293.3,156.0
5766,ac6cb989ccc38f73,6c2030e0a143a94b,f797f0c57a83353e,2017-05-28,0,1,0,900,0,0,18,6,16,2,0,0,2,1,5,4,11,5,0.0,256.79999999999995
5767,ac6cb989ccc38f73,f797f0c57a83353e,6c2030e0a143a94b,2017-05-28,1,0,0,900,7,4,60,22,20,40,12,12,28,16,9,5,11,6,643.2,96.0
5768,9c3f3bc7f7472e0c,8b5f9ea38184ded3,fcce75a25c14a804,2017-05-28,0,0,0,877,5,1,173,41,169,4,1,1,3,2,8,7,161,39,108.0,682.2
5769,9c3f3bc7f7472e0c,fcce75a25c14a804,8b5f9ea38184ded3,2017-05-28,1,0,0,877,4,1,123,37,122,1,0,0,1,1,19,16,103,36,5.8,740.0
5770,9674c37e3a2bc399,42a7e90605df3c8a,6bd02119599741a4,2017-05-28,0,0,0,900,6,2,151,35,151,0,0,0,0,0,21,9,130,35,0.0,866.0
5771,9674c37e3a2bc399,6bd02119599741a4,42a7e90605df3c8a,2017-05-28,0,1,0,900,10,3,151,39,148,3,1,1,2,1,43,25,105,38,21.0,753.0
5772,923d5041c3b6d763,3c6976f8182d9527,7ff97850e8c32bda,2017-05-28,2,0,0,1267,3,1,228,77,212,16,1,1,15,12,30,19,182,65,90.1,1098.0
5773,923d5041c3b6d763,7ff97850e8c32bda,3c6976f8182d9527,2017-05-28,0,0,0,1267,5,1,134,34,134,0,0,0,0,0,11,8,123,34,0.0,1142.9
5774,8cdc9c13d75adb28,1fcfc3709fe58151,484acc7b0f856ce9,2017-05-28,3,0,0,449,0,0,97,40,81,16,0,0,16,9,7,6,74,31,56.0,386.0
5775,8cdc9c13d75adb28,484acc7b0f856ce9,1fcfc3709fe58151,2017-05-28,0,0,0,449,0,0,68,9,63,5,1,1,4,4,23,9,40,5,0.0,393.0
5776,79be3a6d483ad64a,0845c81e37d3bcb3,67f272324a030d00,2017-05-28,1,0,0,28,0,0,7,5,5,2,0,0,2,2,0,0,5,3,2.0,26.0
5777,79be3a6d483ad64a,67f272324a030d00,0845c81e37d3bcb3,2017-05-28,0,0,0,28,0,0,19,7,19,0,0,0,0,0,3,2,16,7,0.0,26.0
5778,78e38f1ad43c3479,16690d100f995f8f,eae431e70064e046,2017-05-28,0,0,0,900,9,6,153,42,131,22,3,2,19,10,10,8,121,32,277.0,560.0
5779,78e38f1ad43c3479,eae431e70064e046,16690d100f995f8f,2017-05-28,0,0,0,900,0,0,99,37,99,0,0,0,0,0,11,6,88,37,0.0,622.0
5780,33913e8e56c49a4c,330bafba312face4,49858bf46dabf6fb,2017-05-28,0,0,0,900,5,1,101,15,101,0,0,0,0,0,33,19,68,15,0.0,684.6
5781,33913e8e56c49a4c,49858bf46dabf6fb,330bafba312face4,2017-05-28,0,0,0,900,2,2,88,38,75,13,2,1,11,11,23,18,52,27,168.4,628.0
5782,2c101a0bcf334d31,ae7fe94f117f98cf,e25bcbcdaf6537a1,2017-05-28,0,1,0,900,0,0,142,30,123,19,0,0,19,8,15,10,108,22,76.6,694.5
5783,2c101a0bcf334d31,e25bcbcdaf6537a1,ae7fe94f117f98cf,2017-05-28,0,0,0,900,13,5,62,18,58,4,1,1,3,1,8,7,50,17,84.5,485.4
5784,2105210529457ffd,0a1942069c9ad6b6,2b6d855c6e280fb1,2017-05-28,1,0,0,120,1,1,29,23,2,27,0,0,27,22,0,0,2,1,98.0,22.0
5785,2105210529457ffd,2b6d855c6e280fb1,0a1942069c9ad6b6,2017-05-28,0,1,0,120,0,0,4,0,4,0,0,0,0,0,2,1,2,0,0.0,22.0
5786,1ed9dbbe604654b9,6eaec40f724852f4,9ce6d5a03af801b7,2017-05-28,0,1,0,900,5,0,112,21,107,5,0,0,5,4,7,7,100,17,11.5,690.6
5787,1ed9dbbe604654b9,9ce6d5a03af801b7,6eaec40f724852f4,2017-05-28,1,0,0,900,3,2,69,27,56,13,0,0,13,11,4,4,52,16,163.4,712.5
5788,f26657d5018ee428,01b352b6a9074d5c,d1528ac5675558b1,2017-05-13,1,0,0,516,0,0,231,67,205,26,0,0,26,18,43,36,162,49,36.8,458.0
5789,f26657d5018ee428,d1528ac5675558b1,01b352b6a9074d5c,2017-05-13,0,0,0,516,0,0,83,32,83,0,0,0,0,0,4,4,79,32,0.0,479.2
5790,af2ef75664656957,5f179af5fffeb9f6,8f382b3baa954d2a,2017-05-13,0,0,0,900,0,0,294,70,245,49,23,19,26,13,19,14,226,57,46.7,562.8
5791,af2ef75664656957,8f382b3baa954d2a,5f179af5fffeb9f6,2017-05-13,0,0,0,900,5,4,106,27,71,35,9,6,26,17,27,24,44,10,256.2,465.3
5792,9882c1dac77c0367,4bd6b4800070b069,bb1a2cdad6ff34db,2017-05-13,0,0,0,639,6,1,63,23,62,1,0,0,1,0,9,6,53,23,115.5,325.7
5793,9882c1dac77c0367,bb1a2cdad6ff34db,4bd6b4800070b069,2017-05-13,1,3,0,639,2,2,109,46,80,29,3,2,26,21,16,11,64,25,82.3,418.5
5794,7188621a628e718d,436f970c9ea9169c,be0b310a12eb80b4,2017-05-13,0,0,0,900,0,0,151,33,150,1,0,0,1,1,26,18,124,32,0.0,755.9
5795,7188621a628e718d,be0b310a12eb80b4,436f970c9ea9169c,2017-05-13,0,1,0,900,15,9,148,33,141,7,2,1,5,2,17,12,124,31,144.1,550.0
5796,6fe9729cee57c680,029eaff01e6bb8f0,33a331684283900f,2017-05-13,0,2,0,542,0,0,144,61,144,0,0,0,0,0,16,12,128,61,0.0,526.8
5797,6fe9729cee57c680,33a331684283900f,029eaff01e6bb8f0,2017-05-13,0,0,0,542,4,1,127,32,124,3,0,0,3,3,16,12,108,29,15.2,466.0
5798,6e3139f066149a81,427b5953ac8e3a27,47b9e0e7703a4868,2017-05-13,0,0,0,900,12,4,38,22,19,19,1,1,18,14,0,0,19,8,375.1,323.4
5799,6e3139f066149a81,47b9e0e7703a4868,427b5953ac8e3a27,2017-05-13,0,0,0,900,0,0,63,27,35,28,5,4,23,14,10,8,25,13,43.6,471.9
5800,567cefcaba821205,6256b2b1562cb8e1,edd02825c29028fe,2017-05-13,1,0,0,159,0,0,52,14,44,8,0,0,8,6,8,6,36,8,3.6,155.0
5801,567cefcaba821205,edd02825c29028fe,6256b2b1562cb8e1,2017-05-13,0,0,0,159,0,0,42,3,42,0,0,0,0,0,19,13,23,3,0.0,155.4
5802,39f746cee66e8771,cbf5e6f231b55443,f2688492b9a525a3,2017-05-13,0,1,0,600,0,0,42,14,22,20,0,0,20,11,3,2,19,3,0.0,94.0
5803,39f746cee66e8771,f2688492b9a525a3,cbf5e6f231b55443,2017-05-13,1,0,0,600,3,1,103,67,16,87,5,5,82,64,0,0,16,3,506.0,94.0
5804,362a5b3cd4a70330,4e06913c91da5200,d2c55d1d2e67773b,2017-05-13,0,0,0,900,2,1,85,17,84,1,0,0,1,0,16,11,68,17,2.7,755.6
5805,362a5b3cd4a70330,d2c55d1d2e67773b,4e06913c91da5200,2017-05-13,0,0,0,900,7,2,122,16,115,7,3,2,4,3,29,21,86,13,87.4,585.3
5806,16a0352f3e19b931,63def5a5662a6917,d28dee5c705991df,2017-05-13,0,0,0,142,0,0,18,4,18,0,0,0,0,0,9,8,9,4,0.0,138.2
5807,16a0352f3e19b931,d28dee5c705991df,63def5a5662a6917,2017-05-13,1,0,0,142,0,0,56,23,43,13,0,0,13,8,6,3,37,15,3.8,137.0
5808,14dbcdbe8e7251bf,2d447cc91bdaa545,af997f7611673880,2017-05-13,0,0,0,141,0,0,3,1,3,0,0,0,0,0,0,0,3,1,0.0,22.0
5809,14dbcdbe8e7251bf,af997f7611673880,2d447cc91bdaa545,2017-05-13,0,1,1,141,1,1,4,1,3,1,0,0,1,1,1,1,2,0,119.0,22.0
5810,0fd8214ac276728e,3d6749c4267da18f,6a1901c62ab3870f,2017-05-13,0,0,0,1500,0,0,352,101,352,0,0,0,0,0,141,124,211,101,0.0,1478.7
5811,0fd8214ac276728e,6a1901c62ab3870f,3d6749c4267da18f,2017-05-13,0,0,0,1500,10,2,218,51,217,1,0,0,1,1,55,32,162,50,5.3,1289.0
5812,f313eae425b7c539,4c2d90e335e6df19,9eef6584fab21fbb,2017-04-22,0,2,0,900,0,0,123,21,113,10,0,0,10,7,35,30,78,14,85.3,563.9
5813,f313eae425b7c539,9eef6584fab21fbb,4c2d90e335e6df19,2017-04-22,0,0,0,900,9,5,146,34,132,14,2,2,12,9,19,11,113,25,174.1,416.7
5814,cf18911df2052826,443f60bec7c3c3d5,df1eb4354d18a906,2017-04-22,0,2,0,900,6,3,172,50,157,15,1,0,14,7,44,33,113,43,36.5,481.2
5815,cf18911df2052826,df1eb4354d18a906,443f60bec7c3c3d5,2017-04-22,1,0,0,900,4,2,190,70,133,57,10,8,47,28,44,26,89,42,362.8,462.5
5816,c0c587cb52de929b,b76c6268dc1d3c05,c742287ed86a09bc,2017-04-22,0,0,0,900,0,0,176,43,176,0,0,0,0,0,35,29,141,43,0.0,900.0
5817,c0c587cb52de929b,c742287ed86a09bc,b76c6268dc1d3c05,2017-04-22,0,0,0,900,2,1,178,37,178,0,0,0,0,0,42,32,136,37,0.0,871.0
5818,b29ed164b3014a42,02f2a9702ba3d167,d247691a6c0e9034,2017-04-22,0,0,0,1500,8,2,276,79,275,1,0,0,1,1,71,44,204,78,6.8,1361.2
5819,b29ed164b3014a42,d247691a6c0e9034,02f2a9702ba3d167,2017-04-22,0,0,0,1500,3,2,296,114,286,10,0,0,10,9,106,95,180,105,29.8,1350.2
5820,8b97cd609c7152b7,99506df1af6c8b3b,fc9a9559a05f2704,2017-04-22,0,0,0,900,1,0,103,23,103,0,0,0,0,0,28,25,75,23,0.0,900.0
5821,8b97cd609c7152b7,fc9a9559a05f2704,99506df1af6c8b3b,2017-04-22,0,0,0,900,0,0,138,14,138,0,0,0,0,0,13,7,125,14,0.0,900.0
5822,7d4e11c2a9485320,a331233f597090a5,a36556bb1565e32d,2017-04-22,1,0,0,210,0,0,45,22,38,7,0,0,7,6,9,6,29,16,2.6,204.0
5823,7d4e11c2a9485320,a36556bb1565e32d,a331233f597090a5,2017-04-22,0,0,0,210,0,0,23,4,23,0,0,0,0,0,7,4,16,4,0.0,207.4
5824,6ccfbe3a7c5aa55e,449c890bd90f3374,67c1d46f4ed16f9e,2017-04-22,1,0,0,264,8,3,50,22,38,12,0,0,12,10,13,10,25,12,18.8,205.6
5825,6ccfbe3a7c5aa55e,67c1d46f4ed16f9e,449c890bd90f3374,2017-04-22,0,1,0,264,1,1,40,8,39,1,0,0,1,0,11,8,28,8,0.4,239.2
5826,53c96668bf850809,50db8711c70196cd,ab943cd2c3c17825,2017-04-22,0,1,1,431,2,1,41,15,30,11,1,1,10,7,8,5,22,8,99.0,323.0
5827,53c96668bf850809,ab943cd2c3c17825,50db8711c70196cd,2017-04-22,0,0,0,431,0,0,45,3,45,0,0,0,0,0,33,14,12,3,0.0,332.0
5828,41385f4e63682b5b,31a13532e724ca2b,3bad7ef643840f67,2017-04-22,0,1,0,900,0,0,196,94,169,27,2,2,25,22,15,13,154,72,16.9,433.5
5829,41385f4e63682b5b,3bad7ef643840f67,31a13532e724ca2b,2017-04-22,0,1,0,900,7,5,76,42,47,29,1,1,28,24,3,3,44,18,431.5,392.1
5830,3905e5dc489811d6,d81ac739417d7f53,f2b6fdb20675b11c,2017-04-22,0,0,0,365,4,1,41,13,41,0,0,0,0,0,6,4,35,13,0.0,334.8
5831,3905e5dc489811d6,f2b6fdb20675b11c,d81ac739417d7f53,2017-04-22,2,0,0,365,0,0,55,10,54,1,0,0,1,0,23,16,31,10,2.2,356.0
5832,319f3fad278368e6,792be9a24df82ed6,f53c1f4ceeed8c08,2017-04-22,1,2,1,546,0,0,73,14,60,13,2,1,11,6,11,9,49,8,69.8,386.6
5833,319f3fad278368e6,f53c1f4ceeed8c08,792be9a24df82ed6,2017-04-22,0,0,0,546,10,4,60,3,58,2,2,2,0,0,17,11,41,3,57.4,189.2
5834,2d6182d1d398ed6a,cfb65863d5099327,d156513a19acf856,2017-04-22,0,0,0,900,7,1,68,8,68,0,0,0,0,0,34,30,34,8,0.0,802.0
5835,2d6182d1d398ed6a,d156513a19acf856,cfb65863d5099327,2017-04-22,0,0,0,900,0,0,89,22,89,0,0,0,0,0,6,5,83,22,0.0,879.0
5836,2310fbcb6fdf3b47,59279a7c978f7da0,82e7929bf6c2b689,2017-04-22,2,0,0,98,0,0,19,9,17,2,0,0,2,2,4,3,13,7,2.5,93.0
5837,2310fbcb6fdf3b47,82e7929bf6c2b689,59279a7c978f7da0,2017-04-22,0,0,0,98,0,0,15,2,15,0,0,0,0,0,2,2,13,2,0.0,95.5
5838,f63961f9d14bc33d,5aedf14771ca82d2,8a304bfd6bf04a57,2017-04-15,0,0,0,889,6,0,168,2,168,0,0,0,0,0,29,14,139,2,0.0,793.5
5839,f63961f9d14bc33d,8a304bfd6bf04a57,5aedf14771ca82d2,2017-04-15,0,1,1,889,2,1,186,81,152,34,5,4,29,24,27,23,125,57,94.5,750.0
5840,f24c296256faeff2,7ea1f74cef32f906,887961364be5ceb3,2017-04-15,0,0,0,900,1,0,189,43,188,1,0,0,1,1,49,32,139,42,0.0,900.0
5841,f24c296256faeff2,887961364be5ceb3,7ea1f74cef32f906,2017-04-15,0,0,0,900,6,0,143,14,143,0,0,0,0,0,72,61,71,14,0.0,752.0
5842,e52318719d839d2d,47b63240018d5d86,eb04b9d31e938edb,2017-04-15,1,1,1,467,1,1,72,42,33,39,0,0,39,33,9,5,24,9,242.0,177.3
5843,e52318719d839d2d,eb04b9d31e938edb,47b63240018d5d86,2017-04-15,0,0,0,467,1,1,33,5,32,1,0,0,1,1,19,17,13,4,16.7,175.0
5844,d764ef3e078c96c8,18968f97ad34f15c,b6452706b373eea1,2017-04-15,0,0,0,900,1,0,207,28,207,0,0,0,0,0,39,28,168,28,0.0,832.0
5845,d764ef3e078c96c8,b6452706b373eea1,18968f97ad34f15c,2017-04-15,0,0,0,900,5,2,116,39,113,3,2,2,1,1,36,29,77,38,68.0,764.0
5846,b0552b065ca7f401,279566840aa55bf2,3f7c14c7eca7195d,2017-04-15,0,0,0,900,0,0,182,77,182,0,0,0,0,0,50,45,132,77,0.0,816.6
5847,b0552b065ca7f401,3f7c14c7eca7195d,279566840aa55bf2,2017-04-15,0,0,0,900,8,1,67,18,65,2,0,0,2,1,15,14,50,17,60.4,628.0
5848,94ce682e4a3e556a,b9706f80d005036c,fc6e681bf6658faf,2017-04-15,0,0,0,900,5,1,235,56,234,1,0,0,1,1,17,15,217,55,13.7,654.0
5849,94ce682e4a3e556a,fc6e681bf6658faf,b9706f80d005036c,2017-04-15,0,0,0,900,5,0,189,20,189,0,0,0,0,0,57,48,132,20,0.0,881.3
5850,677e98ae5834ba70,3d5b1ce6097dbb49,cb696ebfb6598724,2017-04-15,1,0,0,900,3,0,91,16,88,3,0,0,3,2,18,14,70,14,82.7,445.9
5851,677e98ae5834ba70,cb696ebfb6598724,3d5b1ce6097dbb49,2017-04-15,0,0,0,900,6,2,161,28,129,32,21,16,11,4,50,39,79,24,261.1,458.3
5852,4291b38643547fa7,92fa1401b7927da3,cc7040fe76f0ef91,2017-04-15,0,1,0,900,2,0,72,17,71,1,0,0,1,1,24,19,47,16,4.6,429.8
5853,4291b38643547fa7,cc7040fe76f0ef91,92fa1401b7927da3,2017-04-15,0,0,0,900,7,4,105,42,65,40,11,11,29,26,18,15,47,16,338.2,430.4
5854,41cef92a01e7ff3c,c96d9178c9ed9e62,d2bc285ead803db0,2017-04-15,0,1,0,900,14,12,91,34,73,18,7,7,11,8,20,16,53,26,241.5,306.4
5855,41cef92a01e7ff3c,d2bc285ead803db0,c96d9178c9ed9e62,2017-04-15,0,2,0,900,4,1,97,35,81,16,0,0,16,11,8,6,73,24,110.6,499.5
5856,2a0d4dd0997bd712,15ec018d144710db,4ba8d454f762005d,2017-04-15,0,0,0,261,1,1,41,13,41,0,0,0,0,0,12,10,29,13,0.0,250.5
5857,2a0d4dd0997bd712,4ba8d454f762005d,15ec018d144710db,2017-04-15,0,2,1,261,0,0,72,20,70,2,0,0,2,2,6,5,64,18,5.5,250.0
5858,20be16a1db95156c,39330403ad27c2bb,e979c76341f19b22,2017-04-15,0,0,0,328,4,2,73,20,72,1,0,0,1,1,20,17,52,19,1.5,288.2
5859,20be16a1db95156c,e979c76341f19b22,39330403ad27c2bb,2017-04-15,2,0,0,328,0,0,49,16,46,3,0,0,3,1,21,20,25,15,1.8,312.5
5860,0673d8ab0add7a05,d4c9dcd330403612,fccf811c1e8b01c7,2017-04-15,1,0,0,832,1,0,100,33,94,6,0,0,6,6,16,16,78,27,26.8,538.2
5861,0673d8ab0add7a05,fccf811c1e8b01c7,d4c9dcd330403612,2017-04-15,0,0,0,832,10,4,104,48,80,24,3,3,21,21,17,12,63,27,226.8,531.2
5862,0459297e86a14981,7a703c565ccaa18f,e1147d3d2dabe1ce,2017-04-15,0,0,0,508,3,1,36,6,36,0,0,0,0,0,5,3,31,6,0.0,438.0
5863,0459297e86a14981,e1147d3d2dabe1ce,7a703c565ccaa18f,2017-04-15,1,0,0,508,0,0,110,47,89,21,1,1,20,13,12,7,77,34,21.0,483.0
5864,ea8eaf881d38713e,365fee2da473b177,d967f0128c323de6,2017-04-08,0,0,0,517,3,1,36,6,36,0,0,0,0,0,18,16,18,6,0.0,260.6
5865,ea8eaf881d38713e,d967f0128c323de6,365fee2da473b177,2017-04-08,0,1,1,517,2,1,41,29,27,14,0,0,14,14,7,7,20,15,98.4,264.0
5866,e7ad1c3a763c7cae,99df7d0a2a08a8a8,e51e5cb722bd47a8,2017-04-08,1,0,0,900,2,1,99,43,92,7,0,0,7,5,11,10,81,38,22.9,524.5
5867,e7ad1c3a763c7cae,e51e5cb722bd47a8,99df7d0a2a08a8a8,2017-04-08,0,0,0,900,10,3,121,62,80,41,6,6,35,27,6,5,74,35,303.5,418.1
5868,ddb015ac5c067aa9,40093d1d2d78394e,98d961097baaf308,2017-04-08,0,0,0,719,7,1,261,46,261,0,0,0,0,0,71,40,190,46,0.0,673.6
5869,ddb015ac5c067aa9,98d961097baaf308,40093d1d2d78394e,2017-04-08,1,0,0,719,0,0,167,55,165,2,0,0,2,2,34,22,131,53,1.4,709.0
5870,c4da9ec26a924a7d,87f19d19f4cb73f8,ec664422b22d9787,2017-04-08,0,0,0,900,7,2,115,36,65,50,8,5,42,26,18,10,47,10,404.4,412.0
5871,c4da9ec26a924a7d,ec664422b22d9787,87f19d19f4cb73f8,2017-04-08,0,0,0,900,0,0,31,7,28,3,0,0,3,3,5,3,23,4,27.0,468.6
5872,b2c1f9bdd5d3073d,0d8011111be000b2,f1b2aa7853d1ed6e,2017-04-08,0,0,0,900,0,0,103,25,103,0,0,0,0,0,2,2,101,25,0.0,488.2
5873,b2c1f9bdd5d3073d,f1b2aa7853d1ed6e,0d8011111be000b2,2017-04-08,1,0,0,900,8,2,171,49,117,54,17,17,37,22,34,24,83,27,411.8,412.0
5874,a68672f66e12a3c2,31ee470ef5dc8d7f,9fa3bd637edd9aa2,2017-04-08,2,0,0,900,1,1,157,44,135,22,1,0,21,16,41,35,94,28,96.3,738.0
5875,a68672f66e12a3c2,9fa3bd637edd9aa2,31ee470ef5dc8d7f,2017-04-08,0,0,0,900,1,0,131,27,131,0,0,0,0,0,28,17,103,27,0.0,770.7
5876,97b7638c592a95a9,f046d724d2a84ac5,fba03cd6cc28dc41,2017-04-08,0,0,0,900,2,1,124,51,121,3,0,0,3,3,11,6,110,48,33.0,867.0
5877,97b7638c592a95a9,fba03cd6cc28dc41,f046d724d2a84ac5,2017-04-08,0,0,0,900,1,0,142,13,142,0,0,0,0,0,43,28,99,13,0.0,867.0
5878,8b4eeaa048361ba3,66ab58d0b3783607,84ff027394f7e470,2017-04-08,0,0,0,21,0,0,9,3,9,0,0,0,0,0,1,1,8,3,0.0,16.0
5879,8b4eeaa048361ba3,84ff027394f7e470,66ab58d0b3783607,2017-04-08,1,0,0,21,0,0,12,7,7,5,0,0,5,4,1,1,6,3,5.0,16.0
5880,87a969d51de6e179,232c582f29f8f65e,3a8176e15b9887c1,2017-04-08,1,0,0,493,1,0,93,34,91,2,0,0,2,2,17,15,74,32,3.5,254.0
5881,87a969d51de6e179,3a8176e15b9887c1,232c582f29f8f65e,2017-04-08,0,1,0,493,6,4,29,9,28,1,0,0,1,0,4,4,24,9,201.0,288.5
5882,687d973d71e068dc,1ebdcb7488d0ebee,98215d037be5bcb7,2017-04-08,0,1,0,825,3,2,112,28,111,1,0,0,1,1,11,9,100,27,25.7,587.0
5883,687d973d71e068dc,98215d037be5bcb7,1ebdcb7488d0ebee,2017-04-08,0,3,1,825,1,1,169,26,168,1,0,0,1,1,29,24,139,25,161.0,477.3
5884,56c7c59c9bb3b610,07225ba28ae309b6,b6e6c3b1dcaae0a1,2017-04-08,0,1,1,150,2,2,7,0,7,0,0,0,0,0,5,3,2,0,0.0,48.0
5885,56c7c59c9bb3b610,b6e6c3b1dcaae0a1,07225ba28ae309b6,2017-04-08,0,0,0,150,0,0,5,1,5,0,0,0,0,0,3,3,2,1,0.0,150.0
5886,2464a75ee75dbf2f,578ef12674df1e6a,e872e9a9a902c045,2017-04-08,0,0,0,900,0,0,223,47,223,0,0,0,0,0,54,37,169,47,0.0,900.0
5887,2464a75ee75dbf2f,e872e9a9a902c045,578ef12674df1e6a,2017-04-08,0,0,0,900,11,0,273,47,273,0,0,0,0,0,88,58,185,47,0.0,882.0
5888,23ba0218f9f65e33,08e908ed6d18d6a0,1971869b7e054261,2017-04-08,1,0,0,210,1,1,52,36,5,47,0,0,47,35,1,0,4,1,183.0,27.0
5889,23ba0218f9f65e33,1971869b7e054261,08e908ed6d18d6a0,2017-04-08,0,0,0,210,0,0,3,0,3,0,0,0,0,0,0,0,3,0,0.0,27.0
5890,f99ee57f75b20b69,470fedbc8563ac47,cc900af167fbedfd,2017-03-18,0,0,0,900,2,0,93,25,93,0,0,0,0,0,32,29,61,25,0.0,778.0
5891,f99ee57f75b20b69,cc900af167fbedfd,470fedbc8563ac47,2017-03-18,0,0,0,900,5,1,104,29,97,7,1,1,6,4,30,22,67,25,87.0,378.0
5892,eee7f546c126ee8b,32c355b04fc57f3a,8f4eeaf7a0df7c1a,2017-03-18,1,0,0,30,0,0,7,2,7,0,0,0,0,0,4,4,3,2,0.0,29.0
5893,eee7f546c126ee8b,8f4eeaf7a0df7c1a,32c355b04fc57f3a,2017-03-18,0,0,0,30,0,0,1,0,1,0,0,0,0,0,1,1,0,0,0.0,30.0
5894,c365a488a8de3c89,a17ad5a5048e8c3f,b69f24c500d783e7,2017-03-18,0,0,0,900,5,1,73,13,70,3,0,0,3,1,26,18,44,12,31.0,639.3
5895,c365a488a8de3c89,b69f24c500d783e7,a17ad5a5048e8c3f,2017-03-18,0,0,0,900,12,7,62,14,59,3,0,0,3,1,17,14,42,13,22.7,710.0
5896,88ce808e4e604180,6d4b63c767106d3a,f1fac969a1d70b08,2017-03-18,0,0,0,900,7,2,44,13,43,1,1,1,0,0,13,10,30,13,107.7,499.0
5897,88ce808e4e604180,f1fac969a1d70b08,6d4b63c767106d3a,2017-03-18,0,0,0,900,12,3,102,38,98,4,1,0,3,1,20,15,78,37,78.0,480.3
5898,7ec86f2af631344f,040a74bb0a465c54,87a1dc546b1c5caf,2017-03-18,0,1,0,900,6,3,74,27,55,19,2,2,17,12,8,3,47,15,243.3,296.6
5899,7ec86f2af631344f,87a1dc546b1c5caf,040a74bb0a465c54,2017-03-18,0,3,0,900,12,4,46,15,42,4,0,0,4,4,5,2,37,11,270.4,318.7
5900,7e6f91cbf8e93210,cf65d56b0755ed3b,fd55393021a8c255,2017-03-18,0,0,0,346,0,0,33,6,33,0,0,0,0,0,16,11,17,6,0.0,200.4
5901,7e6f91cbf8e93210,fd55393021a8c255,cf65d56b0755ed3b,2017-03-18,0,1,1,346,2,1,18,7,14,4,0,0,4,4,2,1,12,3,145.6,164.0
5902,794b63b4c1e1e789,06827d70c53ff0d9,34e552520a934063,2017-03-18,0,0,0,900,3,1,195,54,195,0,0,0,0,0,46,32,149,54,0.0,857.9
5903,794b63b4c1e1e789,34e552520a934063,06827d70c53ff0d9,2017-03-18,1,0,0,900,0,0,175,42,173,2,0,0,2,2,49,30,124,40,17.1,823.0
5904,55f727e00553035d,654ae722109a0d31,e25bcbcdaf6537a1,2017-03-18,0,0,0,900,0,0,161,39,153,8,1,1,7,6,17,11,136,33,231.1,632.3
5905,55f727e00553035d,e25bcbcdaf6537a1,654ae722109a0d31,2017-03-18,0,0,0,900,12,2,63,20,62,1,0,0,1,1,13,8,49,19,7.7,614.9
5906,0bb419537705fb04,2eeaefbfc7f9fcff,3cf66c62d9069f43,2017-03-18,0,0,0,900,7,1,144,42,139,5,0,0,5,5,48,38,91,37,38.4,545.2
5907,0bb419537705fb04,3cf66c62d9069f43,2eeaefbfc7f9fcff,2017-03-18,0,0,0,900,2,0,204,77,203,1,0,0,1,1,27,22,176,76,1.8,795.6
5908,00be3852000f8fe9,1e1dbd1cc5a7469e,5e4eec08896c9423,2017-03-18,1,0,0,185,0,0,13,5,13,0,0,0,0,0,2,1,11,5,0.0,184.0
5909,00be3852000f8fe9,5e4eec08896c9423,1e1dbd1cc5a7469e,2017-03-18,0,0,0,185,3,0,27,4,27,0,0,0,0,0,3,2,24,4,0.0,185.0
5910,f4f5049e789b7716,0052de90691d4a93,1bcaac2d99b90fce,2017-03-11,0,0,0,900,1,0,122,21,122,0,0,0,0,0,25,14,97,21,0.0,900.0
5911,f4f5049e789b7716,1bcaac2d99b90fce,0052de90691d4a93,2017-03-11,0,0,0,900,0,0,93,24,93,0,0,0,0,0,22,15,71,24,0.0,900.0
5912,ebb94e00d6431e7a,68f6e96c5fa6e044,b71ce838b01f2cad,2017-03-11,0,0,0,900,9,8,74,44,39,35,1,1,34,30,2,1,37,14,356.3,270.0
5913,ebb94e00d6431e7a,b71ce838b01f2cad,68f6e96c5fa6e044,2017-03-11,1,0,0,900,1,0,36,14,26,10,1,1,9,6,5,3,21,8,233.0,310.7
5914,dc169cc01d675125,94527830000ab715,a4e85a58fbce64b2,2017-03-11,0,0,0,900,11,1,215,41,215,0,0,0,0,0,25,18,190,41,0.0,619.0
5915,dc169cc01d675125,a4e85a58fbce64b2,94527830000ab715,2017-03-11,0,2,0,900,1,1,113,49,97,16,0,0,16,15,7,5,90,34,224.0,620.0
5916,b47e4f0982938e5b,08af939f41b5a57b,64a50dad704d1d49,2017-03-11,0,0,0,515,2,0,121,31,121,0,0,0,0,0,27,20,94,31,0.0,512.0
5917,b47e4f0982938e5b,64a50dad704d1d49,08af939f41b5a57b,2017-03-11,1,0,0,515,0,0,82,13,81,1,0,0,1,1,21,17,60,12,3.0,512.0
5918,b03dd50785e761a0,673ea7dcc786b1b3,c7d297714d9ab1a4,2017-03-11,0,0,0,900,4,2,95,20,91,4,1,1,3,1,27,22,64,19,134.7,508.2
5919,b03dd50785e761a0,c7d297714d9ab1a4,673ea7dcc786b1b3,2017-03-11,0,0,0,900,0,0,132,58,98,34,0,0,34,32,21,17,77,26,189.8,525.3
5920,76602c3658d70273,a8283a4f415e1eb9,ee9ebceabfd16fa7,2017-03-11,0,1,0,492,1,0,59,19,53,6,0,0,6,5,7,6,46,14,22.5,357.3
5921,76602c3658d70273,ee9ebceabfd16fa7,a8283a4f415e1eb9,2017-03-11,0,1,1,492,8,1,43,9,39,4,0,0,4,0,7,6,32,9,89.7,312.5
5922,74d4e37b97866514,a4de54ea806fb525,b102c26727306ab6,2017-03-11,0,0,0,900,6,0,88,22,71,17,3,3,14,12,17,11,54,10,117.2,615.2
5923,74d4e37b97866514,b102c26727306ab6,a4de54ea806fb525,2017-03-11,0,0,0,900,3,0,62,14,61,1,0,0,1,0,18,16,43,14,22.8,577.8
5924,58450502a93454c8,0ee783aa00e468f0,8c0580d4fff106c1,2017-03-11,0,0,0,232,0,0,28,5,28,0,0,0,0,0,6,5,22,5,0.0,189.0
5925,58450502a93454c8,8c0580d4fff106c1,0ee783aa00e468f0,2017-03-11,2,0,0,232,0,0,49,25,31,18,0,0,18,13,1,1,30,12,43.0,189.0
5926,34524408fb4d6752,140745cbbcb023ac,fcd448a2fe1a23cc,2017-03-11,2,0,0,659,3,2,173,68,173,0,0,0,0,0,33,26,140,68,0.0,655.0
5927,34524408fb4d6752,fcd448a2fe1a23cc,140745cbbcb023ac,2017-03-11,0,0,0,659,1,0,151,48,151,0,0,0,0,0,8,7,143,48,0.0,650.0
5928,24f156a78bd32026,4b47e71384a9522f,57b10fca4f9c9a7a,2017-03-11,0,0,0,458,1,0,12,8,7,5,0,0,5,4,1,1,6,4,60.5,184.0
5929,24f156a78bd32026,57b10fca4f9c9a7a,4b47e71384a9522f,2017-03-11,0,1,1,458,11,6,24,6,15,9,2,1,7,3,5,5,10,3,153.0,108.5
5930,12740c6b17779fe9,6da99156486ed6c2,e51fcd9cd84c0b93,2017-03-11,0,0,0,102,1,0,1,0,1,0,0,0,0,0,1,1,0,0,0.0,80.7
5931,12740c6b17779fe9,e51fcd9cd84c0b93,6da99156486ed6c2,2017-03-11,0,1,1,102,3,2,34,24,26,8,0,0,8,8,0,0,26,16,21.3,30.0
5932,0ace7e71f5d66bc9,2e5c2aa8e4ab9d82,f215cfbd4ba3c270,2017-03-11,1,0,0,77,0,0,32,18,26,6,0,0,6,6,4,4,22,12,5.0,72.0
5933,0ace7e71f5d66bc9,f215cfbd4ba3c270,2e5c2aa8e4ab9d82,2017-03-11,0,0,0,77,1,0,14,2,14,0,0,0,0,0,4,4,10,2,0.0,72.0
5934,e3ca9462ad0d7685,bdcbb976816fd256,ee779c43a8926d52,2017-03-04,0,0,0,900,8,0,193,64,193,0,0,0,0,0,14,10,179,64,0.0,889.0
5935,e3ca9462ad0d7685,ee779c43a8926d52,bdcbb976816fd256,2017-03-04,0,0,0,900,4,1,138,43,138,0,0,0,0,0,12,10,126,43,0.0,893.0
5936,dfc8c5161ea0ccb5,4a28cb716c19157a,effd9de9937996f8,2017-03-04,0,0,0,1500,0,0,146,30,146,0,0,0,0,0,31,23,115,30,0.0,1406.5
5937,dfc8c5161ea0ccb5,effd9de9937996f8,4a28cb716c19157a,2017-03-04,1,0,0,1500,2,1,125,28,104,21,6,6,15,13,30,20,74,15,74.5,1383.0
5938,c79b862be039d9f0,b4ad3a06ee4d660c,eef9b891edbd4604,2017-03-04,1,0,0,704,1,0,70,11,70,0,0,0,0,0,50,44,20,11,0.0,491.0
5939,c79b862be039d9f0,eef9b891edbd4604,b4ad3a06ee4d660c,2017-03-04,0,0,0,704,0,0,51,12,51,0,0,0,0,0,12,9,39,12,0.0,704.0
5940,7ac4b9823b1e139b,2747c60e42d9d75f,f9b200db02b488d9,2017-03-04,0,0,0,900,7,2,192,46,192,0,0,0,0,0,61,44,131,46,0.0,850.0
5941,7ac4b9823b1e139b,f9b200db02b488d9,2747c60e42d9d75f,2017-03-04,0,0,0,900,1,1,141,36,141,0,0,0,0,0,52,40,89,36,0.0,893.0
5942,6db4d7827082d5b9,49e96ff8ab781589,eabf206b162b3b83,2017-03-04,1,0,0,250,0,0,35,18,24,11,0,0,11,11,7,5,17,7,66.4,93.0
5943,6db4d7827082d5b9,eabf206b162b3b83,49e96ff8ab781589,2017-03-04,0,0,0,250,3,0,24,2,24,0,0,0,0,0,11,10,13,2,0.0,177.6
5944,54f9e3e1fad7a589,98215d037be5bcb7,d4a31850a7457f1b,2017-03-04,0,3,1,199,1,1,26,3,26,0,0,0,0,0,11,10,15,3,0.0,92.0
5945,54f9e3e1fad7a589,d4a31850a7457f1b,98215d037be5bcb7,2017-03-04,0,0,0,199,1,0,28,6,27,1,0,0,1,0,1,1,26,6,0.0,199.0
5946,4804776154430aad,2f95a3c6d58b2aad,96428b9e9bd048ea,2017-03-04,0,1,1,493,2,1,75,12,72,3,0,0,3,3,16,11,56,9,4.5,284.0
5947,4804776154430aad,96428b9e9bd048ea,2f95a3c6d58b2aad,2017-03-04,0,0,0,493,2,1,134,90,53,81,0,0,81,75,7,4,46,15,203.0,270.5
5948,42ad1437a1280294,c9cf753cfdf77fc2,e5bda12faabfc850,2017-03-04,1,0,0,826,2,1,66,41,46,20,1,1,19,18,8,8,38,23,84.4,653.0
5949,42ad1437a1280294,e5bda12faabfc850,c9cf753cfdf77fc2,2017-03-04,0,1,0,826,11,3,25,7,25,0,0,0,0,0,8,7,17,7,0.0,238.6
5950,3b536afcc9098925,92a9aa9c93192871,cbd3e590a85b18c5,2017-03-04,1,1,0,799,1,0,59,14,47,12,8,8,4,4,6,6,41,10,42.8,260.0
5951,3b536afcc9098925,cbd3e590a85b18c5,92a9aa9c93192871,2017-03-04,0,0,0,799,10,4,98,55,56,42,1,1,41,35,6,4,50,20,457.0,212.2
5952,2d4743a82fc55642,544d7460b3e44393,d0e50a3d1b250708,2017-03-04,0,0,0,900,3,1,132,34,126,6,1,1,5,5,28,21,98,29,169.2,511.8
5953,2d4743a82fc55642,d0e50a3d1b250708,544d7460b3e44393,2017-03-04,0,0,0,900,1,0,116,25,106,10,3,3,7,7,32,18,74,18,106.2,592.8
5954,08b65f5009c34997,ad56b3f00ca38dfd,f86cb5f25d545e0e,2017-03-04,0,0,0,900,0,0,167,50,167,0,0,0,0,0,56,42,111,50,0.0,827.0
5955,08b65f5009c34997,f86cb5f25d545e0e,ad56b3f00ca38dfd,2017-03-04,0,0,0,900,2,1,136,33,136,0,0,0,0,0,23,18,113,33,0.0,836.0
5956,f00ac5af033f44b4,bf9bc96336922271,e5010b1b94ca5755,2017-02-19,0,0,0,284,0,0,59,12,59,0,0,0,0,0,18,9,41,12,0.0,281.6
5957,f00ac5af033f44b4,e5010b1b94ca5755,bf9bc96336922271,2017-02-19,1,0,0,284,0,0,71,14,67,4,0,0,4,0,14,9,53,14,2.4,281.0
5958,e59aabdfba9d6c45,045f25b3a4c08e81,dea070ed4a2a8281,2017-02-19,1,0,0,441,0,0,46,6,46,0,0,0,0,0,2,0,44,6,0.0,343.2
5959,e59aabdfba9d6c45,dea070ed4a2a8281,045f25b3a4c08e81,2017-02-19,1,0,0,441,2,1,71,14,56,15,2,1,13,7,19,12,37,7,93.8,341.0
5960,e4c4c54a10e06973,4a57ebb14315b251,d910665038efc639,2017-02-19,0,0,0,900,0,0,110,47,86,24,0,0,24,21,1,1,85,26,17.3,787.1
5961,e4c4c54a10e06973,d910665038efc639,4a57ebb14315b251,2017-02-19,0,1,0,900,10,4,132,30,124,8,0,0,8,6,5,2,119,24,94.9,716.7
5962,c1d86f1e6d41cd03,6ac9bc2953c47345,b59037262c8fe060,2017-02-19,0,1,1,94,0,0,6,2,6,0,0,0,0,0,1,1,5,2,0.0,16.0
5963,c1d86f1e6d41cd03,b59037262c8fe060,6ac9bc2953c47345,2017-02-19,0,0,0,94,1,1,8,3,7,1,0,0,1,0,0,0,7,3,78.0,16.0
5964,ad9ecef413a5b48f,24656ef4d605c96f,f9081770e28ea2e1,2017-02-19,1,0,0,900,0,0,112,39,107,5,0,0,5,3,9,5,98,36,10.0,847.1
5965,ad9ecef413a5b48f,f9081770e28ea2e1,24656ef4d605c96f,2017-02-19,0,0,0,900,13,2,190,27,188,2,1,1,1,1,51,36,137,26,40.9,747.0
5966,ab14dbff9d2ae41a,3236bf606fe9fa5b,d3df1add9d9a7efb,2017-02-19,0,0,0,492,1,0,47,0,46,1,0,0,1,0,33,21,13,0,2.0,392.8
5967,ab14dbff9d2ae41a,d3df1add9d9a7efb,3236bf606fe9fa5b,2017-02-19,1,0,0,492,0,0,71,37,51,20,0,0,20,17,4,2,47,20,95.2,390.0
5968,a5d24caed8afbeef,0941df56f6ac954b,db1f2ed63b54b9a7,2017-02-19,0,0,0,900,0,0,136,32,136,0,0,0,0,0,25,19,111,32,0.0,900.0
5969,a5d24caed8afbeef,db1f2ed63b54b9a7,0941df56f6ac954b,2017-02-19,0,0,0,900,9,2,103,22,103,0,0,0,0,0,23,15,80,22,0.0,778.0
5970,9c256e94c6b584b6,016a8d958883167c,7be74a12d7352df2,2017-02-19,0,0,0,74,0,0,2,0,2,0,0,0,0,0,0,0,2,0,0.0,12.0
5971,9c256e94c6b584b6,7be74a12d7352df2,016a8d958883167c,2017-02-19,0,1,1,74,2,2,14,6,5,9,0,0,9,4,1,1,4,2,62.0,12.0
5972,1db121859d2fcda8,49858bf46dabf6fb,6d1bffff14897645,2017-02-19,0,0,0,900,0,0,121,15,121,0,0,0,0,0,54,33,67,15,0.0,782.0
5973,1db121859d2fcda8,6d1bffff14897645,49858bf46dabf6fb,2017-02-19,1,0,0,900,0,0,171,42,160,11,2,2,9,3,13,9,147,39,118.0,782.0
5974,16e28dd989ee1dea,34f88592c0ab7a54,dbc17725b887860a,2017-02-19,0,0,0,900,4,1,116,18,107,9,0,0,9,7,36,20,71,11,121.5,738.0
5975,16e28dd989ee1dea,dbc17725b887860a,34f88592c0ab7a54,2017-02-19,0,2,0,900,6,3,38,4,38,0,0,0,0,0,12,7,26,4,0.0,673.5
5976,112e6a0ddce893e6,b8aef0faf4ce9b31,da816417a579a0bd,2017-02-19,0,0,0,900,0,0,87,9,87,0,0,0,0,0,7,1,80,9,0.0,874.0
5977,112e6a0ddce893e6,da816417a579a0bd,b8aef0faf4ce9b31,2017-02-19,0,0,0,900,1,1,163,25,163,0,0,0,0,0,43,30,120,25,0.0,885.0
5978,febea68b205f6273,5aedf14771ca82d2,7c3c48cf54a2848e,2017-02-11,0,2,0,900,9,6,84,19,75,9,2,2,7,5,17,13,58,14,430.4,317.3
5979,febea68b205f6273,7c3c48cf54a2848e,5aedf14771ca82d2,2017-02-11,0,0,0,900,1,0,105,25,95,10,0,0,10,7,16,9,79,18,56.7,401.6
5980,f680e6ebe3bdfe3e,b1b0729d27936f2f,c6aee362c7a7d482,2017-02-11,0,0,0,900,5,2,152,23,130,22,0,0,22,11,54,48,76,12,353.0,524.7
5981,f680e6ebe3bdfe3e,c6aee362c7a7d482,b1b0729d27936f2f,2017-02-11,0,0,0,900,0,0,145,36,139,6,0,0,6,3,32,16,107,33,22.3,521.0
5982,ddd9e64d97b095f9,275aca31f61ba28c,6fb1ba67bef41b37,2017-02-11,0,0,0,900,5,5,58,37,26,32,1,1,31,29,5,5,21,8,692.4,179.1
5983,ddd9e64d97b095f9,6fb1ba67bef41b37,275aca31f61ba28c,2017-02-11,0,1,0,900,2,0,35,3,33,2,0,0,2,2,16,10,17,1,6.9,176.60000000000002
5984,d29750cee389a0b9,1f454354805b6f75,b1a3e0aca758b322,2017-02-11,0,0,0,900,0,0,78,28,73,5,0,0,5,5,22,15,51,23,0.0,879.3
5985,d29750cee389a0b9,b1a3e0aca758b322,1f454354805b6f75,2017-02-11,0,0,0,900,10,2,101,36,98,3,0,0,3,2,21,18,77,34,20.7,672.0
5986,ced241b99eab5f22,7a703c565ccaa18f,c80095f6092271a7,2017-02-11,0,1,1,221,2,1,18,5,17,1,0,0,1,1,5,2,12,4,18.5,147.0
5987,ced241b99eab5f22,c80095f6092271a7,7a703c565ccaa18f,2017-02-11,0,0,0,221,0,0,10,2,10,0,0,0,0,0,4,4,6,2,0.0,202.5
5988,c4174e22cb22622c,64360e618823a8e4,814ff3018127e8fc,2017-02-11,0,0,0,900,2,0,102,41,102,0,0,0,0,0,15,9,87,41,0.0,900.0
5989,c4174e22cb22622c,814ff3018127e8fc,64360e618823a8e4,2017-02-11,0,0,0,900,11,0,115,19,115,0,0,0,0,0,45,33,70,19,0.0,628.0
5990,8b8f9485214f9e48,029eaff01e6bb8f0,d1941565abf50b16,2017-02-11,0,0,0,900,3,3,216,79,206,10,1,1,9,3,29,17,177,76,76.5,653.4
5991,8b8f9485214f9e48,d1941565abf50b16,029eaff01e6bb8f0,2017-02-11,0,3,0,900,6,1,135,36,133,2,0,0,2,2,37,35,96,34,9.6,741.5
5992,252074c8554bf30d,1d239d571e342453,634e2fb70bde3fd5,2017-02-11,0,0,0,1500,1,0,150,28,149,1,0,0,1,0,62,52,87,28,1.0,1462.0
5993,252074c8554bf30d,634e2fb70bde3fd5,1d239d571e342453,2017-02-11,0,0,0,1500,9,0,182,18,182,0,0,0,0,0,83,59,99,18,0.0,1002.0
5994,244357514dd89bd6,13a0275fa13c4d26,7ff97850e8c32bda,2017-02-11,0,0,0,900,0,0,46,19,45,1,0,0,1,1,2,2,43,18,2.0,289.5
5995,244357514dd89bd6,7ff97850e8c32bda,13a0275fa13c4d26,2017-02-11,0,1,0,900,3,3,53,19,37,16,0,0,16,9,6,5,31,10,600.5,260.0
5996,1f9ac1648b8e501e,1c86754617d9813a,4c7781da8c6cae93,2017-02-11,0,0,0,900,4,0,50,12,43,7,1,1,6,5,8,6,35,7,79.1,585.5
5997,1f9ac1648b8e501e,4c7781da8c6cae93,1c86754617d9813a,2017-02-11,1,0,0,900,4,1,91,13,76,15,2,2,13,5,26,14,50,8,201.5,511.9
5998,f3bb58f485dc2008,749f572d1d3161fb,eeabcd4dc6619129,2017-02-04,1,0,0,52,0,0,3,1,1,2,0,0,0,0,0,0,0,0,0.7,51.0
5999,f3bb58f485dc2008,eeabcd4dc6619129,749f572d1d3161fb,2017-02-04,0,0,0,52,2,0,3,0,3,0,0,0,0,0,1,0,2,0,0.0,43.3
6000,ebe38ba75cbf2320,31ef8b67e13495b3,907e60fd13407e1e,2017-02-04,0,0,0,900,2,1,189,45,186,3,1,0,2,1,44,36,142,44,188.2,626.8
6001,ebe38ba75cbf2320,907e60fd13407e1e,31ef8b67e13495b3,2017-02-04,0,0,0,900,2,1,151,21,149,2,0,0,2,1,29,16,120,20,22.2,600.8
6002,94cecf4bd29793e1,6256b2b1562cb8e1,e14b5aa06eea9653,2017-02-04,0,3,1,649,2,1,67,13,66,1,0,0,1,1,16,12,50,12,35.2,508.0
6003,94cecf4bd29793e1,e14b5aa06eea9653,6256b2b1562cb8e1,2017-02-04,0,0,0,649,5,1,33,9,33,0,0,0,0,0,3,2,30,9,0.0,478.8
6004,8c220d4c96895a98,6f242453c91a5af0,c451d67c09c55418,2017-02-04,0,0,0,149,3,0,34,11,34,0,0,0,0,0,10,9,24,11,0.0,126.0
6005,8c220d4c96895a98,c451d67c09c55418,6f242453c91a5af0,2017-02-04,1,0,0,149,1,0,35,16,32,3,0,0,0,0,2,0,16,0,3.0,144.0
6006,74256b4e8d0b1de6,72ffecf712673af1,fa6796c55d6c5440,2017-02-04,0,0,0,359,0,0,1,1,1,0,0,0,0,0,0,0,1,1,0.0,64.89999999999998
6007,74256b4e8d0b1de6,fa6796c55d6c5440,72ffecf712673af1,2017-02-04,0,0,0,359,10,8,33,10,6,27,14,14,13,9,1,1,5,1,294.1,54.0
6008,66ad9f88f063d2ef,1ae8f3c723aacff4,64788ee44b062ded,2017-02-04,1,1,0,900,1,0,88,27,66,22,1,0,9,0,5,0,28,0,57.5,647.3
6009,66ad9f88f063d2ef,64788ee44b062ded,1ae8f3c723aacff4,2017-02-04,0,0,0,900,8,2,73,10,68,5,1,0,4,1,20,18,48,9,150.7,631.5
6010,4a2e7e2c8cfdaf5f,b6850671a008bf9a,e8b731feff72294b,2017-02-04,0,0,0,900,4,2,246,36,241,5,0,0,2,0,34,0,150,0,16.8,858.3
6011,4a2e7e2c8cfdaf5f,e8b731feff72294b,b6850671a008bf9a,2017-02-04,0,1,0,900,0,0,206,43,205,1,0,0,1,0,53,37,152,43,4.7,869.2
6012,49e344834626c144,c727c7d31c50c4cf,d761b3766e38c5db,2017-02-04,0,0,0,190,0,0,37,6,37,0,0,0,0,0,12,8,25,6,0.0,165.0
6013,49e344834626c144,d761b3766e38c5db,c727c7d31c50c4cf,2017-02-04,1,0,0,190,0,0,30,11,30,0,0,0,0,0,5,4,25,11,0.0,189.0
6014,48e51d4e7172048e,cdb96af67d096b1e,d8da10db80131bec,2017-02-04,1,0,0,600,0,0,131,31,122,9,1,0,5,0,4,0,76,0,5.5,592.0
6015,48e51d4e7172048e,d8da10db80131bec,cdb96af67d096b1e,2017-02-04,1,0,0,600,1,0,117,12,116,1,0,0,0,0,19,0,75,0,0.0,594.5
6016,478221ad98336565,4bd6b4800070b069,feaf00f3373435d6,2017-02-04,0,1,1,421,3,2,52,20,48,4,0,0,2,0,1,0,28,0,93.3,141.0
6017,478221ad98336565,feaf00f3373435d6,4bd6b4800070b069,2017-02-04,0,0,0,421,0,0,43,15,31,12,0,0,1,0,1,0,13,0,0.0,327.7
6018,451525a1abe30a91,6a1901c62ab3870f,f0feeb2192937424,2017-02-04,0,0,0,900,3,2,322,86,322,0,0,0,0,0,73,45,249,86,0.0,804.3
6019,451525a1abe30a91,f0feeb2192937424,6a1901c62ab3870f,2017-02-04,1,0,0,900,0,0,209,61,202,7,0,0,3,0,20,0,97,0,0.7,894.0
6020,36220644401d85e1,0845c81e37d3bcb3,50db8711c70196cd,2017-02-04,0,0,0,900,1,0,182,51,182,0,0,0,0,0,44,31,138,51,0.0,816.0
6021,36220644401d85e1,50db8711c70196cd,0845c81e37d3bcb3,2017-02-04,0,0,0,900,4,0,189,61,189,0,0,0,0,0,24,15,165,61,0.0,861.0
6022,c5865afc31cb6c59,7dfb56f24fe5ddea,e64b96c07d7ce999,2017-01-28,1,2,0,585,4,1,106,25,102,4,0,0,4,2,17,14,85,23,42.1,361.5
6023,c5865afc31cb6c59,e64b96c07d7ce999,7dfb56f24fe5ddea,2017-01-28,1,0,0,585,1,0,75,22,73,2,0,0,2,2,16,15,57,20,2.5,532.9
6024,b91756d955e14d2e,1d00756835ca67c9,47b9e0e7703a4868,2017-01-28,0,0,0,360,1,0,65,10,65,0,0,0,0,0,22,20,43,10,0.0,357.3
6025,b91756d955e14d2e,47b9e0e7703a4868,1d00756835ca67c9,2017-01-28,2,0,0,360,0,0,102,36,93,9,0,0,9,6,31,22,62,30,2.7,354.0
6026,ab79fe7b35ccc3dc,132deb59abae64b1,3253b16d38ae087d,2017-01-28,0,1,1,569,2,2,17,5,11,6,0,0,6,5,8,8,3,0,75.2,373.3
6027,ab79fe7b35ccc3dc,3253b16d38ae087d,132deb59abae64b1,2017-01-28,0,0,0,569,5,1,35,2,32,3,0,0,3,2,30,25,2,0,32.7,133.8
6028,a45596cda51a1816,3738e68d2261e60f,8d03ce87ca14e778,2017-01-28,0,0,0,92,0,0,9,1,9,0,0,0,0,0,4,2,5,1,0.0,89.0
6029,a45596cda51a1816,8d03ce87ca14e778,3738e68d2261e60f,2017-01-28,1,0,0,92,0,0,13,8,9,4,0,0,4,4,0,0,9,4,3.0,89.0
6030,99373dc33dfbf6e0,917a5cb9821df261,ab943cd2c3c17825,2017-01-28,0,0,0,147,0,0,17,3,17,0,0,0,0,0,3,2,14,3,0.0,125.0
6031,99373dc33dfbf6e0,ab943cd2c3c17825,917a5cb9821df261,2017-01-28,1,0,0,147,0,0,25,6,18,7,0,0,7,5,8,6,10,1,4.0,143.0
6032,6eb382e2c51fc4f5,3ec1e4ba98c9c85a,e45cfa47f504033a,2017-01-28,0,0,0,234,1,1,6,1,6,0,0,0,0,0,0,0,6,1,0.0,77.0
6033,6eb382e2c51fc4f5,e45cfa47f504033a,3ec1e4ba98c9c85a,2017-01-28,0,1,1,234,0,0,18,3,18,0,0,0,0,0,3,1,15,3,0.0,227.0
6034,637f561cd731fb44,2f13e4020cea5b38,cb696ebfb6598724,2017-01-28,0,0,0,900,0,0,101,10,101,0,0,0,0,0,41,29,60,10,0.0,900.0
6035,637f561cd731fb44,cb696ebfb6598724,2f13e4020cea5b38,2017-01-28,0,0,0,900,3,0,172,18,172,0,0,0,0,0,60,34,112,18,0.0,898.0
6036,481aef2d2802ec68,77d7295d1b22c694,b9664eae2ac75262,2017-01-28,0,0,0,134,0,0,2,1,2,0,0,0,0,0,0,0,2,1,0.0,62.5
6037,481aef2d2802ec68,b9664eae2ac75262,77d7295d1b22c694,2017-01-28,0,1,1,134,3,1,3,1,2,1,0,0,1,1,0,0,2,0,25.5,83.0
6038,43682a646b9b956f,7aa3d6964eff4877,bb1a2cdad6ff34db,2017-01-28,0,0,0,561,0,0,58,14,58,0,0,0,0,0,18,13,40,14,0.0,356.0
6039,43682a646b9b956f,bb1a2cdad6ff34db,7aa3d6964eff4877,2017-01-28,0,4,1,561,4,2,95,22,84,11,1,1,10,8,16,8,68,14,204.0,357.0
6040,3c8eb8ad5e98876f,a8e6a69796280f17,d156513a19acf856,2017-01-28,0,0,0,900,2,1,65,13,65,0,0,0,0,0,24,15,41,13,0.0,774.6
6041,3c8eb8ad5e98876f,d156513a19acf856,a8e6a69796280f17,2017-01-28,0,0,0,900,1,0,84,23,83,1,0,0,1,1,18,13,65,22,13.4,779.0
6042,1cd0ce0e2312ad52,99bcdf5eac39898f,b0bd0c5425668b8f,2017-01-28,0,2,0,900,5,4,67,36,51,16,1,1,15,12,2,2,49,24,489.3,315.0
6043,1cd0ce0e2312ad52,b0bd0c5425668b8f,99bcdf5eac39898f,2017-01-28,0,0,0,900,0,0,43,9,41,2,0,0,2,1,16,13,25,8,4.0,390.7
6044,0094d2ed98819f7a,a0c64f272b65d441,a0f0004aadf10b71,2017-01-28,0,0,0,900,12,4,93,31,89,4,0,0,4,3,3,1,86,28,97.7,630.4
6045,0094d2ed98819f7a,a0f0004aadf10b71,a0c64f272b65d441,2017-01-28,0,2,0,900,3,1,99,27,96,3,0,0,3,2,17,10,79,25,98.6,572.3
6046,c1356395d6b055d7,75afb06215a07341,9be6020024133293,2017-01-15,0,0,0,161,1,0,10,2,10,0,0,0,0,0,5,3,5,2,0.0,79.0
6047,c1356395d6b055d7,9be6020024133293,75afb06215a07341,2017-01-15,1,0,0,161,1,1,47,19,9,38,0,0,38,17,0,0,9,2,82.0,79.0
6048,bbb67c2ac4453d64,065eb44700e641a4,7cbf7c78d3b34218,2017-01-15,0,0,0,900,0,0,80,7,80,0,0,0,0,0,23,15,57,7,0.0,843.2
6049,bbb67c2ac4453d64,7cbf7c78d3b34218,065eb44700e641a4,2017-01-15,0,0,0,900,2,2,110,29,106,4,3,2,1,1,43,37,63,28,49.8,414.0
6050,b60bbec8ec98941b,3d5b1ce6097dbb49,9ba2226646046b63,2017-01-15,0,0,0,900,9,4,109,33,108,1,0,0,1,0,14,9,94,33,6.6,759.9
6051,b60bbec8ec98941b,9ba2226646046b63,3d5b1ce6097dbb49,2017-01-15,1,0,0,900,4,0,106,16,105,1,0,0,1,1,38,24,67,15,8.1,739.4
6052,ae803440d778a12b,2d447cc91bdaa545,d6285cba1d1052e0,2017-01-15,1,0,0,725,1,0,95,24,83,12,2,1,10,5,19,16,64,19,120.7,393.0
6053,ae803440d778a12b,d6285cba1d1052e0,2d447cc91bdaa545,2017-01-15,0,0,0,725,0,0,54,6,54,0,0,0,0,0,22,16,32,6,0.0,538.3
6054,8edb831924d69dd9,484acc7b0f856ce9,523fa774700d7d3f,2017-01-15,0,0,0,900,0,0,139,22,139,0,0,0,0,0,42,27,97,22,0.0,800.4
6055,8edb831924d69dd9,523fa774700d7d3f,484acc7b0f856ce9,2017-01-15,0,0,0,900,3,1,172,25,162,10,0,0,10,5,51,29,111,20,99.6,671.0
6056,8156479490877d08,5331b25a60417ffb,c17041f1bb5768d8,2017-01-15,0,0,0,900,6,2,40,12,25,15,2,1,13,9,8,7,17,3,429.2,156.0
6057,8156479490877d08,c17041f1bb5768d8,5331b25a60417ffb,2017-01-15,0,0,0,900,0,0,30,5,30,0,0,0,0,0,10,6,20,5,0.0,430.8
6058,7685701c382cd49a,92437c6775b3f7d1,de75d1c45a39e221,2017-01-15,0,0,0,900,5,1,120,26,118,2,1,1,1,1,12,6,106,25,81.5,737.0
6059,7685701c382cd49a,de75d1c45a39e221,92437c6775b3f7d1,2017-01-15,0,0,0,900,2,2,159,45,159,0,0,0,0,0,7,3,152,45,0.0,734.5
6060,5742025a09190829,73c7cfa551289285,cbf5e6f231b55443,2017-01-15,0,0,0,324,0,0,22,4,22,0,0,0,0,0,0,0,22,4,0.0,286.1
6061,5742025a09190829,cbf5e6f231b55443,73c7cfa551289285,2017-01-15,1,0,0,324,0,0,111,33,75,36,0,0,36,16,28,22,47,17,15.9,305.0
6062,53c3565ee1d3411a,1a98c9dbb7fc3959,d343df8ba11f4c4e,2017-01-15,0,0,0,819,1,0,73,15,73,0,0,0,0,0,11,6,62,15,0.0,432.8
6063,53c3565ee1d3411a,d343df8ba11f4c4e,1a98c9dbb7fc3959,2017-01-15,0,2,1,819,1,1,106,37,82,24,0,0,24,18,22,11,60,19,383.2,308.0
6064,3f7684492c9df05e,01b352b6a9074d5c,03f982ca3735070c,2017-01-15,0,0,0,461,0,0,63,6,63,0,0,0,0,0,21,14,42,6,0.0,460.3
6065,3f7684492c9df05e,03f982ca3735070c,01b352b6a9074d5c,2017-01-15,1,0,0,461,1,0,73,24,71,2,0,0,2,2,15,8,56,22,0.7,459.0
6066,1a81573425c585fb,202b0467521c9d6f,98c23cb6da5b3352,2017-01-15,0,0,0,177,1,1,19,7,11,8,0,0,8,4,0,0,11,3,103.0,74.0
6067,1a81573425c585fb,98c23cb6da5b3352,202b0467521c9d6f,2017-01-15,0,1,1,177,0,0,15,4,15,0,0,0,0,0,3,3,12,4,0.0,40.0
6068,00720c46f864fe03,3bad7ef643840f67,bf43fed8f29e1671,2017-01-15,0,1,0,900,2,1,62,17,61,1,0,0,1,0,4,3,57,17,6.1,680.2
6069,00720c46f864fe03,bf43fed8f29e1671,3bad7ef643840f67,2017-01-15,0,0,0,900,5,5,78,20,75,3,0,0,3,0,8,3,67,20,122.8,402.9
6070,d8c7497043e7e5bd,638cfec7ec559d6e,d8da10db80131bec,2016-12-30,0,2,0,270,0,0,14,4,14,0,0,0,0,0,5,4,9,4,0.0,140.8
6071,d8c7497043e7e5bd,d8da10db80131bec,638cfec7ec559d6e,2016-12-30,0,2,1,270,4,1,16,3,13,3,0,0,3,1,4,3,9,2,128.2,99.0
6072,abf0f8234f6be37e,0941df56f6ac954b,84b3e7d38f2d2ec5,2016-12-30,0,0,0,900,7,6,36,10,25,11,2,2,9,6,6,6,19,4,412.5,299.0
6073,abf0f8234f6be37e,84b3e7d38f2d2ec5,0941df56f6ac954b,2016-12-30,0,2,0,900,1,1,91,27,69,22,3,3,19,15,29,20,40,12,1.0,486.5
6074,ab847a4cf397d7d5,a4de54ea806fb525,d2bc285ead803db0,2016-12-30,0,1,0,900,8,4,38,14,23,15,2,2,13,10,7,5,16,4,489.8,247.0
6075,ab847a4cf397d7d5,d2bc285ead803db0,a4de54ea806fb525,2016-12-30,0,1,0,900,1,0,43,9,43,0,0,0,0,0,7,1,36,9,0.0,365.2
6076,9d4b2767f6630fc9,4b47e71384a9522f,57b10fca4f9c9a7a,2016-12-30,0,0,0,213,1,1,23,9,16,7,2,1,5,4,8,7,8,5,31.0,151.0
6077,9d4b2767f6630fc9,57b10fca4f9c9a7a,4b47e71384a9522f,2016-12-30,1,0,0,213,4,1,10,3,10,0,0,0,0,0,3,3,7,3,0.0,103.0
6078,7f663d67422c1b24,c268b2cfebccf652,c849740a3ff51931,2016-12-30,0,0,0,900,2,1,90,18,84,6,1,1,5,4,36,19,48,14,12.0,469.0
6079,7f663d67422c1b24,c849740a3ff51931,c268b2cfebccf652,2016-12-30,0,1,0,900,6,5,119,53,59,60,6,6,54,40,15,12,44,13,413.0,475.0
6080,78736e322574e500,52e76bb4b3e852f3,7acbb0972e75281a,2016-12-30,0,0,0,900,13,4,75,12,67,8,2,1,6,3,19,15,48,9,157.2,409.4
6081,78736e322574e500,7acbb0972e75281a,52e76bb4b3e852f3,2016-12-30,0,1,0,900,1,1,70,21,49,21,2,2,19,14,7,6,42,7,156.6,563.8
6082,3d07a533feca7458,0749d968e932df53,9bcf8603ceb25680,2016-12-30,0,0,0,900,6,2,105,38,105,0,0,0,0,0,17,14,88,38,0.0,815.0
6083,3d07a533feca7458,9bcf8603ceb25680,0749d968e932df53,2016-12-30,0,0,0,900,8,3,107,28,107,0,0,0,0,0,13,8,94,28,0.0,583.0
6084,31acf87e89a4a401,a2b12c3f3d60ff69,f5990c11974d8e9c,2016-12-30,1,0,0,214,2,1,29,13,27,2,0,0,2,1,2,1,25,12,59.3,125.0
6085,31acf87e89a4a401,f5990c11974d8e9c,a2b12c3f3d60ff69,2016-12-30,0,0,0,214,0,0,24,2,24,0,0,0,0,0,3,3,21,2,0.0,154.7
6086,25e6b11e1cf45b83,10f3ba6cd2f44a97,d8c7c61b176e3994,2016-12-30,0,0,0,1500,7,0,291,58,291,0,0,0,0,0,41,30,250,58,0.0,1491.2
6087,25e6b11e1cf45b83,d8c7c61b176e3994,10f3ba6cd2f44a97,2016-12-30,2,0,0,1500,4,1,195,47,194,1,0,0,1,0,31,21,163,47,7.8,1461.0
6088,0aad210fbaa1db6c,80fa8218c99f9c58,8bdac25ce0bb874d,2016-12-30,1,0,0,48,0,0,47,23,47,0,0,0,0,0,4,4,43,23,0.0,48.0
6089,0aad210fbaa1db6c,8bdac25ce0bb874d,80fa8218c99f9c58,2016-12-30,0,0,0,48,0,0,14,6,14,0,0,0,0,0,2,1,12,6,0.0,48.0
6090,d77ace7aadb2383e,578ef12674df1e6a,76984112f697631f,2016-12-17,0,0,0,900,1,1,256,84,253,3,2,1,1,0,29,23,224,84,0.8,887.6
6091,d77ace7aadb2383e,76984112f697631f,578ef12674df1e6a,2016-12-17,1,0,0,900,0,0,401,126,386,15,3,1,12,5,63,42,323,121,6.4,882.2
6092,ca6d4239726931f9,48e093ea1f43a053,fc9a9559a05f2704,2016-12-17,0,0,0,184,0,0,40,8,40,0,0,0,0,0,6,5,34,8,0.0,178.0
6093,ca6d4239726931f9,fc9a9559a05f2704,48e093ea1f43a053,2016-12-17,2,0,0,184,0,0,32,8,28,4,0,0,4,2,2,1,26,6,6.0,178.0
6094,88c712be47805d63,0ccab7c889ede9ea,449c890bd90f3374,2016-12-17,0,0,0,900,8,0,87,5,87,0,0,0,0,0,25,17,62,5,0.0,885.3
6095,88c712be47805d63,449c890bd90f3374,0ccab7c889ede9ea,2016-12-17,0,2,0,900,12,2,67,14,66,1,1,0,0,0,22,19,44,14,6.7,740.0
6096,7979888b1fb5eb39,df1eb4354d18a906,fba03cd6cc28dc41,2016-12-17,0,0,0,900,4,3,179,48,174,5,0,0,5,3,31,17,143,45,20.7,672.2
6097,7979888b1fb5eb39,fba03cd6cc28dc41,df1eb4354d18a906,2016-12-17,0,1,0,900,12,8,160,50,153,7,1,1,6,4,40,36,113,46,32.8,640.3
6098,677588ea237aa5c0,a331233f597090a5,dc9572dd6ec74859,2016-12-17,0,0,0,900,0,0,111,29,109,2,0,0,2,2,13,12,96,27,0.0,687.3
6099,677588ea237aa5c0,dc9572dd6ec74859,a331233f597090a5,2016-12-17,0,0,0,900,17,12,141,56,134,7,1,1,6,6,23,19,111,50,212.7,353.0
6100,5840527835a8ffb2,4d5197f331c47290,eb04b9d31e938edb,2016-12-17,0,0,0,201,1,0,12,1,12,0,0,0,0,0,6,4,6,1,0.0,201.0
6101,5840527835a8ffb2,eb04b9d31e938edb,4d5197f331c47290,2016-12-17,0,2,1,201,1,1,17,6,17,0,0,0,0,0,8,6,9,6,0.0,94.0
6102,4b35edc671de861f,282fa667ff9c51ed,35faad160d346839,2016-12-17,0,0,0,900,0,0,60,11,59,1,0,0,1,1,16,10,43,10,63.0,259.9
6103,4b35edc671de861f,35faad160d346839,282fa667ff9c51ed,2016-12-17,0,0,0,900,7,6,114,43,61,53,5,3,48,27,14,11,47,16,577.1,249.0
6104,473b9b56cdaedba3,cf65d56b0755ed3b,f2b6fdb20675b11c,2016-12-17,1,0,0,900,5,2,133,24,130,3,0,0,3,2,64,45,66,22,49.5,834.0
6105,473b9b56cdaedba3,f2b6fdb20675b11c,cf65d56b0755ed3b,2016-12-17,0,0,0,900,0,0,90,22,90,0,0,0,0,0,20,15,70,22,0.0,850.5
6106,30f6cf4253b13b76,c06a9b48d4132c8e,cdb96af67d096b1e,2016-12-17,0,0,0,900,0,0,95,14,95,0,0,0,0,0,45,32,50,14,0.0,881.0
6107,30f6cf4253b13b76,cdb96af67d096b1e,c06a9b48d4132c8e,2016-12-17,0,0,0,900,3,0,186,85,186,0,0,0,0,0,32,26,154,85,0.0,846.0
6108,2cdf841a057d9039,78114b7199cef90c,c945adc22c2bfe8f,2016-12-17,1,1,0,900,10,5,126,61,79,47,1,1,46,38,11,8,68,23,351.1,503.5
6109,2cdf841a057d9039,c945adc22c2bfe8f,78114b7199cef90c,2016-12-17,0,0,0,900,1,1,65,8,64,1,0,0,1,1,23,10,41,7,15.5,517.9
6110,23bc29f1b6baacad,9e50097a89442158,ed9d8ee3a4239b1c,2016-12-17,1,3,1,400,2,2,18,8,10,8,3,1,5,2,0,0,10,6,182.2,159.0
6111,23bc29f1b6baacad,ed9d8ee3a4239b1c,9e50097a89442158,2016-12-17,1,0,0,400,1,0,23,6,19,4,1,1,3,2,6,6,13,4,36.0,154.8
6112,1ca4274019680d23,e70de1859b7ee78e,fcce75a25c14a804,2016-12-17,0,0,0,900,3,2,26,14,16,10,0,0,10,9,1,1,15,5,394.3,343.2
6113,1ca4274019680d23,fcce75a25c14a804,e70de1859b7ee78e,2016-12-17,0,1,0,900,1,0,53,1,52,1,0,0,1,1,32,21,20,0,4.8,481.7
6114,01f396a7372dc8ff,b0bd0c5425668b8f,eabf206b162b3b83,2016-12-17,0,0,0,419,3,1,24,7,24,0,0,0,0,0,11,9,13,7,0.0,183.1
6115,01f396a7372dc8ff,eabf206b162b3b83,b0bd0c5425668b8f,2016-12-17,0,3,1,419,2,1,49,21,43,6,1,1,5,4,11,9,32,17,34.9,291.0
6116,d573e571d8349b5d,57ab4d7c0bc09a30,f53c1f4ceeed8c08,2016-12-10,0,1,0,900,10,4,44,7,43,1,0,0,1,1,16,14,27,6,9.1,535.4
6117,d573e571d8349b5d,f53c1f4ceeed8c08,57ab4d7c0bc09a30,2016-12-10,0,0,0,900,9,4,65,18,49,16,3,3,13,10,20,13,29,8,237.6,400.9
6118,ca9804845b010845,46a2f24feb258ae0,d50382dc0565a9e1,2016-12-10,0,0,0,900,1,1,153,30,142,11,2,2,9,7,22,15,120,23,50.7,738.0
6119,ca9804845b010845,d50382dc0565a9e1,46a2f24feb258ae0,2016-12-10,0,0,0,900,1,1,97,12,95,2,0,0,2,1,24,13,71,11,56.0,625.3
6120,b121f30d7fc9ea6c,2fc7e9701642ca38,b8592b4a383696cd,2016-12-10,0,1,0,900,6,5,54,20,33,21,0,0,21,12,11,10,22,8,487.4,251.1
6121,b121f30d7fc9ea6c,b8592b4a383696cd,2fc7e9701642ca38,2016-12-10,1,0,0,900,4,1,50,22,30,20,1,1,19,14,9,8,21,8,91.9,288.6
6122,977a758d869f9e7a,150ff4cc642270b9,cbb682f5fcc44bfc,2016-12-10,1,0,0,890,2,2,208,48,206,2,2,2,0,0,63,44,143,48,3.6,854.0
6123,977a758d869f9e7a,cbb682f5fcc44bfc,150ff4cc642270b9,2016-12-10,0,0,0,890,2,0,158,25,158,0,0,0,0,0,58,28,100,25,0.0,802.4
6124,96404a3b32791c8d,1d00756835ca67c9,31123249b0bbf52e,2016-12-10,2,0,0,634,3,0,147,46,147,0,0,0,0,0,21,17,126,46,0.0,599.0
6125,96404a3b32791c8d,31123249b0bbf52e,1d00756835ca67c9,2016-12-10,1,1,0,634,2,0,128,42,128,0,0,0,0,0,37,28,91,42,0.0,630.0
6126,8b983e834df0c6c4,4ac1ecf8ce59ef23,9b7694d064a8a0ad,2016-12-10,0,0,0,900,2,0,72,1,72,0,0,0,0,0,30,18,42,1,0.0,567.8
6127,8b983e834df0c6c4,9b7694d064a8a0ad,4ac1ecf8ce59ef23,2016-12-10,0,0,0,900,5,4,102,33,81,21,1,1,20,12,15,8,66,21,332.2,552.0
6128,761a215d51a0442e,103b06d8707895a9,2aa49b3766a59bcd,2016-12-10,0,1,0,900,2,1,133,25,107,26,13,11,13,11,21,14,86,14,385.4,379.7
6129,761a215d51a0442e,2aa49b3766a59bcd,103b06d8707895a9,2016-12-10,0,0,0,900,5,3,61,22,60,1,0,0,1,1,18,12,42,21,16.3,416.6
6130,5f0aa841c21f7d30,d247691a6c0e9034,e93b04e308913c2e,2016-12-10,0,0,0,900,5,2,210,75,201,9,1,1,8,6,54,35,147,69,38.6,746.3
6131,5f0aa841c21f7d30,e93b04e308913c2e,d247691a6c0e9034,2016-12-10,0,0,0,900,5,1,160,61,158,2,0,0,2,2,20,16,138,59,3.7,808.4
6132,0af90a49f0ca1879,1091d4d957141094,67f272324a030d00,2016-12-10,0,0,0,278,2,1,29,5,29,0,0,0,0,0,18,11,11,5,0.0,185.0
6133,0af90a49f0ca1879,67f272324a030d00,1091d4d957141094,2016-12-10,0,1,1,278,3,2,18,6,18,0,0,0,0,0,3,2,15,6,0.0,238.0
6134,07b98dbf5d2c62a2,3c660c90d48fc80d,8c0580d4fff106c1,2016-12-10,0,0,0,765,8,3,108,15,107,1,0,0,1,1,47,30,60,14,11.1,523.2
6135,07b98dbf5d2c62a2,8c0580d4fff106c1,3c660c90d48fc80d,2016-12-10,1,0,0,765,0,0,110,49,109,1,1,1,0,0,18,12,91,49,7.8,683.9
6136,071d488ec8ccf254,c21a036b4e012f1c,f9b200db02b488d9,2016-12-10,0,0,0,100,0,0,13,2,13,0,0,0,0,0,10,9,3,2,0.0,100.0
6137,071d488ec8ccf254,f9b200db02b488d9,c21a036b4e012f1c,2016-12-10,1,0,0,100,0,0,32,3,32,0,0,0,0,0,18,7,14,3,0.0,99.0
6138,04f27a78e4ffce47,519e4fe37ce9ff75,55ee431411ccf07a,2016-12-10,1,0,0,477,0,0,71,9,59,12,9,9,3,0,16,6,43,9,72.0,405.0
6139,04f27a78e4ffce47,55ee431411ccf07a,519e4fe37ce9ff75,2016-12-10,0,1,1,477,0,0,53,21,53,0,0,0,0,0,9,6,44,21,0.0,312.0
6140,cb1e57b5f8c92922,2f5cbecbbe18bac4,d3df1add9d9a7efb,2016-12-09,0,1,0,1122,11,4,37,5,30,7,4,4,3,1,10,6,20,4,226.0,584.2
6141,cb1e57b5f8c92922,d3df1add9d9a7efb,2f5cbecbbe18bac4,2016-12-09,1,0,0,1122,3,1,90,32,53,37,0,0,37,27,9,7,44,5,85.8,794.0
6142,a71febed166b7d42,32c355b04fc57f3a,96c336b463e0662c,2016-12-09,0,0,0,900,13,6,34,5,28,6,0,0,6,4,9,4,19,1,367.7,310.7
6143,a71febed166b7d42,96c336b463e0662c,32c355b04fc57f3a,2016-12-09,0,0,0,900,3,1,51,7,40,11,1,1,10,6,16,12,24,1,160.3,328.3
6144,9555d8941df4a998,928ae2e5b5f7a9ec,b4c6c904a9ffc5e8,2016-12-09,0,1,0,900,1,1,107,17,105,2,0,0,2,1,53,34,52,16,43.3,521.7
6145,9555d8941df4a998,b4c6c904a9ffc5e8,928ae2e5b5f7a9ec,2016-12-09,0,0,0,900,2,1,116,31,108,8,0,0,8,5,32,13,76,26,53.3,736.7
6146,87b6c507a7684ec2,6fd953151d981979,75a6a390fd5dca46,2016-12-09,0,0,0,900,0,0,81,13,76,5,1,1,4,3,21,17,55,10,7.7,750.9
6147,87b6c507a7684ec2,75a6a390fd5dca46,6fd953151d981979,2016-12-09,0,0,0,900,6,4,124,22,115,9,3,3,6,5,40,31,75,17,103.1,468.3
6148,85feac6924abb35b,6ac9bc2953c47345,83825fad27ab3581,2016-12-09,0,1,1,252,2,0,34,13,31,3,1,1,2,2,0,0,31,11,19.5,187.0
6149,85feac6924abb35b,83825fad27ab3581,6ac9bc2953c47345,2016-12-09,0,0,0,252,1,1,20,2,20,0,0,0,0,0,4,3,16,2,0.0,193.5
6150,770312f3ca8506b6,b59037262c8fe060,e3779ef06e98f185,2016-12-09,0,0,0,900,0,0,214,55,210,4,0,0,4,2,34,27,176,53,59.3,702.5
6151,770312f3ca8506b6,e3779ef06e98f185,b59037262c8fe060,2016-12-09,0,0,0,900,5,2,168,39,165,3,0,0,3,1,32,22,133,38,19.5,788.7
6152,4bf0be780f2d09be,8ce87f7e3a9baed2,98d961097baaf308,2016-12-09,0,0,0,900,12,1,200,33,200,0,0,0,0,0,40,23,160,33,0.0,734.7
6153,4bf0be780f2d09be,98d961097baaf308,8ce87f7e3a9baed2,2016-12-09,1,0,0,900,1,1,189,62,170,19,1,1,18,12,14,10,156,50,53.3,813.0
6154,25cd989ac5569629,88d7b6d8230e1f3f,fcd448a2fe1a23cc,2016-12-09,0,0,0,474,2,0,131,30,130,1,0,0,1,0,11,7,119,30,2.4,448.4
6155,25cd989ac5569629,fcd448a2fe1a23cc,88d7b6d8230e1f3f,2016-12-09,1,0,0,474,0,0,108,49,92,16,0,0,16,10,15,11,77,39,13.6,448.6
6156,14e7bb7a9d49450d,5e4eec08896c9423,cb52f9490c2dc069,2016-12-09,1,0,0,456,5,5,103,62,11,92,4,4,88,57,0,0,11,5,401.6,50.0
6157,14e7bb7a9d49450d,cb52f9490c2dc069,5e4eec08896c9423,2016-12-09,0,0,0,456,0,0,22,5,14,8,0,0,8,5,5,4,9,0,0.0,54.39999999999998
6158,0b26d635106aea1c,f797f0c57a83353e,fccf811c1e8b01c7,2016-12-09,0,0,0,900,2,0,141,20,140,1,0,0,1,1,43,41,97,19,1.7,857.0
6159,0b26d635106aea1c,fccf811c1e8b01c7,f797f0c57a83353e,2016-12-09,0,0,0,900,0,0,204,54,204,0,0,0,0,0,26,20,178,54,0.0,871.3
6160,0769ab47fcf0bf6b,8d03ce87ca14e778,c727c7d31c50c4cf,2016-12-09,0,1,1,117,0,0,1,0,1,0,0,0,0,0,1,1,0,0,0.0,111.0
6161,0769ab47fcf0bf6b,c727c7d31c50c4cf,8d03ce87ca14e778,2016-12-09,0,0,0,117,2,1,3,0,3,0,0,0,0,0,2,0,1,0,0.0,73.0
6162,02e3699be1d8daa2,1999ffb5cebc314f,c6aee362c7a7d482,2016-12-09,0,1,0,385,3,0,35,3,34,1,0,0,1,1,11,8,23,2,7.5,202.7
6163,02e3699be1d8daa2,c6aee362c7a7d482,1999ffb5cebc314f,2016-12-09,1,0,0,385,1,1,82,30,62,20,5,5,15,9,9,7,53,21,152.3,141.5
6164,fe132ef2ab8ae9d2,30ea504870f8597b,cc7040fe76f0ef91,2016-12-03,0,2,0,900,2,0,66,21,65,1,0,0,1,0,16,15,49,21,12.8,634.0
6165,fe132ef2ab8ae9d2,cc7040fe76f0ef91,30ea504870f8597b,2016-12-03,0,0,0,900,6,1,103,35,101,2,0,0,2,0,16,12,85,35,35.0,607.2
6166,c5d48ca7c22f857e,494b0bfdbac74502,98a6b2361045898f,2016-12-03,0,1,0,900,2,0,38,16,36,2,1,1,1,1,12,8,24,15,17.7,265.1
6167,c5d48ca7c22f857e,98a6b2361045898f,494b0bfdbac74502,2016-12-03,0,0,0,900,4,4,32,8,16,16,5,5,11,8,9,8,7,0,413.9,287.3
6168,a716172939767cab,4c2d90e335e6df19,7be74a12d7352df2,2016-12-03,0,1,0,472,0,0,29,17,19,10,0,0,10,10,4,4,15,7,370.0,102.0
6169,a716172939767cab,7be74a12d7352df2,4c2d90e335e6df19,2016-12-03,0,1,1,472,2,2,36,11,29,7,0,0,7,6,4,3,25,5,0.0,102.0
6170,9cad47cdd6351e50,13a0275fa13c4d26,cd13728ae1151f46,2016-12-03,0,0,0,900,2,0,94,45,89,5,1,1,4,4,13,13,76,41,47.2,564.3
6171,9cad47cdd6351e50,cd13728ae1151f46,13a0275fa13c4d26,2016-12-03,0,0,0,900,7,6,142,30,122,20,0,0,20,10,20,15,102,20,146.7,566.8
6172,63b35df1276b3d64,05339613bf8e9808,67c1d46f4ed16f9e,2016-12-03,1,1,0,227,1,1,33,20,20,13,2,2,11,11,4,4,16,9,120.7,97.0
6173,63b35df1276b3d64,67c1d46f4ed16f9e,05339613bf8e9808,2016-12-03,0,0,0,227,0,0,33,9,33,0,0,0,0,0,5,5,28,9,0.0,106.3
6174,5e1370a92ce8abb0,056c493bbd76a918,80eacd4da0617c57,2016-12-03,1,0,0,900,7,1,195,29,195,0,0,0,0,0,52,39,143,29,0.0,887.0
6175,5e1370a92ce8abb0,80eacd4da0617c57,056c493bbd76a918,2016-12-03,0,0,0,900,0,0,232,39,232,0,0,0,0,0,60,30,172,39,0.0,899.0
6176,5ae45d20a60dc109,05b43e0ead3df345,882d62561063a927,2016-12-03,0,1,0,900,0,0,134,30,130,4,1,1,3,2,21,16,109,28,76.3,433.1
6177,5ae45d20a60dc109,882d62561063a927,05b43e0ead3df345,2016-12-03,0,0,0,900,10,3,121,37,109,12,0,0,12,8,43,36,66,29,27.9,737.7
6178,36830f6eb3c847f5,20999e27ddd94bda,792be9a24df82ed6,2016-12-03,1,0,0,900,1,0,93,21,91,2,0,0,2,1,13,2,78,20,4.0,811.5
6179,36830f6eb3c847f5,792be9a24df82ed6,20999e27ddd94bda,2016-12-03,0,0,0,900,13,5,143,35,138,5,0,0,5,4,23,19,115,31,72.5,606.0
6180,27ff7028ec8c2161,47b9e0e7703a4868,d81ac739417d7f53,2016-12-03,1,0,0,245,0,0,63,26,56,7,0,0,7,6,23,18,33,20,11.1,207.0
6181,27ff7028ec8c2161,d81ac739417d7f53,47b9e0e7703a4868,2016-12-03,0,0,0,245,1,0,31,7,31,0,0,0,0,0,7,4,24,7,0.0,230.9
6182,163fbb2185730846,28c55b4087a6f136,d4c9dcd330403612,2016-12-03,0,0,0,507,0,0,81,22,56,25,0,0,25,14,13,7,43,8,248.1,248.0
6183,163fbb2185730846,d4c9dcd330403612,28c55b4087a6f136,2016-12-03,1,1,0,507,0,0,90,41,87,3,0,0,3,1,12,7,75,40,1.0,255.9
6184,02822c35ffef5a50,8a304bfd6bf04a57,c96d9178c9ed9e62,2016-12-03,0,3,0,1500,7,5,58,16,47,11,1,1,10,8,18,11,29,8,577.8,474.8
6185,02822c35ffef5a50,c96d9178c9ed9e62,8a304bfd6bf04a57,2016-12-03,0,2,0,1500,4,4,61,15,59,2,0,0,2,1,25,9,34,14,27.2,704.2
6186,019983faebec6d64,7d96bc577e5178b2,8866c6f509c19089,2016-12-03,0,0,0,900,0,0,42,4,36,6,5,2,1,1,10,6,26,3,178.0,722.0
6187,019983faebec6d64,8866c6f509c19089,7d96bc577e5178b2,2016-12-03,0,0,0,900,2,0,117,14,116,1,0,0,1,1,73,32,43,13,0.0,722.0
6188,d1c519260c0ddf3a,49e96ff8ab781589,749f572d1d3161fb,2016-11-26,0,1,1,247,2,2,7,0,7,0,0,0,0,0,7,4,0,0,0.0,58.0
6189,d1c519260c0ddf3a,749f572d1d3161fb,49e96ff8ab781589,2016-11-26,1,0,0,247,0,0,7,3,6,1,0,0,1,0,0,0,6,3,0.0,247.0
6190,71854cfe738d6ee1,6c2030e0a143a94b,bdcbb976816fd256,2016-11-26,0,0,0,900,0,0,115,48,115,0,0,0,0,0,8,8,107,48,0.0,597.0
6191,71854cfe738d6ee1,bdcbb976816fd256,6c2030e0a143a94b,2016-11-26,0,0,0,900,4,4,102,36,96,6,1,1,5,4,3,2,93,32,303.0,496.0
6192,6d04fbef6b8e4551,b1a3e0aca758b322,e1147d3d2dabe1ce,2016-11-26,0,0,0,247,3,0,42,18,42,0,0,0,0,0,1,1,41,18,0.0,171.7
6193,6d04fbef6b8e4551,e1147d3d2dabe1ce,b1a3e0aca758b322,2016-11-26,1,0,0,247,0,0,58,30,49,9,0,0,9,6,3,3,46,24,3.3,240.0
6194,64bc223daa594bcc,53ec9cb470e1a4ea,d024ed963e8bf7ea,2016-11-26,1,0,0,900,1,0,87,24,73,14,1,1,13,7,20,14,53,17,176.6,673.0
6195,64bc223daa594bcc,d024ed963e8bf7ea,53ec9cb470e1a4ea,2016-11-26,0,1,0,900,1,0,130,22,130,0,0,0,0,0,27,12,103,22,0.0,723.4
6196,4f60a7e7b848bc6d,193b9d1858bc4df3,bb1a2cdad6ff34db,2016-11-26,0,0,0,900,0,0,100,43,99,1,0,0,1,0,14,4,85,43,21.5,731.4
6197,4f60a7e7b848bc6d,bb1a2cdad6ff34db,193b9d1858bc4df3,2016-11-26,0,4,0,900,13,4,185,50,182,3,0,0,3,3,13,9,169,47,125.6,585.5
6198,450760216f5643ca,16690d100f995f8f,7339d340aa2889cb,2016-11-26,0,0,0,900,4,3,74,21,57,17,1,1,16,12,6,1,51,9,387.0,513.0
6199,450760216f5643ca,7339d340aa2889cb,16690d100f995f8f,2016-11-26,0,0,0,900,0,0,51,4,51,0,0,0,0,0,21,12,30,4,0.0,513.0
6200,314aea77cd24210f,165c244bcca3ed26,b76c6268dc1d3c05,2016-11-26,0,0,0,900,1,0,103,24,103,0,0,0,0,0,10,7,93,24,0.0,892.0
6201,314aea77cd24210f,b76c6268dc1d3c05,165c244bcca3ed26,2016-11-26,0,0,0,900,2,0,162,37,162,0,0,0,0,0,12,8,150,37,0.0,900.0
6202,2e209dc450b7ebe3,2c1170b825f58e57,7c7332319c14094c,2016-11-26,0,0,0,900,1,0,107,23,85,22,1,1,21,14,39,22,46,9,147.8,597.8
6203,2e209dc450b7ebe3,7c7332319c14094c,2c1170b825f58e57,2016-11-26,1,2,0,900,3,1,72,20,58,14,1,1,13,10,27,15,31,10,134.2,589.2
6204,2cab927474cb6e62,3058888c33149a53,e1248941344b3288,2016-11-26,0,0,0,426,2,1,10,2,10,0,0,0,0,0,4,2,6,2,0.0,77.30000000000001
6205,2cab927474cb6e62,e1248941344b3288,3058888c33149a53,2016-11-26,1,0,0,426,3,3,76,47,10,66,1,0,65,45,4,3,6,2,249.7,165.0
6206,2c0a58ef0324e18b,303a05a7aa3ff761,5823ceab56741617,2016-11-26,0,1,0,900,8,2,88,7,83,5,0,0,5,2,19,11,64,5,57.7,723.7
6207,2c0a58ef0324e18b,5823ceab56741617,303a05a7aa3ff761,2016-11-26,0,0,0,900,3,1,155,39,154,1,0,0,1,1,55,35,99,38,3.3,762.3
6208,291d91378a96d1e8,840d2c82ea68b9aa,c169545ab0825f44,2016-11-26,1,0,0,900,1,0,255,75,254,1,0,0,1,0,43,30,211,75,0.1,898.0
6209,291d91378a96d1e8,c169545ab0825f44,840d2c82ea68b9aa,2016-11-26,0,0,0,900,5,1,107,16,107,0,0,0,0,0,9,6,98,16,0.0,861.9
6210,0da0dc2c7eb29f58,5ea918ea81b7dee2,ec664422b22d9787,2016-11-26,0,0,0,900,6,1,124,15,112,12,0,0,12,8,23,14,89,7,106.2,734.0
6211,0da0dc2c7eb29f58,ec664422b22d9787,5ea918ea81b7dee2,2016-11-26,2,1,0,900,1,1,109,53,103,6,0,0,6,3,7,3,96,50,51.0,742.8
6212,0d33d43bee65d98f,66ab58d0b3783607,a845f0735bc67405,2016-11-26,0,3,0,900,2,2,53,16,50,3,0,0,3,3,17,14,33,13,23.6,628.8
6213,0d33d43bee65d98f,a845f0735bc67405,66ab58d0b3783607,2016-11-26,0,0,0,900,3,3,62,14,58,4,0,0,4,1,12,8,46,13,98.2,557.4
6214,f1afa75c8d492550,045f25b3a4c08e81,0e21976afc92e4d1,2016-11-19,2,0,0,520,0,0,91,33,74,17,1,1,16,9,15,8,59,24,13.0,237.0
6215,f1afa75c8d492550,0e21976afc92e4d1,045f25b3a4c08e81,2016-11-19,0,0,0,520,3,3,83,25,65,18,0,0,18,11,15,11,50,14,270.0,237.0
6216,edcf1d6a1bd8acc7,1bcaac2d99b90fce,47cd337b86b1af92,2016-11-19,0,0,0,900,3,1,91,29,80,11,2,1,9,5,9,5,71,24,244.0,656.0
6217,edcf1d6a1bd8acc7,47cd337b86b1af92,1bcaac2d99b90fce,2016-11-19,0,0,0,900,1,0,141,31,141,0,0,0,0,0,20,13,121,31,0.0,656.0
6218,e4795ab9bdd6fb38,02f2a9702ba3d167,88cd34d836b4ebcd,2016-11-19,0,0,0,900,1,1,160,45,155,5,0,0,5,4,49,37,106,41,24.5,805.0
6219,e4795ab9bdd6fb38,88cd34d836b4ebcd,02f2a9702ba3d167,2016-11-19,1,0,0,900,4,0,119,20,117,2,0,0,2,2,42,28,75,18,46.0,806.5
6220,dad034faf3d62cb9,31d7446b184e3305,ee9ebceabfd16fa7,2016-11-19,0,1,0,571,2,0,34,11,31,3,0,0,3,3,14,9,17,8,15.2,252.0
6221,dad034faf3d62cb9,ee9ebceabfd16fa7,31d7446b184e3305,2016-11-19,0,2,1,571,9,7,28,13,15,13,3,3,10,9,4,4,11,4,258.0,158.8
6222,bd6909a463a1de2b,e81dd0bb8a64b550,eae431e70064e046,2016-11-19,0,0,0,53,0,0,14,2,14,0,0,0,0,0,0,0,14,2,0.0,48.3
6223,bd6909a463a1de2b,eae431e70064e046,e81dd0bb8a64b550,2016-11-19,3,0,0,53,0,0,22,12,18,4,0,0,4,3,0,0,18,9,4.7,46.0
6224,b5268a0c2df32a24,232c582f29f8f65e,65578a75fa7900e3,2016-11-19,1,0,0,277,2,1,40,14,18,22,1,1,21,11,5,5,13,3,44.0,233.0
6225,b5268a0c2df32a24,65578a75fa7900e3,232c582f29f8f65e,2016-11-19,0,0,0,277,0,0,25,2,25,0,0,0,0,0,15,10,10,2,0.0,233.0
6226,ad0bac98558900af,3dd92ff9fb0412b3,98aa60cf58071fd6,2016-11-19,0,0,0,900,6,2,84,9,81,3,1,1,2,2,36,26,45,7,28.2,715.0
6227,ad0bac98558900af,98aa60cf58071fd6,3dd92ff9fb0412b3,2016-11-19,0,0,0,900,9,4,92,47,90,2,0,0,2,2,11,8,79,45,16.0,599.8
6228,ac656cebef8cf0a4,2b074403b7c6cdb4,544d7460b3e44393,2016-11-19,1,0,0,397,0,0,79,30,79,0,0,0,0,0,15,11,64,30,0.0,391.0
6229,ac656cebef8cf0a4,544d7460b3e44393,2b074403b7c6cdb4,2016-11-19,0,0,0,397,2,1,74,13,74,0,0,0,0,0,9,5,65,13,0.0,361.0
6230,a5e240bcd7731725,ab943cd2c3c17825,af997f7611673880,2016-11-19,0,0,0,67,0,0,6,2,6,0,0,0,0,0,0,0,6,2,0.0,46.0
6231,a5e240bcd7731725,af997f7611673880,ab943cd2c3c17825,2016-11-19,0,1,1,67,1,1,4,0,4,0,0,0,0,0,0,0,4,0,0.0,38.0
6232,a337e11f80a75b7d,c13042265355a290,ec52462a1b41f714,2016-11-19,0,0,0,900,0,0,128,35,128,0,0,0,0,0,25,18,103,35,0.0,317.1
6233,a337e11f80a75b7d,ec52462a1b41f714,c13042265355a290,2016-11-19,0,0,0,900,15,11,80,45,54,26,2,2,24,20,4,2,50,25,573.9,304.0
6234,9e75fbe17a35f272,9123c54d0a2b72dd,e5bda12faabfc850,2016-11-19,0,0,0,732,0,0,14,1,14,0,0,0,0,0,2,2,12,1,0.0,211.60000000000002
6235,9e75fbe17a35f272,e5bda12faabfc850,9123c54d0a2b72dd,2016-11-19,0,2,1,732,6,6,52,26,21,31,2,2,29,19,3,3,18,7,520.4,178.0
6236,939cc30f07131724,d317a5e2b3f88c5f,f1b2aa7853d1ed6e,2016-11-19,0,1,0,900,0,0,73,11,73,0,0,0,0,0,18,14,55,11,0.0,637.6
6237,939cc30f07131724,f1b2aa7853d1ed6e,d317a5e2b3f88c5f,2016-11-19,0,1,0,900,2,1,150,58,128,22,3,3,19,6,20,10,108,52,262.4,578.0
6238,934c967872f28b13,a17ad5a5048e8c3f,b69f24c500d783e7,2016-11-19,0,0,0,94,2,1,10,6,3,7,0,0,7,6,1,1,2,0,65.6,19.0
6239,934c967872f28b13,b69f24c500d783e7,a17ad5a5048e8c3f,2016-11-19,0,0,0,94,0,0,1,0,1,0,0,0,0,0,0,0,1,0,0.0,28.400000000000006
6240,8eaa23d64c20b0f1,ad56b3f00ca38dfd,ba1e6cb3d43f7430,2016-11-19,0,0,0,136,1,0,11,2,11,0,0,0,0,0,5,3,6,2,0.0,51.0
6241,8eaa23d64c20b0f1,ba1e6cb3d43f7430,ad56b3f00ca38dfd,2016-11-19,0,1,1,136,1,1,11,3,10,1,0,0,1,1,0,0,10,2,75.0,61.0
6242,7fce3efc5d2add6e,072a10e85f7d4bff,c7d297714d9ab1a4,2016-11-19,0,0,0,783,4,2,47,8,43,4,0,0,4,1,13,9,30,7,49.7,551.8
6243,7fce3efc5d2add6e,c7d297714d9ab1a4,072a10e85f7d4bff,2016-11-19,1,1,0,783,1,1,136,38,119,17,0,0,17,10,13,10,106,28,82.2,472.3
6244,6b5fe10e6e7d160a,31a13532e724ca2b,4f732e58ed907eff,2016-11-19,0,0,0,900,3,1,117,13,117,0,0,0,0,0,46,36,71,13,0.0,708.0
6245,6b5fe10e6e7d160a,4f732e58ed907eff,31a13532e724ca2b,2016-11-19,0,0,0,900,0,0,92,5,92,0,0,0,0,0,52,33,40,5,0.0,892.0
6246,689116759885e4a5,279566840aa55bf2,cc900af167fbedfd,2016-11-19,0,0,0,900,2,1,84,35,84,0,0,0,0,0,13,10,71,35,0.0,470.2
6247,689116759885e4a5,cc900af167fbedfd,279566840aa55bf2,2016-11-19,1,0,0,900,8,1,93,36,63,30,3,2,27,20,7,5,56,16,204.8,627.0
6248,4c05732d411d6412,5f179af5fffeb9f6,ec34349e7dffcde7,2016-11-19,0,0,0,900,1,0,68,10,68,0,0,0,0,0,19,12,49,10,0.0,760.7
6249,4c05732d411d6412,ec34349e7dffcde7,5f179af5fffeb9f6,2016-11-19,0,1,0,900,6,6,80,30,75,5,0,0,5,3,5,4,70,27,120.3,515.0
6250,3e1bd51261cb61df,4e06913c91da5200,cfb65863d5099327,2016-11-19,0,0,0,900,2,1,83,37,44,39,1,1,38,27,10,4,34,10,384.4,417.0
6251,3e1bd51261cb61df,cfb65863d5099327,4e06913c91da5200,2016-11-19,0,1,0,900,8,1,14,4,14,0,0,0,0,0,2,0,12,4,0.0,346.6
6252,30a2c7e5b90e6d74,6bd02119599741a4,9fa568ad2bf2cb0b,2016-11-19,0,1,1,415,4,0,79,13,79,0,0,0,0,0,31,15,48,13,0.0,403.5
6253,30a2c7e5b90e6d74,9fa568ad2bf2cb0b,6bd02119599741a4,2016-11-19,0,0,0,415,1,1,102,30,101,1,0,0,1,1,29,14,72,29,3.5,408.0
6254,24411c5356903d11,1536a25e16fc299b,d4a31850a7457f1b,2016-11-19,1,0,0,900,0,0,129,39,111,18,3,3,15,11,27,21,84,28,109.6,615.3
6255,24411c5356903d11,d4a31850a7457f1b,1536a25e16fc299b,2016-11-19,0,1,0,900,3,2,172,60,158,14,0,0,14,10,12,9,146,50,150.7,607.4
6256,1b52e24d09700dd9,4ba8d454f762005d,d06f8869449ba7bd,2016-11-19,0,1,1,542,0,0,80,14,79,1,0,0,1,0,13,10,66,14,11.7,470.0
6257,1b52e24d09700dd9,d06f8869449ba7bd,4ba8d454f762005d,2016-11-19,0,0,0,542,2,1,41,9,40,1,0,0,1,0,14,9,26,9,2.0,528.3
6258,13d2b7aef67cb6ea,0a1942069c9ad6b6,dbc17725b887860a,2016-11-19,0,0,0,431,0,0,49,3,49,0,0,0,0,0,28,11,21,3,0.0,429.0
6259,13d2b7aef67cb6ea,dbc17725b887860a,0a1942069c9ad6b6,2016-11-19,0,1,1,431,1,1,30,3,30,0,0,0,0,0,10,7,20,3,0.0,350.0
6260,106088694fa0c682,73e09f837f3b5ecc,c0ab242c40decc55,2016-11-19,0,0,0,831,0,0,12,3,12,0,0,0,0,0,0,0,12,3,0.0,151.0
6261,106088694fa0c682,c0ab242c40decc55,73e09f837f3b5ecc,2016-11-19,1,1,0,831,5,5,116,74,25,91,13,12,78,65,0,0,25,9,680.0,151.0
6262,02b39d683f027517,528c24b99fbaab79,cc6f9d1e89f3449a,2016-11-19,1,0,0,346,0,0,54,14,42,12,0,0,12,10,16,12,26,4,31.0,315.0
6263,02b39d683f027517,cc6f9d1e89f3449a,528c24b99fbaab79,2016-11-19,0,0,0,346,3,0,24,6,24,0,0,0,0,0,6,5,18,6,0.0,315.0
6264,f37d18b5c35145bf,3a8176e15b9887c1,f77c68bb4be8516d,2016-11-12,0,0,0,624,8,1,47,2,47,0,0,0,0,0,25,10,22,2,0.0,500.1
6265,f37d18b5c35145bf,f77c68bb4be8516d,3a8176e15b9887c1,2016-11-12,1,0,0,624,3,2,40,13,26,14,0,0,14,8,8,5,18,5,98.9,511.0
6266,c26806c2d554e50c,032cc3922d871c7f,511e82663651438d,2016-11-12,0,1,1,751,6,2,142,93,22,120,1,1,119,87,0,0,22,6,519.7,227.0
6267,c26806c2d554e50c,511e82663651438d,032cc3922d871c7f,2016-11-12,0,1,0,751,0,0,77,9,77,0,0,0,0,0,26,10,51,9,0.0,231.29999999999995
6268,b80ef7cdc36ab48b,4a28cb716c19157a,effd9de9937996f8,2016-11-12,0,0,0,1500,1,0,161,26,153,8,2,0,5,0,17,0,94,0,131.6,1170.8
6269,b80ef7cdc36ab48b,effd9de9937996f8,4a28cb716c19157a,2016-11-12,1,2,0,1500,1,1,141,42,111,30,1,0,4,0,10,0,65,0,181.2,1078.4
6270,9ebfd601c43b89b3,b96619b3acd7d9da,fc169c387b4b465d,2016-11-12,0,0,0,900,5,1,65,8,65,0,0,0,0,0,31,13,34,8,0.0,422.9
6271,9ebfd601c43b89b3,fc169c387b4b465d,b96619b3acd7d9da,2016-11-12,0,3,0,900,1,1,77,31,61,16,3,3,13,8,9,9,52,23,210.1,493.0
6272,9c4cbd0546d03f6b,18968f97ad34f15c,f2688492b9a525a3,2016-11-12,1,1,0,900,0,0,146,23,145,1,0,0,1,1,13,10,132,22,0.3,713.1
6273,9c4cbd0546d03f6b,f2688492b9a525a3,18968f97ad34f15c,2016-11-12,0,2,0,900,14,5,76,29,69,7,1,1,6,3,13,10,56,26,183.9,610.7
6274,8172d8d996335d0a,0dba4df5f34d5ff0,c80095f6092271a7,2016-11-12,0,0,0,202,1,0,18,2,18,0,0,0,0,0,5,3,13,2,0.0,198.0
6275,8172d8d996335d0a,c80095f6092271a7,0dba4df5f34d5ff0,2016-11-12,1,0,0,202,0,0,25,9,22,3,0,0,3,3,8,5,14,6,4.0,198.0
6276,706228ddb6076b3f,51a0c09cbe9b8472,e872e9a9a902c045,2016-11-12,0,0,0,900,7,4,64,6,60,4,2,2,2,2,30,19,30,4,260.6,441.3
6277,706228ddb6076b3f,e872e9a9a902c045,51a0c09cbe9b8472,2016-11-12,1,0,0,900,0,0,115,11,112,3,0,0,3,2,21,11,91,9,2.7,629.4
6278,4403857f545ede75,3d6749c4267da18f,d7c3816669784109,2016-11-12,0,0,0,1500,1,1,360,63,360,0,0,0,0,0,169,108,191,63,0.0,1291.0
6279,4403857f545ede75,d7c3816669784109,3d6749c4267da18f,2016-11-12,0,0,0,1500,1,0,220,36,220,0,0,0,0,0,32,14,188,36,0.0,1286.0
6280,1d7015553debd1c8,33a331684283900f,f4c49976c75c5ab2,2016-11-12,0,0,0,484,3,0,41,2,41,0,0,0,0,0,14,7,27,2,0.0,389.6
6281,1d7015553debd1c8,f4c49976c75c5ab2,33a331684283900f,2016-11-12,3,0,0,484,0,0,84,24,72,12,0,0,12,5,13,8,59,19,37.4,431.0
6282,14477908199435e1,6d4b63c767106d3a,b1b0729d27936f2f,2016-11-12,1,0,0,79,0,0,21,5,17,4,0,0,4,4,5,4,12,1,3.0,76.0
6283,14477908199435e1,b1b0729d27936f2f,6d4b63c767106d3a,2016-11-12,0,0,0,79,0,0,10,2,10,0,0,0,0,0,2,1,8,2,0.0,76.0
6284,e322eae035f7c00f,07225ba28ae309b6,3974fa35c917af1d,2016-11-05,0,2,0,433,2,2,18,11,11,7,0,0,7,6,2,2,9,5,169.6,68.0
6285,e322eae035f7c00f,3974fa35c917af1d,07225ba28ae309b6,2016-11-05,0,1,1,433,1,1,20,7,15,5,1,1,4,2,5,3,10,5,147.0,116.4
6286,c5a8e0098d1024ce,82e7929bf6c2b689,bf43fed8f29e1671,2016-11-05,0,0,0,900,1,0,81,31,52,29,6,5,23,20,13,10,39,11,555.0,333.0
6287,c5a8e0098d1024ce,bf43fed8f29e1671,82e7929bf6c2b689,2016-11-05,0,1,0,900,2,0,82,30,74,8,0,0,8,4,2,0,72,26,12.0,327.0
6288,c1e039419a671b9e,459e4dc69ec669b2,edd02825c29028fe,2016-11-05,0,0,0,900,3,1,126,16,123,3,0,0,3,2,19,13,104,14,64.0,683.0
6289,c1e039419a671b9e,edd02825c29028fe,459e4dc69ec669b2,2016-11-05,0,0,0,900,0,0,166,20,154,12,7,7,5,4,37,23,117,16,153.0,683.0
6290,9220acccebf14a46,22a92d7f62195791,6a2f7c151031653d,2016-11-05,0,0,0,1500,2,0,401,126,401,0,0,0,0,0,89,73,312,126,0.0,1476.0
6291,9220acccebf14a46,6a2f7c151031653d,22a92d7f62195791,2016-11-05,0,0,0,1500,5,0,276,84,272,4,0,0,4,1,53,37,219,83,24.0,1470.0
6292,52943c821416dc38,dd4c16777fb2ccf9,e8b731feff72294b,2016-11-05,0,0,0,900,4,0,87,17,87,0,0,0,0,0,28,23,59,17,0.0,743.0
6293,52943c821416dc38,e8b731feff72294b,dd4c16777fb2ccf9,2016-11-05,0,0,0,900,2,1,134,28,129,5,3,3,2,1,45,34,84,27,19.0,699.0
6294,51010081d59b4687,71002dbc1743b9a7,af62f99eb7606308,2016-11-05,0,2,0,900,0,0,68,18,64,4,0,0,4,3,20,16,44,15,77.3,370.2
6295,51010081d59b4687,af62f99eb7606308,71002dbc1743b9a7,2016-11-05,0,0,0,900,5,3,96,21,62,34,13,10,21,15,5,5,57,6,413.8,396.7
6296,4fa26e1e88583ab5,4665cbf36b08193b,be0b310a12eb80b4,2016-11-05,0,0,0,900,0,0,105,24,104,1,0,0,1,1,6,5,98,23,0.0,644.4
6297,4fa26e1e88583ab5,be0b310a12eb80b4,4665cbf36b08193b,2016-11-05,0,0,0,900,12,7,127,29,115,12,3,2,9,6,48,41,67,23,255.6,474.0
6298,43a941e005a2d463,9c44f290f5726d95,d747eb273a40a920,2016-11-05,1,0,0,415,0,0,121,40,118,3,0,0,3,2,24,16,94,38,0.9,413.0
6299,43a941e005a2d463,d747eb273a40a920,9c44f290f5726d95,2016-11-05,0,0,0,415,6,1,68,14,68,0,0,0,0,0,19,15,49,14,0.0,380.1
6300,2c39797c6574ff29,2b6d855c6e280fb1,d156513a19acf856,2016-11-05,0,0,0,900,0,0,182,51,182,0,0,0,0,0,41,31,141,51,0.0,900.0
6301,2c39797c6574ff29,d156513a19acf856,2b6d855c6e280fb1,2016-11-05,0,0,0,900,2,0,138,39,138,0,0,0,0,0,28,24,110,39,0.0,860.0
6302,29df50b2ea446361,01fcef7e3d051722,3a314d9fa7c6825d,2016-11-05,0,0,0,753,1,0,144,33,143,1,0,0,1,0,44,34,99,33,0.2,749.0
6303,29df50b2ea446361,3a314d9fa7c6825d,01fcef7e3d051722,2016-11-05,1,0,0,753,1,1,158,57,157,1,0,0,1,1,20,15,137,56,2.0,742.8
6304,23c6a428df1569bc,8163cd7de0342652,b0d6a1d8ac3d563d,2016-11-05,0,0,0,54,0,0,7,2,7,0,0,0,0,0,2,1,5,2,0.0,41.6
6305,23c6a428df1569bc,b0d6a1d8ac3d563d,8163cd7de0342652,2016-11-05,1,0,0,54,0,0,30,14,8,22,1,1,21,10,0,0,8,4,12.4,41.0
6306,00494c77d2a88f8c,08af939f41b5a57b,7ea1f74cef32f906,2016-11-05,0,0,0,900,5,0,120,20,120,0,0,0,0,0,59,40,61,20,0.0,634.5
6307,00494c77d2a88f8c,7ea1f74cef32f906,08af939f41b5a57b,2016-11-05,0,0,0,900,2,1,78,24,76,2,0,0,2,0,23,17,53,24,15.5,737.0
6308,ebc7ec239faf7b0b,0ee783aa00e468f0,232c582f29f8f65e,2016-10-08,0,0,0,463,0,0,26,5,26,0,0,0,0,0,5,3,21,5,0.0,419.4
6309,ebc7ec239faf7b0b,232c582f29f8f65e,0ee783aa00e468f0,2016-10-08,1,0,0,463,4,1,114,41,87,27,2,1,25,13,17,15,70,28,43.6,371.0
6310,eaa63c8fb9379426,1ccf4e7caff270df,2b93ebd9f5417ad2,2016-10-08,2,0,0,1500,4,1,220,46,200,20,1,1,19,7,37,34,163,39,79.2,1396.6
6311,eaa63c8fb9379426,2b93ebd9f5417ad2,1ccf4e7caff270df,2016-10-08,0,0,0,1500,0,0,335,90,331,4,0,0,4,2,42,29,289,88,0.4,1419.8
6312,87b61c1d72232a84,7dcf06c1967801c1,9c65736747ca92ec,2016-10-08,0,0,0,900,0,0,83,8,83,0,0,0,0,0,35,26,48,8,0.0,900.0
6313,87b61c1d72232a84,9c65736747ca92ec,7dcf06c1967801c1,2016-10-08,0,0,0,900,1,0,70,9,70,0,0,0,0,0,23,14,47,9,0.0,900.0
6314,8794b5f9a591daf6,32c355b04fc57f3a,fb41432b622992a9,2016-10-08,1,0,0,580,1,1,116,36,115,1,0,0,1,1,17,12,98,35,0.2,429.7
6315,8794b5f9a591daf6,fb41432b622992a9,32c355b04fc57f3a,2016-10-08,0,0,0,580,6,2,54,8,46,8,2,2,6,5,13,11,33,3,143.3,364.8
6316,85bec51d0bdf511f,a6cba6bb66c1a8c9,f2b6fdb20675b11c,2016-10-08,0,0,0,880,4,0,239,53,239,0,0,0,0,0,40,28,199,53,0.0,838.8
6317,85bec51d0bdf511f,f2b6fdb20675b11c,a6cba6bb66c1a8c9,2016-10-08,1,0,0,880,0,0,214,78,193,21,1,1,20,17,18,11,175,61,41.2,778.0
6318,47dfd70b5780d68a,f1fac969a1d70b08,ff6a1f63c254127e,2016-10-08,0,1,1,781,10,3,72,7,72,0,0,0,0,0,17,9,55,7,0.0,509.0
6319,47dfd70b5780d68a,ff6a1f63c254127e,f1fac969a1d70b08,2016-10-08,0,0,0,781,0,0,83,28,83,0,0,0,0,0,8,4,75,28,0.0,781.0
6320,451d7d8c2a6bacb3,1e1dbd1cc5a7469e,50db8711c70196cd,2016-10-08,1,1,0,458,3,0,47,12,46,1,0,0,1,0,22,20,24,12,2.0,376.5
6321,451d7d8c2a6bacb3,50db8711c70196cd,1e1dbd1cc5a7469e,2016-10-08,0,0,0,458,3,2,38,7,37,1,0,0,1,1,9,6,28,6,51.5,250.0
6322,3be121d4f5460893,113df4fde64735c6,42a7e90605df3c8a,2016-10-08,0,0,0,776,2,2,84,23,78,6,0,0,3,0,4,0,41,0,19.1,623.2
6323,3be121d4f5460893,42a7e90605df3c8a,113df4fde64735c6,2016-10-08,0,1,1,776,9,4,39,7,38,1,0,0,1,1,12,3,26,6,63.8,501.9
6324,2f9a8807807b80d6,2f95a3c6d58b2aad,c945adc22c2bfe8f,2016-10-08,1,2,1,119,0,0,39,22,22,17,0,0,17,15,6,4,16,7,27.4,90.0
6325,2f9a8807807b80d6,c945adc22c2bfe8f,2f95a3c6d58b2aad,2016-10-08,0,0,0,119,0,0,3,0,3,0,0,0,0,0,2,1,1,0,0.0,80.6
6326,23253ebb1d86d8b4,cbd3e590a85b18c5,f50d95223751e6ca,2016-10-08,0,2,1,262,6,4,10,4,10,0,0,0,0,0,0,0,10,4,0.0,61.0
6327,23253ebb1d86d8b4,f50d95223751e6ca,cbd3e590a85b18c5,2016-10-08,0,0,0,262,0,0,15,3,12,3,0,0,3,1,6,3,6,2,0.0,262.0
6328,17067cf55726c673,470fedbc8563ac47,ebc1f40e00e0c481,2016-10-08,0,0,0,401,1,0,30,6,30,0,0,0,0,0,13,8,17,6,0.0,248.5
6329,17067cf55726c673,ebc1f40e00e0c481,470fedbc8563ac47,2016-10-08,0,1,1,401,4,2,23,3,22,1,0,0,1,0,13,6,9,3,82.5,236.0
6330,ba7250ef080d1603,a8e6a69796280f17,eff47295daf721a6,2016-10-01,1,0,0,584,2,2,39,11,35,4,0,0,4,4,17,13,18,7,200.7,283.0
6331,ba7250ef080d1603,eff47295daf721a6,a8e6a69796280f17,2016-10-01,0,0,0,584,0,0,52,5,52,0,0,0,0,0,14,11,38,5,0.0,377.3
6332,b43dfe6743160a66,792be9a24df82ed6,d2bc285ead803db0,2016-10-01,0,2,1,143,1,1,11,7,5,6,0,0,6,4,1,1,4,3,83.1,29.0
6333,b43dfe6743160a66,d2bc285ead803db0,792be9a24df82ed6,2016-10-01,0,0,0,143,1,1,13,6,8,5,0,0,5,5,1,1,7,1,17.0,42.900000000000006
6334,a27a9b7b8194e8fc,2d447cc91bdaa545,b0bd0c5425668b8f,2016-10-01,1,0,0,583,0,0,124,42,106,18,2,1,16,11,8,7,98,31,84.0,370.1
6335,a27a9b7b8194e8fc,b0bd0c5425668b8f,2d447cc91bdaa545,2016-10-01,0,1,1,583,0,0,76,17,69,7,0,0,7,3,32,27,37,14,44.9,326.0
6336,98e3b4d05ecc36a2,9c42a0de8e012870,b9706f80d005036c,2016-10-01,0,0,0,900,1,0,104,26,97,7,1,0,6,3,24,18,73,23,12.6,639.0
6337,98e3b4d05ecc36a2,b9706f80d005036c,9c42a0de8e012870,2016-10-01,0,0,0,900,6,4,57,11,54,3,0,0,3,1,2,2,52,10,216.0,383.4
6338,958f6e5b79ff8c33,65ddc8a9ac4e8531,8adcbd525fab8d9b,2016-10-01,0,0,0,900,6,5,58,21,51,7,0,0,7,5,5,3,46,16,268.9,411.0
6339,958f6e5b79ff8c33,8adcbd525fab8d9b,65ddc8a9ac4e8531,2016-10-01,0,2,0,900,1,1,120,24,113,7,0,0,7,4,15,10,98,20,28.0,555.1
6340,8793208907eca67f,99506df1af6c8b3b,c268b2cfebccf652,2016-10-01,0,0,0,1500,6,0,191,56,191,0,0,0,0,0,51,45,140,56,0.0,1477.0
6341,8793208907eca67f,c268b2cfebccf652,99506df1af6c8b3b,2016-10-01,0,0,0,1500,0,0,322,47,322,0,0,0,0,0,99,46,223,47,0.0,1500.0
6342,4efbd869aa0211d2,5713c1d2fac539ac,fa6796c55d6c5440,2016-10-01,0,0,0,422,3,3,47,17,43,4,0,0,4,2,4,4,39,15,10.7,183.6
6343,4efbd869aa0211d2,fa6796c55d6c5440,5713c1d2fac539ac,2016-10-01,1,0,0,422,6,5,81,41,33,48,4,4,44,32,8,7,25,9,214.4,143.3
6344,412735f3e0b66ea6,03f982ca3735070c,2f5cbecbbe18bac4,2016-10-01,0,1,0,900,0,0,98,21,98,0,0,0,0,0,19,12,79,21,0.0,862.2
6345,412735f3e0b66ea6,2f5cbecbbe18bac4,03f982ca3735070c,2016-10-01,0,0,0,900,8,1,128,21,124,4,0,0,4,1,37,26,87,20,8.8,856.0
6346,3a8cc4cda195d758,57b10fca4f9c9a7a,b6e6c3b1dcaae0a1,2016-10-01,1,1,0,810,10,4,59,21,43,16,6,5,10,9,26,22,17,12,160.3,281.5
6347,3a8cc4cda195d758,b6e6c3b1dcaae0a1,57b10fca4f9c9a7a,2016-10-01,0,0,0,810,8,4,17,2,15,2,1,1,1,1,14,13,1,1,37.5,424.7
6348,21b361d723fcf3cd,47cd337b86b1af92,6da99156486ed6c2,2016-10-01,0,1,0,900,2,0,149,31,147,2,0,0,2,1,43,34,104,30,3.6,891.0
6349,21b361d723fcf3cd,6da99156486ed6c2,47cd337b86b1af92,2016-10-01,0,0,0,900,4,1,126,12,126,0,0,0,0,0,52,35,74,12,0.0,820.4
6350,1cca8ba792f1e1d9,cd01f0b768a32475,cd13728ae1151f46,2016-10-01,0,0,0,900,0,0,78,21,78,0,0,0,0,0,9,9,69,21,0.0,876.0
6351,1cca8ba792f1e1d9,cd13728ae1151f46,cd01f0b768a32475,2016-10-01,0,0,0,900,1,0,283,59,283,0,0,0,0,0,37,30,246,59,0.0,892.0
6352,11b369120409d2aa,8fd808923cffff82,ed209f6618c82e41,2016-10-01,1,0,0,900,2,1,124,34,87,37,7,6,30,14,10,5,77,20,126.3,501.0
6353,11b369120409d2aa,ed209f6618c82e41,8fd808923cffff82,2016-10-01,0,1,0,900,13,4,69,20,62,7,0,0,7,4,9,5,53,16,259.0,440.7
6354,fae3f395669b7285,00a3ff40c4b2cf21,84ff027394f7e470,2016-09-24,0,0,0,900,0,0,102,42,101,1,0,0,1,1,4,1,97,41,0.1,359.20000000000005
6355,fae3f395669b7285,84ff027394f7e470,00a3ff40c4b2cf21,2016-09-24,0,0,0,900,19,5,90,35,68,22,0,0,22,15,7,6,61,20,537.8,239.9
6356,c29b63d6cd2ba413,1971869b7e054261,fa37628269132d1a,2016-09-24,0,0,0,183,0,0,18,6,18,0,0,0,0,0,0,0,18,6,0.0,154.5
6357,c29b63d6cd2ba413,fa37628269132d1a,1971869b7e054261,2016-09-24,0,2,1,183,2,1,39,22,37,2,0,0,2,0,3,2,34,22,14.5,89.0
6358,845907142e023077,a8283a4f415e1eb9,e5010b1b94ca5755,2016-09-24,1,0,0,745,3,1,67,16,62,5,1,1,4,4,18,15,44,12,81.9,480.3
6359,845907142e023077,e5010b1b94ca5755,a8283a4f415e1eb9,2016-09-24,0,0,0,745,0,0,84,10,83,1,0,0,1,1,32,23,51,9,2.7,636.1
6360,6f2a4a2f769eb9e3,23024fdfc966410a,e51fcd9cd84c0b93,2016-09-24,0,0,0,900,4,1,122,24,121,1,0,0,1,1,28,22,93,23,0.0,857.5
6361,6f2a4a2f769eb9e3,e51fcd9cd84c0b93,23024fdfc966410a,2016-09-24,0,0,0,900,7,5,169,30,161,8,5,0,3,2,51,37,110,28,42.5,831.0
6362,66b8f3426f36fdf7,b9664eae2ac75262,dea070ed4a2a8281,2016-09-24,0,1,1,178,2,1,8,5,6,2,0,0,2,2,0,0,6,3,32.8,31.0
6363,66b8f3426f36fdf7,dea070ed4a2a8281,b9664eae2ac75262,2016-09-24,0,0,0,178,0,0,9,1,8,1,0,0,1,1,1,1,7,0,65.0,80.2
6364,5c5ed0416e881faf,3f7c14c7eca7195d,8349d55cdecd393a,2016-09-24,1,0,0,550,1,0,66,25,61,5,0,0,5,5,12,11,49,20,25.6,458.0
6365,5c5ed0416e881faf,8349d55cdecd393a,3f7c14c7eca7195d,2016-09-24,0,0,0,550,2,0,61,7,61,0,0,0,0,0,26,20,35,7,0.0,505.4
6366,5948876f1d80c21a,4b8fb0453a596b8e,6d4b63c767106d3a,2016-09-24,0,0,0,60,1,0,17,4,17,0,0,0,0,0,2,1,15,4,0.0,44.0
6367,5948876f1d80c21a,6d4b63c767106d3a,4b8fb0453a596b8e,2016-09-24,1,0,0,60,0,0,22,11,22,0,0,0,0,0,0,0,22,11,0.0,59.0
6368,50935ae1627fc89b,2c99576fefe53c7c,64360e618823a8e4,2016-09-24,0,0,0,900,3,3,151,27,151,0,0,0,0,0,53,37,98,27,0.0,809.0
6369,50935ae1627fc89b,64360e618823a8e4,2c99576fefe53c7c,2016-09-24,0,0,0,900,0,0,141,25,140,1,0,0,1,1,22,14,118,24,0.0,900.0
6370,39c16381a9722735,b102c26727306ab6,f53c1f4ceeed8c08,2016-09-24,0,2,0,900,3,1,34,2,33,1,0,0,1,1,7,6,26,1,274.5,262.5
6371,39c16381a9722735,f53c1f4ceeed8c08,b102c26727306ab6,2016-09-24,0,0,0,900,2,0,65,7,58,7,0,0,7,2,12,6,46,5,88.5,448.5
6372,1afa8d6ae4d8a5b2,31a13532e724ca2b,cd7763bcadb5d4c8,2016-09-24,0,1,0,900,0,0,9,2,7,2,0,0,2,2,0,0,7,0,92.0,76.0
6373,1afa8d6ae4d8a5b2,cd7763bcadb5d4c8,31a13532e724ca2b,2016-09-24,0,1,0,900,8,5,12,7,6,6,0,0,6,4,1,0,5,3,732.0,76.0
6374,0e9b7e682e0a79f1,5866fc86183a9fb8,9ccf8371fd80d45d,2016-09-24,1,2,1,837,0,0,116,41,82,34,4,2,30,15,14,12,68,26,174.6,517.8
6375,0e9b7e682e0a79f1,9ccf8371fd80d45d,5866fc86183a9fb8,2016-09-24,2,0,0,837,4,1,101,27,84,17,2,0,15,9,20,14,64,18,129.2,510.4
6376,0408a452fb5c3e14,64788ee44b062ded,94527830000ab715,2016-09-24,0,0,0,900,4,1,34,10,17,17,7,6,10,9,5,4,12,1,354.0,546.0
6377,0408a452fb5c3e14,94527830000ab715,64788ee44b062ded,2016-09-24,0,1,0,900,11,7,18,4,18,0,0,0,0,0,7,6,11,4,0.0,123.0
6378,f4cdc944e27c2cd2,65578a75fa7900e3,b1a3e0aca758b322,2016-09-17,0,0,0,101,0,0,3,0,3,0,0,0,0,0,1,1,2,0,0.0,70.0
6379,f4cdc944e27c2cd2,b1a3e0aca758b322,65578a75fa7900e3,2016-09-17,1,0,0,101,3,0,7,3,4,3,0,0,3,0,1,1,3,3,31.0,39.0
6380,c87d2569da8d4305,52e76bb4b3e852f3,cc98d857b148e33a,2016-09-17,0,1,1,886,14,7,60,24,40,20,2,2,18,16,11,6,29,8,557.3,273.0
6381,c87d2569da8d4305,cc98d857b148e33a,52e76bb4b3e852f3,2016-09-17,0,2,0,886,0,0,17,1,17,0,0,0,0,0,8,5,9,1,0.0,317.70000000000005
6382,96adba2273a13f46,544d7460b3e44393,80daefbed11ce998,2016-09-17,0,0,0,900,1,0,232,35,229,3,1,0,2,1,65,44,164,34,2.2,859.0
6383,96adba2273a13f46,80daefbed11ce998,544d7460b3e44393,2016-09-17,0,0,0,900,3,1,167,43,157,10,0,0,10,5,23,18,134,38,29.0,839.8
6384,692241119228cc82,029eaff01e6bb8f0,511e82663651438d,2016-09-17,0,0,0,95,0,0,12,4,12,0,0,0,0,0,3,2,9,4,0.0,92.0
6385,692241119228cc82,511e82663651438d,029eaff01e6bb8f0,2016-09-17,1,0,0,95,0,0,37,10,32,5,0,0,5,4,11,4,21,6,3.0,92.0
6386,4f6f7f1ad8954bb6,436f970c9ea9169c,b8aef0faf4ce9b31,2016-09-17,1,1,1,380,0,0,101,21,94,7,0,0,7,6,26,18,68,15,11.9,363.0
6387,4f6f7f1ad8954bb6,b8aef0faf4ce9b31,436f970c9ea9169c,2016-09-17,0,0,0,380,1,0,70,12,70,0,0,0,0,0,9,7,61,12,0.0,368.1
6388,4df1d3183929d021,94508d80e1f885fc,b1b0729d27936f2f,2016-09-17,0,0,0,859,0,0,149,12,149,0,0,0,0,0,72,55,77,12,0.0,665.8
6389,4df1d3183929d021,b1b0729d27936f2f,94508d80e1f885fc,2016-09-17,1,0,0,859,4,3,149,55,135,14,0,0,14,13,16,11,119,42,193.2,652.0
6390,30b33d032605c885,8163cd7de0342652,c6aee362c7a7d482,2016-09-17,0,0,0,618,8,2,41,11,35,6,1,1,5,3,15,9,20,8,125.6,283.7
6391,30b33d032605c885,c6aee362c7a7d482,8163cd7de0342652,2016-09-17,0,1,1,618,3,1,30,8,29,1,0,0,1,1,6,4,23,7,20.3,350.4
6392,187681b2843174b5,0778f94eb5d588a5,36549928f90f1d36,2016-09-17,1,0,0,900,0,0,136,26,133,3,0,0,3,0,30,18,103,26,3.2,713.5
6393,187681b2843174b5,36549928f90f1d36,0778f94eb5d588a5,2016-09-17,2,0,0,900,7,5,131,39,115,16,2,1,14,7,31,16,84,32,170.5,619.8
6394,144b0c1dd6c909f3,275aca31f61ba28c,c8097968da5e5f13,2016-09-17,0,2,0,900,4,4,19,5,14,5,5,5,0,0,2,2,12,5,536.0,120.0
6395,144b0c1dd6c909f3,c8097968da5e5f13,275aca31f61ba28c,2016-09-17,0,2,0,900,0,0,17,2,13,4,0,0,4,2,8,3,5,0,244.0,120.0
6396,0596fc5eba5c1fe0,814ff3018127e8fc,e5c9de15bb58b1c6,2016-09-17,0,0,0,900,3,0,156,43,149,7,2,1,5,3,24,14,125,40,0.0,659.9
6397,0596fc5eba5c1fe0,e5c9de15bb58b1c6,814ff3018127e8fc,2016-09-17,0,2,0,900,9,3,279,132,258,21,3,3,18,11,14,9,244,121,240.1,477.0
6398,054f1423ba7c121e,1c86754617d9813a,6e0273f9478be71e,2016-09-17,0,0,0,900,6,2,70,24,70,0,0,0,0,0,11,9,59,24,0.0,636.3
6399,054f1423ba7c121e,6e0273f9478be71e,1c86754617d9813a,2016-09-17,0,0,0,900,0,0,134,11,129,5,2,1,3,2,22,16,107,9,106.7,708.0
6400,00b7497b02b3b2bb,4a1329cc8eb0928a,4bd6b4800070b069,2016-09-17,0,0,0,19,0,0,1,0,1,0,0,0,0,0,1,0,0,0,0.0,19.0
6401,00b7497b02b3b2bb,4bd6b4800070b069,4a1329cc8eb0928a,2016-09-17,0,1,1,19,0,0,1,0,1,0,0,0,0,0,1,1,0,0,0.0,8.0
6402,e9ffcf05270a320a,673ea7dcc786b1b3,f72465a784c1b084,2016-09-10,0,0,0,900,3,0,150,32,150,0,0,0,0,0,31,17,119,32,0.0,840.0
6403,e9ffcf05270a320a,f72465a784c1b084,673ea7dcc786b1b3,2016-09-10,0,0,0,900,0,0,199,29,199,0,0,0,0,0,35,23,164,29,0.0,897.0
6404,c8ca99d1adc5448d,0c5c66ddd1886b83,0c6d9ea8306c029e,2016-09-10,0,1,0,900,7,1,81,12,81,0,0,0,0,0,29,14,52,12,0.0,727.3
6405,c8ca99d1adc5448d,0c6d9ea8306c029e,0c5c66ddd1886b83,2016-09-10,0,0,0,900,0,0,100,21,99,1,0,0,1,1,35,25,64,20,5.7,781.0
6406,9b1386a28b81bcd5,443f60bec7c3c3d5,6fb1ba67bef41b37,2016-09-10,0,0,0,557,1,0,31,10,28,3,0,0,3,2,9,6,19,8,24.0,115.30000000000001
6407,9b1386a28b81bcd5,6fb1ba67bef41b37,443f60bec7c3c3d5,2016-09-10,1,1,0,557,6,5,50,32,21,29,0,0,29,26,7,6,14,6,409.7,95.0
6408,971d9fa5947a4bb7,78114b7199cef90c,9c907996820d2d69,2016-09-10,0,0,0,900,4,0,112,11,112,0,0,0,0,0,18,11,94,11,0.0,900.0
6409,971d9fa5947a4bb7,9c907996820d2d69,78114b7199cef90c,2016-09-10,0,0,0,900,0,0,160,21,160,0,0,0,0,0,47,33,113,21,0.0,900.0
6410,5d5abb5dade718de,519e4fe37ce9ff75,e45cfa47f504033a,2016-09-10,1,0,0,105,1,0,41,14,39,2,0,0,2,1,7,6,32,13,1.8,94.0
6411,5d5abb5dade718de,e45cfa47f504033a,519e4fe37ce9ff75,2016-09-10,0,0,0,105,0,0,30,6,30,0,0,0,0,0,5,4,25,6,0.0,103.2
6412,52bc6927e80aca5d,12f91bfa8f1f723b,6a1901c62ab3870f,2016-09-10,0,0,0,278,0,0,26,3,24,2,0,0,2,1,10,10,14,2,3.4,107.19999999999999
6413,52bc6927e80aca5d,6a1901c62ab3870f,12f91bfa8f1f723b,2016-09-10,0,1,1,278,3,2,28,10,9,19,3,3,16,9,7,7,2,1,158.8,65.6
6414,409bcfacb259999a,3236bf606fe9fa5b,492b202d2064e7a9,2016-09-10,0,0,0,900,0,0,143,27,142,1,1,0,0,0,19,10,123,27,4.3,844.4
6415,409bcfacb259999a,492b202d2064e7a9,3236bf606fe9fa5b,2016-09-10,1,1,0,900,3,0,142,41,133,9,1,1,8,7,50,42,83,34,42.6,805.7
6416,26e6a2705a1e9e72,9e50097a89442158,a8c9d16fe2a14d72,2016-09-10,0,2,1,134,1,1,32,20,0,32,0,0,32,20,0,0,0,0,131.0,3.0
6417,26e6a2705a1e9e72,a8c9d16fe2a14d72,9e50097a89442158,2016-09-10,0,0,0,134,0,0,1,0,1,0,0,0,0,0,0,0,1,0,0.0,3.0
6418,1c85f793ea4f9caa,813550bc53b15fb0,ab850a77a0fa487d,2016-09-10,2,1,1,349,0,0,57,10,56,1,0,0,1,0,11,7,45,10,5.7,332.0
6419,1c85f793ea4f9caa,ab850a77a0fa487d,813550bc53b15fb0,2016-09-10,0,0,0,349,0,0,89,6,89,0,0,0,0,0,24,11,65,6,0.0,343.3
6420,19df0d0cb1269fa7,b4ad3a06ee4d660c,d28dee5c705991df,2016-09-10,1,1,0,267,0,0,17,5,17,0,0,0,0,0,7,4,10,5,0.0,247.9
6421,19df0d0cb1269fa7,d28dee5c705991df,b4ad3a06ee4d660c,2016-09-10,1,0,0,267,1,1,60,31,45,15,1,1,14,11,4,2,41,20,13.1,246.0
6422,f24144fbe9e32c10,8b1ed83b02303075,d1e1fdcea7c8a90a,2016-09-03,0,0,0,900,0,0,146,49,141,5,0,0,5,4,16,14,125,45,9.4,842.0
6423,f24144fbe9e32c10,d1e1fdcea7c8a90a,8b1ed83b02303075,2016-09-03,0,0,0,900,14,3,61,6,61,0,0,0,0,0,23,13,38,6,0.0,499.6
6424,ddb4376695f115b9,8614b7134913f5d5,9123c54d0a2b72dd,2016-09-03,0,0,0,900,5,1,98,43,92,6,0,0,0,0,5,0,41,0,48.4,676.1
6425,ddb4376695f115b9,9123c54d0a2b72dd,8614b7134913f5d5,2016-09-03,0,0,0,900,1,0,159,49,156,3,0,0,1,0,6,0,76,0,5.9,737.6
6426,d6389fa434e86916,0c670b443c3d269f,6eaec40f724852f4,2016-09-03,1,0,0,900,0,0,135,31,130,5,0,0,5,2,22,16,108,29,24.3,866.0
6427,d6389fa434e86916,6eaec40f724852f4,0c670b443c3d269f,2016-09-03,0,0,0,900,3,0,172,48,172,0,0,0,0,0,37,22,135,48,0.0,864.7
6428,d38cd293a0c3fdfd,06827d70c53ff0d9,0a1942069c9ad6b6,2016-09-03,0,2,0,900,3,0,106,8,105,1,0,0,1,1,44,29,61,7,4.6,785.7
6429,d38cd293a0c3fdfd,0a1942069c9ad6b6,06827d70c53ff0d9,2016-09-03,0,0,0,900,6,1,156,39,154,2,0,0,1,0,9,0,58,0,9.3,699.4
6430,c5c1deb1607f69b4,159da492e000afbf,9b7694d064a8a0ad,2016-09-03,0,0,0,900,2,0,83,13,82,1,0,0,1,0,26,16,56,13,2.6,718.3
6431,c5c1deb1607f69b4,9b7694d064a8a0ad,159da492e000afbf,2016-09-03,0,0,0,900,10,2,82,12,74,8,0,0,2,0,8,0,48,0,168.7,665.4
6432,bd887c173d3050bf,4798e823ada58fe9,fc6e681bf6658faf,2016-09-03,0,0,0,766,0,0,41,13,41,0,0,0,0,0,14,10,27,13,0.0,460.1
6433,bd887c173d3050bf,fc6e681bf6658faf,4798e823ada58fe9,2016-09-03,1,0,0,766,5,2,115,41,73,42,5,5,37,28,32,27,41,13,196.9,405.0
6434,a3b972117a3998ee,3738e68d2261e60f,ad3f53c454cbbead,2016-09-03,0,0,0,773,2,1,62,22,59,3,0,0,0,0,0,0,24,0,18.5,397.3
6435,a3b972117a3998ee,ad3f53c454cbbead,3738e68d2261e60f,2016-09-03,0,1,1,773,2,1,82,40,51,31,0,0,6,0,3,0,20,0,233.7,362.5
6436,69ecd4aa5a550f7b,1fcfc3709fe58151,9d19d9e4aa2662e8,2016-09-03,1,1,0,900,5,3,76,28,44,32,5,5,27,12,6,5,38,16,622.0,270.0
6437,69ecd4aa5a550f7b,9d19d9e4aa2662e8,1fcfc3709fe58151,2016-09-03,0,0,0,900,1,0,52,7,50,2,0,0,2,2,12,7,38,5,8.0,250.0
6438,5237736e6b37c609,c0ab242c40decc55,e9a3aeb207578eea,2016-09-03,1,0,0,426,1,0,34,12,34,0,0,0,0,0,3,1,31,12,0.0,416.6
6439,5237736e6b37c609,e9a3aeb207578eea,c0ab242c40decc55,2016-09-03,1,0,0,426,5,0,30,6,28,2,0,0,1,0,4,0,16,0,7.4,400.0
6440,31dd8b5d6444f19b,2816ced060a21be3,9a2d3567abc02e34,2016-09-03,0,0,0,900,5,2,76,12,76,0,0,0,0,0,21,8,55,12,0.0,892.0
6441,31dd8b5d6444f19b,9a2d3567abc02e34,2816ced060a21be3,2016-09-03,0,0,0,900,2,0,117,34,117,0,0,0,0,0,12,6,105,34,0.0,761.0
6442,0549b655619774c5,3c6976f8182d9527,99df7d0a2a08a8a8,2016-09-03,0,0,0,900,5,4,100,43,59,41,1,1,40,32,7,6,52,11,613.1,257.0
6443,0549b655619774c5,99df7d0a2a08a8a8,3c6976f8182d9527,2016-09-03,0,0,0,900,1,0,90,18,87,3,0,0,3,1,17,10,70,17,0.0,286.9
6444,f8df4cb5f22656c0,77d7295d1b22c694,f215cfbd4ba3c270,2016-08-27,1,0,0,900,6,2,136,51,119,17,0,0,17,9,14,10,105,42,68.7,714.0
6445,f8df4cb5f22656c0,f215cfbd4ba3c270,77d7295d1b22c694,2016-08-27,0,0,0,900,8,2,139,27,139,0,0,0,0,0,50,30,89,27,0.0,608.3
6446,f7114bf73eec4022,68f6e96c5fa6e044,bf9bc96336922271,2016-08-27,0,0,0,900,14,5,71,16,68,3,0,0,3,1,20,11,48,15,77.3,226.2
6447,f7114bf73eec4022,bf9bc96336922271,68f6e96c5fa6e044,2016-08-27,0,0,0,900,2,0,60,7,59,1,0,0,1,0,35,21,24,7,3.8,734.7
6448,f19d1c8ca5660240,427b5953ac8e3a27,f9f07bb5a43535ed,2016-08-27,0,1,1,112,1,1,1,1,0,1,0,0,1,1,0,0,0,0,79.0,33.0
6449,f19d1c8ca5660240,f9f07bb5a43535ed,427b5953ac8e3a27,2016-08-27,0,0,0,112,0,0,6,1,5,1,0,0,1,0,1,0,4,1,0.0,33.0
6450,e15b393a27c07043,3bad7ef643840f67,d1941565abf50b16,2016-08-27,0,1,0,900,4,3,136,46,121,15,3,3,12,9,10,5,111,37,223.2,527.1
6451,e15b393a27c07043,d1941565abf50b16,3bad7ef643840f67,2016-08-27,0,0,0,900,3,0,166,52,162,4,0,0,4,4,36,28,126,48,0.9,668.8
6452,df33799f117000cb,be0b310a12eb80b4,c5af5750e8bae4f0,2016-08-27,0,0,0,900,9,1,165,31,165,0,0,0,0,0,29,24,136,31,0.0,882.0
6453,df33799f117000cb,c5af5750e8bae4f0,be0b310a12eb80b4,2016-08-27,0,0,0,900,3,1,141,15,141,0,0,0,0,0,34,26,107,15,0.0,873.0
6454,c64537874352793a,1b38a2b897f6209c,784285b7ae7dd85f,2016-08-27,1,0,0,73,0,0,25,6,18,7,0,0,7,2,6,5,12,4,2.3,69.0
6455,c64537874352793a,784285b7ae7dd85f,1b38a2b897f6209c,2016-08-27,0,0,0,73,0,0,13,1,13,0,0,0,0,0,9,8,4,1,0.0,70.7
6456,70ab91b37be75408,8d9586726252dbf7,d156513a19acf856,2016-08-27,0,0,0,596,2,0,51,11,51,0,0,0,0,0,16,14,35,11,0.0,423.0
6457,70ab91b37be75408,d156513a19acf856,8d9586726252dbf7,2016-08-27,2,0,0,596,0,0,114,36,91,23,0,0,23,13,26,23,65,23,17.0,565.0
6458,51d3be5e8aee5cd9,07225ba28ae309b6,cbb682f5fcc44bfc,2016-08-27,0,0,0,709,11,4,86,23,75,11,1,1,10,5,28,17,47,18,142.0,226.6
6459,51d3be5e8aee5cd9,cbb682f5fcc44bfc,07225ba28ae309b6,2016-08-27,0,1,1,709,0,0,87,41,54,33,2,1,31,17,18,11,36,24,185.4,376.0
6460,0bf8bb9b4ef329f9,4d5197f331c47290,907e60fd13407e1e,2016-08-27,1,0,0,317,0,0,63,14,52,11,0,0,11,7,25,11,27,7,9.2,302.0
6461,0bf8bb9b4ef329f9,907e60fd13407e1e,4d5197f331c47290,2016-08-27,0,0,0,317,0,0,51,15,51,0,0,0,0,0,10,6,41,15,0.0,307.8
6462,00742aea8da72a35,51e86de150ee8be6,c03a5022f8439f2a,2016-08-27,0,0,0,96,0,0,16,2,16,0,0,0,0,0,2,2,14,2,0.0,76.7
6463,00742aea8da72a35,c03a5022f8439f2a,51e86de150ee8be6,2016-08-27,2,0,0,96,0,0,35,14,26,9,0,0,9,5,4,3,22,9,19.3,66.0
6464,ec381753e852cb63,4a57ebb14315b251,5f179af5fffeb9f6,2016-08-20,0,0,0,274,1,1,17,4,17,0,0,0,0,0,1,0,16,4,0.0,83.6
6465,ec381753e852cb63,5f179af5fffeb9f6,4a57ebb14315b251,2016-08-20,0,1,1,274,0,0,36,16,22,14,1,1,13,10,5,4,17,6,78.4,190.0
6466,ec067e9c9efd7aa1,84b3e7d38f2d2ec5,9450848a71d53776,2016-08-20,0,0,0,248,5,0,23,5,23,0,0,0,0,0,3,3,20,5,0.0,245.0
6467,ec067e9c9efd7aa1,9450848a71d53776,84b3e7d38f2d2ec5,2016-08-20,1,0,0,248,0,0,48,13,48,0,0,0,0,0,23,19,25,13,0.0,190.0
6468,dbc72a4092a0b296,48e093ea1f43a053,d8c7c61b176e3994,2016-08-20,0,0,0,48,0,0,9,3,9,0,0,0,0,0,2,1,7,3,0.0,41.6
6469,dbc72a4092a0b296,d8c7c61b176e3994,48e093ea1f43a053,2016-08-20,1,0,0,48,0,0,27,10,16,11,0,0,11,5,2,2,14,5,6.4,41.0
6470,d101d2ed58a7cf84,02f2a9702ba3d167,4665cbf36b08193b,2016-08-20,0,0,0,900,1,0,117,15,117,0,0,0,0,0,48,38,69,15,0.0,863.9
6471,d101d2ed58a7cf84,4665cbf36b08193b,02f2a9702ba3d167,2016-08-20,0,0,0,900,1,0,128,27,126,2,0,0,2,1,24,15,102,26,3.1,878.0
6472,c0329bd8d3b302c6,365fee2da473b177,7ff97850e8c32bda,2016-08-20,1,0,0,13,0,0,8,4,6,2,0,0,2,2,0,0,6,2,1.0,12.0
6473,c0329bd8d3b302c6,7ff97850e8c32bda,365fee2da473b177,2016-08-20,0,0,0,13,0,0,3,1,3,0,0,0,0,0,0,0,3,1,0.0,12.0
6474,a69a6da9560ed62c,4b47e71384a9522f,71f048adbfed5b49,2016-08-20,1,0,0,476,0,0,118,57,118,0,0,0,0,0,17,14,101,57,0.0,459.3
6475,a69a6da9560ed62c,71f048adbfed5b49,4b47e71384a9522f,2016-08-20,0,0,0,476,2,2,80,25,79,1,0,0,1,0,10,8,69,25,8.7,415.0
6476,781f9a642e7a9278,1d00756835ca67c9,5b5307450405abf0,2016-08-20,1,1,0,422,1,1,73,22,67,6,0,0,6,5,25,23,42,17,25.8,317.8
6477,781f9a642e7a9278,5b5307450405abf0,1d00756835ca67c9,2016-08-20,0,0,0,422,5,1,51,6,48,3,1,1,2,1,15,10,33,5,61.2,294.2
6478,70f08a4771138817,203c957eac95dd87,f2b6fdb20675b11c,2016-08-20,0,0,0,218,0,0,29,8,29,0,0,0,0,0,1,0,28,8,0.0,133.8
6479,70f08a4771138817,f2b6fdb20675b11c,203c957eac95dd87,2016-08-20,3,0,0,218,0,0,50,21,28,22,0,0,22,15,12,10,16,6,84.2,130.0
6480,6b6680338558bd46,dcbf01d605681ad1,fc169c387b4b465d,2016-08-20,0,0,0,900,5,1,34,5,34,0,0,0,0,0,15,10,19,5,0.0,419.7
6481,6b6680338558bd46,fc169c387b4b465d,dcbf01d605681ad1,2016-08-20,0,1,0,900,5,3,50,18,42,8,0,0,8,8,17,15,25,10,81.3,595.0
6482,648396cc751c730d,8355922d564b152c,f4c49976c75c5ab2,2016-08-20,0,0,0,1500,7,1,343,107,339,4,0,0,4,1,87,59,252,106,12.1,1147.2
6483,648396cc751c730d,f4c49976c75c5ab2,8355922d564b152c,2016-08-20,3,0,0,1500,1,0,286,98,285,1,0,0,1,0,74,66,211,98,2.8,1396.9
6484,41eb39f532e148d9,7acbb0972e75281a,8f2deefe8c5dfb5d,2016-08-20,0,1,1,270,1,1,14,10,4,10,0,0,10,8,0,0,4,2,26.0,32.0
6485,41eb39f532e148d9,8f2deefe8c5dfb5d,7acbb0972e75281a,2016-08-20,0,0,0,270,2,1,9,3,5,4,0,0,4,3,1,1,4,0,212.0,32.0
6486,0294253e4a5b4725,b0d6a1d8ac3d563d,dc9572dd6ec74859,2016-08-20,0,1,0,738,0,0,35,9,33,2,0,0,2,1,4,4,29,8,4.7,154.89999999999998
6487,0294253e4a5b4725,dc9572dd6ec74859,b0d6a1d8ac3d563d,2016-08-20,1,0,0,738,9,6,46,19,29,17,0,0,17,11,8,7,21,8,576.1,123.3
6488,e35d878ba90d9769,83825fad27ab3581,f797f0c57a83353e,2016-08-06,0,1,0,900,1,1,31,10,29,2,0,0,2,1,5,5,24,9,9.7,267.5
6489,e35d878ba90d9769,f797f0c57a83353e,83825fad27ab3581,2016-08-06,1,2,0,900,6,4,69,38,30,39,1,1,38,28,5,3,25,10,574.5,124.3
6490,cb76509b5c2f2a90,2747c60e42d9d75f,459e4dc69ec669b2,2016-08-06,1,0,0,385,1,0,61,10,61,0,0,0,0,0,21,16,40,10,0.0,383.0
6491,cb76509b5c2f2a90,459e4dc69ec669b2,2747c60e42d9d75f,2016-08-06,0,0,0,385,0,0,28,3,28,0,0,0,0,0,10,5,18,3,0.0,362.0
6492,787d94246afe18a3,4ba8d454f762005d,6d1bffff14897645,2016-08-06,0,0,0,900,5,1,152,23,152,0,0,0,0,0,17,12,135,23,0.0,891.0
6493,787d94246afe18a3,6d1bffff14897645,4ba8d454f762005d,2016-08-06,0,0,0,900,0,0,126,50,126,0,0,0,0,0,9,8,117,50,0.0,900.0
6494,78410b48feaba213,6c2030e0a143a94b,cfb65863d5099327,2016-08-06,0,0,0,778,0,0,15,5,14,1,0,0,1,1,3,3,11,4,11.0,371.1
6495,78410b48feaba213,cfb65863d5099327,6c2030e0a143a94b,2016-08-06,0,1,1,778,11,5,53,36,27,26,0,0,26,22,0,0,27,14,384.9,86.0
6496,58c73a9562adcfe5,b4192a975027aab6,b76c6268dc1d3c05,2016-08-06,0,0,0,900,0,0,251,13,251,0,0,0,0,0,13,4,238,13,0.0,900.0
6497,58c73a9562adcfe5,b76c6268dc1d3c05,b4192a975027aab6,2016-08-06,0,0,0,900,1,1,102,7,102,0,0,0,0,0,18,10,84,7,0.0,899.0
6498,570f3407722cc512,7aa3d6964eff4877,cbf5e6f231b55443,2016-08-06,0,0,0,1500,1,1,196,46,194,2,0,0,2,1,26,16,168,45,22.0,1380.8
6499,570f3407722cc512,cbf5e6f231b55443,7aa3d6964eff4877,2016-08-06,0,0,0,1500,2,1,338,63,323,15,2,2,13,6,69,55,254,57,20.2,1447.0
6500,537c77f3b75a75ae,80d918336163b80c,d247691a6c0e9034,2016-08-06,0,0,0,900,12,3,101,12,88,13,2,0,11,2,17,11,71,10,265.7,485.3
6501,537c77f3b75a75ae,d247691a6c0e9034,80d918336163b80c,2016-08-06,0,1,0,900,1,1,109,51,86,23,1,1,22,20,16,15,70,31,87.7,512.3
6502,4a46b63c19cfa932,523fa774700d7d3f,68c11c27d4d56572,2016-08-06,0,1,0,900,15,4,39,9,39,0,0,0,0,0,11,6,28,9,0.0,474.0
6503,4a46b63c19cfa932,68c11c27d4d56572,523fa774700d7d3f,2016-08-06,0,0,0,900,1,0,65,18,65,0,0,0,0,0,9,5,56,18,0.0,808.0
6504,3fe9e895b2a45049,202b0467521c9d6f,c9cf753cfdf77fc2,2016-08-06,0,0,0,353,2,0,42,2,42,0,0,0,0,0,1,1,41,2,0.0,324.0
6505,3fe9e895b2a45049,c9cf753cfdf77fc2,202b0467521c9d6f,2016-08-06,1,0,0,353,0,0,62,11,62,0,0,0,0,0,8,4,54,11,0.0,338.0
6506,34644c44229e41a1,88cd34d836b4ebcd,cd85b48dc880fabd,2016-08-06,1,0,0,152,1,0,25,7,19,6,0,0,6,5,8,6,11,2,6.0,146.0
6507,34644c44229e41a1,cd85b48dc880fabd,88cd34d836b4ebcd,2016-08-06,0,0,0,152,0,0,18,1,18,0,0,0,0,0,4,4,14,1,0.0,146.0
6508,0344687c9852b1d2,6f242453c91a5af0,b71ce838b01f2cad,2016-08-06,0,0,0,900,10,5,95,29,61,34,2,2,32,23,26,17,35,6,402.3,474.0
6509,0344687c9852b1d2,b71ce838b01f2cad,6f242453c91a5af0,2016-08-06,0,0,0,900,0,0,41,6,41,0,0,0,0,0,9,3,32,6,0.0,445.7
6510,02f4277726712796,01b352b6a9074d5c,ba1e6cb3d43f7430,2016-08-06,0,0,0,900,0,0,166,26,166,0,0,0,0,0,46,33,120,26,0.0,900.0
6511,02f4277726712796,ba1e6cb3d43f7430,01b352b6a9074d5c,2016-08-06,0,0,0,900,0,0,230,111,230,0,0,0,0,0,2,2,228,111,0.0,900.0
6512,c8f946610906bffe,0ccab7c889ede9ea,20999e27ddd94bda,2016-07-30,0,0,0,900,14,5,60,14,58,2,0,0,2,2,10,8,48,12,74.8,572.7
6513,c8f946610906bffe,20999e27ddd94bda,0ccab7c889ede9ea,2016-07-30,1,0,0,900,1,0,58,15,52,6,0,0,6,2,20,16,32,13,28.3,740.2
6514,c67e5fec8e1876f0,effd9de9937996f8,f2925e6db404bf1d,2016-07-30,1,0,0,132,0,0,11,7,6,5,0,0,5,5,2,1,4,2,19.0,113.0
6515,c67e5fec8e1876f0,f2925e6db404bf1d,effd9de9937996f8,2016-07-30,0,0,0,132,0,0,6,0,6,0,0,0,0,0,5,3,1,0,0.0,113.0
6516,ae6fb7829db7ecc7,06f36cf4bd97ec77,1091d4d957141094,2016-07-30,0,0,0,340,1,1,55,20,55,0,0,0,0,0,8,6,47,20,0.0,315.0
6517,ae6fb7829db7ecc7,1091d4d957141094,06f36cf4bd97ec77,2016-07-30,1,0,0,340,0,0,118,35,118,0,0,0,0,0,38,25,80,35,0.0,285.0
6518,8b61a3acdfb007d9,449c890bd90f3374,5aedf14771ca82d2,2016-07-30,0,0,0,109,0,0,13,3,13,0,0,0,0,0,2,2,11,3,0.0,102.0
6519,8b61a3acdfb007d9,5aedf14771ca82d2,449c890bd90f3374,2016-07-30,0,1,1,109,5,3,8,3,8,0,0,0,0,0,1,1,7,3,0.0,44.0
6520,855338a9a68e4c9f,3f1d23b01c552a13,fcce75a25c14a804,2016-07-30,0,0,0,900,6,3,20,4,16,4,1,1,3,2,5,4,11,2,339.2,476.0
6521,855338a9a68e4c9f,fcce75a25c14a804,3f1d23b01c552a13,2016-07-30,0,0,0,900,2,1,57,3,57,0,0,0,0,0,26,14,31,3,0.0,477.8
6522,8495283a56311b4d,3f11b5d4bd76a6d9,c727c7d31c50c4cf,2016-07-30,0,0,0,14,0,0,3,1,3,0,0,0,0,0,0,0,3,1,0.0,14.0
6523,8495283a56311b4d,c727c7d31c50c4cf,3f11b5d4bd76a6d9,2016-07-30,1,0,0,14,0,0,16,8,16,0,0,0,0,0,1,1,15,8,0.0,12.0
6524,82d057278298846f,31123249b0bbf52e,d81ac739417d7f53,2016-07-30,0,0,0,106,1,0,17,5,17,0,0,0,0,0,2,2,15,5,0.0,65.0
6525,82d057278298846f,d81ac739417d7f53,31123249b0bbf52e,2016-07-30,2,0,0,106,0,0,34,18,15,19,1,1,18,13,2,2,13,5,41.0,65.0
6526,806ee07a1a7042b8,47b9e0e7703a4868,4f732e58ed907eff,2016-07-30,1,0,0,900,1,1,256,84,231,25,2,2,23,11,35,27,196,73,25.7,864.0
6527,806ee07a1a7042b8,4f732e58ed907eff,47b9e0e7703a4868,2016-07-30,0,0,0,900,2,2,138,14,138,0,0,0,0,0,59,38,79,14,0.0,844.3
6528,7f3763caa99a3486,47b63240018d5d86,d7c3816669784109,2016-07-30,0,0,0,900,6,2,145,52,141,4,0,0,4,4,22,18,119,48,20.1,729.6
6529,7f3763caa99a3486,d7c3816669784109,47b63240018d5d86,2016-07-30,0,0,0,900,0,0,242,44,230,12,0,0,12,7,57,40,173,37,24.4,741.9
6530,3cf1d67a20ae1c18,7ea4a9f07df33a45,af62f99eb7606308,2016-07-30,0,0,0,900,0,0,158,39,156,2,0,0,2,1,20,16,136,38,0.3,708.1
6531,3cf1d67a20ae1c18,af62f99eb7606308,7ea4a9f07df33a45,2016-07-30,0,0,0,900,6,2,156,20,142,14,6,6,8,7,35,28,107,13,190.9,599.7
6532,09c092dc766fa3f9,49f78022126bf4a4,d024ed963e8bf7ea,2016-07-30,0,1,0,147,0,0,27,11,27,0,0,0,0,0,6,6,21,11,0.0,101.9
6533,09c092dc766fa3f9,d024ed963e8bf7ea,49f78022126bf4a4,2016-07-30,2,0,0,147,0,0,42,20,23,19,0,0,19,12,2,2,21,8,42.1,96.0
6534,e09d17f97d6fc6b8,d06f8869449ba7bd,f1b2aa7853d1ed6e,2016-07-23,0,0,0,900,0,0,15,1,15,0,0,0,0,0,10,7,5,1,0.0,152.0
6535,e09d17f97d6fc6b8,f1b2aa7853d1ed6e,d06f8869449ba7bd,2016-07-23,0,0,0,900,9,5,67,26,23,44,15,14,29,26,6,1,17,0,748.0,118.0
6536,b1dee00c3052e65e,64a50dad704d1d49,aa5b4eff51bdc7d1,2016-07-23,0,0,0,900,1,1,136,23,127,9,4,1,5,3,48,32,79,20,38.0,860.0
6537,b1dee00c3052e65e,aa5b4eff51bdc7d1,64a50dad704d1d49,2016-07-23,0,0,0,900,5,0,129,35,127,2,0,0,2,2,9,4,118,33,2.0,858.0
6538,adb86e0206cba97d,3ec1e4ba98c9c85a,e51fcd9cd84c0b93,2016-07-23,0,0,0,900,0,0,53,9,53,0,0,0,0,0,6,5,47,9,0.0,572.2
6539,adb86e0206cba97d,e51fcd9cd84c0b93,3ec1e4ba98c9c85a,2016-07-23,0,1,0,900,14,7,77,31,71,6,3,3,3,3,18,14,53,28,241.8,497.0
6540,9e90800495c1d607,132deb59abae64b1,634e2fb70bde3fd5,2016-07-23,0,0,0,1500,7,3,185,44,181,4,0,0,4,3,65,43,116,41,93.1,1337.0
6541,9e90800495c1d607,634e2fb70bde3fd5,132deb59abae64b1,2016-07-23,0,0,0,1500,0,0,211,20,211,0,0,0,0,0,72,34,139,20,0.0,1301.9
6542,9d2f46b677246e41,8d03ce87ca14e778,d6285cba1d1052e0,2016-07-23,1,0,0,94,0,0,20,5,7,13,1,1,12,4,2,2,5,1,5.6,88.0
6543,9d2f46b677246e41,d6285cba1d1052e0,8d03ce87ca14e778,2016-07-23,0,0,0,94,1,0,6,0,6,0,0,0,0,0,5,3,1,0,0.0,88.4
6544,8167500af262bba5,9ba2226646046b63,fc9a9559a05f2704,2016-07-23,0,0,0,714,4,1,116,27,113,3,1,1,2,1,33,17,80,26,82.0,628.7
6545,8167500af262bba5,fc9a9559a05f2704,9ba2226646046b63,2016-07-23,1,0,0,714,1,0,129,35,125,4,0,0,4,3,10,7,115,32,3.3,627.0
6546,5a09a7a3f2792d1a,05b43e0ead3df345,b6850671a008bf9a,2016-07-23,0,0,0,119,0,0,17,4,17,0,0,0,0,0,1,1,16,4,0.0,119.0
6547,5a09a7a3f2792d1a,b6850671a008bf9a,05b43e0ead3df345,2016-07-23,0,1,1,119,1,1,30,5,30,0,0,0,0,0,11,8,19,5,0.0,59.0
6548,43fbc59edc7dfa9f,75afb06215a07341,e5bda12faabfc850,2016-07-23,0,0,0,538,1,0,34,8,33,1,0,0,1,1,8,6,25,7,0.0,293.0
6549,43fbc59edc7dfa9f,e5bda12faabfc850,75afb06215a07341,2016-07-23,0,1,1,538,7,1,43,16,24,19,1,1,18,11,3,3,21,5,245.0,177.0
6550,435c93cb89016fd1,bb1a2cdad6ff34db,fe5a9547479396ab,2016-07-23,0,0,0,900,2,1,225,40,219,6,1,1,5,4,45,35,174,36,27.6,773.2
6551,435c93cb89016fd1,fe5a9547479396ab,bb1a2cdad6ff34db,2016-07-23,0,0,0,900,10,4,100,32,98,2,0,0,2,2,13,9,85,30,80.8,670.4
6552,3aace29fcc65ec51,57b10fca4f9c9a7a,c06a9b48d4132c8e,2016-07-23,0,0,0,900,8,2,78,28,33,45,20,17,25,21,13,13,20,7,463.6,220.0
6553,3aace29fcc65ec51,c06a9b48d4132c8e,57b10fca4f9c9a7a,2016-07-23,0,0,0,900,1,0,26,6,26,0,0,0,0,0,9,6,17,6,0.0,357.4
6554,1eb0491642f276ed,92a9aa9c93192871,fa37628269132d1a,2016-07-23,0,0,0,900,6,5,57,32,17,40,0,0,40,30,3,1,14,2,705.0,142.3
6555,1eb0491642f276ed,fa37628269132d1a,92a9aa9c93192871,2016-07-23,0,2,0,900,0,0,38,18,19,19,0,0,19,13,2,2,17,5,52.7,134.0
6556,ee46c069ebe691ff,729d4bd5a6cd0a97,e872e9a9a902c045,2016-07-13,0,0,0,900,4,1,143,28,137,6,0,0,6,5,14,10,123,23,205.2,558.0
6557,ee46c069ebe691ff,e872e9a9a902c045,729d4bd5a6cd0a97,2016-07-13,0,0,0,900,1,0,139,27,139,0,0,0,0,0,25,18,114,27,0.0,687.8
6558,df661c70c40adf84,2fc7e9701642ca38,94527830000ab715,2016-07-13,0,2,0,859,1,1,34,7,33,1,0,0,1,1,7,7,26,6,62.5,316.7
6559,df661c70c40adf84,94527830000ab715,2fc7e9701642ca38,2016-07-13,0,1,1,859,6,3,75,28,55,20,0,0,20,14,14,12,41,14,417.3,337.5
6560,bb0770ead53940f5,65ddc8a9ac4e8531,7339d340aa2889cb,2016-07-13,1,1,1,599,2,0,113,33,95,18,2,1,16,8,12,7,83,25,30.3,556.0
6561,bb0770ead53940f5,7339d340aa2889cb,65ddc8a9ac4e8531,2016-07-13,0,0,0,599,2,2,77,19,76,1,0,0,1,1,30,25,46,18,11.0,535.7
6562,a2fe63d064567d14,840d2c82ea68b9aa,d2bc285ead803db0,2016-07-13,0,1,0,581,0,0,8,2,7,1,0,0,1,1,2,2,5,1,54.5,49.0
6563,a2fe63d064567d14,d2bc285ead803db0,840d2c82ea68b9aa,2016-07-13,1,7,0,581,6,3,113,75,5,108,6,6,102,73,1,1,4,2,423.0,103.5
6564,824fb74f5fc34218,22a92d7f62195791,f9b200db02b488d9,2016-07-13,0,3,1,442,0,0,119,42,119,0,0,0,0,0,27,24,92,42,0.0,402.0
6565,824fb74f5fc34218,f9b200db02b488d9,22a92d7f62195791,2016-07-13,1,0,0,442,2,0,110,26,102,8,0,0,8,4,28,14,74,22,40.0,372.0
6566,5b6451f3f83c719c,5904b0b38dc6718d,df1eb4354d18a906,2016-07-13,0,0,0,900,9,1,93,24,87,6,0,0,6,4,5,4,82,20,70.7,484.8
6567,5b6451f3f83c719c,df1eb4354d18a906,5904b0b38dc6718d,2016-07-13,1,1,0,900,3,3,99,34,83,16,2,2,14,10,19,17,64,24,203.2,448.3
6568,2ef96a4eb306fbb4,b9664eae2ac75262,d156513a19acf856,2016-07-13,0,0,0,163,4,0,9,4,9,0,0,0,0,0,4,3,5,4,0.0,85.0
6569,2ef96a4eb306fbb4,d156513a19acf856,b9664eae2ac75262,2016-07-13,0,1,1,163,0,0,15,6,14,1,0,0,1,0,2,2,12,6,4.0,143.0
6570,2d205cc1da2e7930,175852708cb55776,5f179af5fffeb9f6,2016-07-13,0,0,0,156,0,0,12,2,12,0,0,0,0,0,4,3,8,2,0.0,98.0
6571,2d205cc1da2e7930,5f179af5fffeb9f6,175852708cb55776,2016-07-13,1,0,0,156,2,2,28,18,10,18,0,0,18,16,2,1,8,2,58.0,98.0
6572,0fed8d8499eae01a,470fedbc8563ac47,98c23cb6da5b3352,2016-07-13,0,0,0,900,1,1,37,22,22,15,1,1,14,13,4,3,18,9,177.8,162.60000000000002
6573,0fed8d8499eae01a,98c23cb6da5b3352,470fedbc8563ac47,2016-07-13,0,2,0,900,7,4,28,6,20,8,0,0,8,5,3,2,17,1,500.4,159.2
6574,0f73ee9121ec7539,9deff9e3e8d94d47,c80095f6092271a7,2016-07-13,0,0,0,529,3,0,39,7,39,0,0,0,0,0,16,10,23,7,0.0,209.4
6575,0f73ee9121ec7539,c80095f6092271a7,9deff9e3e8d94d47,2016-07-13,1,0,0,529,2,2,58,28,27,31,1,1,30,23,11,9,16,5,192.6,268.0
6576,08c6b88ac22717ed,c268b2cfebccf652,d0314416a7f26527,2016-07-13,2,0,0,163,0,0,55,18,47,8,1,1,7,5,11,7,36,13,3.8,155.0
6577,08c6b88ac22717ed,d0314416a7f26527,c268b2cfebccf652,2016-07-13,0,0,0,163,0,0,30,13,30,0,0,0,0,0,1,1,29,13,0.0,159.2
6578,0864112e968630ea,2b6d855c6e280fb1,cc7040fe76f0ef91,2016-07-13,1,0,0,297,0,0,31,6,28,3,0,0,3,3,13,12,15,3,0.4,213.5
6579,0864112e968630ea,cc7040fe76f0ef91,2b6d855c6e280fb1,2016-07-13,1,1,0,297,1,1,20,7,16,4,2,2,2,1,5,5,11,6,82.5,131.6
6580,d1aaef0d7f0c8e8b,23a6e307077c6ccc,ed9d8ee3a4239b1c,2016-07-09,0,2,0,900,10,4,36,12,34,2,0,0,2,2,4,4,30,10,178.8,325.0
6581,d1aaef0d7f0c8e8b,ed9d8ee3a4239b1c,23a6e307077c6ccc,2016-07-09,0,1,0,900,2,0,66,36,50,16,1,1,15,13,6,4,44,23,128.0,457.2
6582,c1f74805a4ff9396,2f13e4020cea5b38,c849740a3ff51931,2016-07-09,0,0,0,900,2,0,140,25,140,0,0,0,0,0,39,24,101,25,0.0,888.2
6583,c1f74805a4ff9396,c849740a3ff51931,2f13e4020cea5b38,2016-07-09,0,0,0,900,5,1,195,33,194,1,0,0,1,1,43,31,151,32,9.8,851.0
6584,9d7a798f0c20c04a,3bad7ef643840f67,82e7929bf6c2b689,2016-07-09,1,0,0,86,0,0,33,22,29,4,0,0,4,2,0,0,29,20,3.0,69.0
6585,9d7a798f0c20c04a,82e7929bf6c2b689,3bad7ef643840f67,2016-07-09,0,0,0,86,0,0,10,3,10,0,0,0,0,0,3,3,7,3,0.0,83.0
6586,96c93167c982c467,3253b16d38ae087d,3ecd936bd8814108,2016-07-09,0,1,0,900,3,2,21,8,10,11,3,3,8,6,1,1,9,2,229.4,211.60000000000002
6587,96c93167c982c467,3ecd936bd8814108,3253b16d38ae087d,2016-07-09,0,0,0,900,4,3,23,6,15,8,1,1,7,5,4,4,11,1,396.4,125.6
6588,8c2e4d3cc4b9e93a,0941df56f6ac954b,8c0580d4fff106c1,2016-07-09,0,0,0,900,5,1,157,51,157,0,0,0,0,0,23,19,134,51,0.0,771.0
6589,8c2e4d3cc4b9e93a,8c0580d4fff106c1,0941df56f6ac954b,2016-07-09,0,0,0,900,1,0,249,89,249,0,0,0,0,0,38,35,211,89,0.0,879.0
6590,84c5035830ebb421,d0f3959b4a9747e6,f2688492b9a525a3,2016-07-09,0,0,0,1500,0,0,192,68,192,0,0,0,0,0,18,12,174,68,0.0,1429.0
6591,84c5035830ebb421,f2688492b9a525a3,d0f3959b4a9747e6,2016-07-09,0,0,0,1500,11,0,264,42,264,0,0,0,0,0,51,37,213,42,0.0,1500.0
6592,83414cc83ec3f2ac,513c6f1715e547a8,eef9b891edbd4604,2016-07-09,0,0,0,900,8,4,75,47,21,54,1,1,53,42,3,3,18,5,478.1,413.0
6593,83414cc83ec3f2ac,eef9b891edbd4604,513c6f1715e547a8,2016-07-09,0,0,0,900,0,0,32,12,30,2,0,0,2,2,1,1,29,10,0.0,421.9
6594,7679c5ee3514e119,232c582f29f8f65e,dea070ed4a2a8281,2016-07-09,1,0,0,272,2,2,34,16,23,11,1,1,10,9,5,4,18,7,94.6,143.0
6595,7679c5ee3514e119,dea070ed4a2a8281,232c582f29f8f65e,2016-07-09,0,0,0,272,0,0,13,3,12,1,0,0,1,1,6,2,6,2,0.0,177.4
6596,433e3fd8782b6e0e,3be081c29bf734d9,d1941565abf50b16,2016-07-09,0,0,0,138,0,0,5,0,5,0,0,0,0,0,1,1,4,0,0.0,45.0
6597,433e3fd8782b6e0e,d1941565abf50b16,3be081c29bf734d9,2016-07-09,1,0,0,138,1,1,26,8,8,18,0,0,18,7,0,0,8,1,93.0,45.0
6598,424221c96ee13ceb,1f454354805b6f75,d967f0128c323de6,2016-07-09,0,0,0,900,0,0,43,9,43,0,0,0,0,0,13,8,30,9,0.0,267.0
6599,424221c96ee13ceb,d967f0128c323de6,1f454354805b6f75,2016-07-09,0,0,0,900,3,3,64,27,38,26,1,1,25,17,7,5,31,10,633.0,267.0
6600,1a66e67add5d55ef,0ff11cc094e887bc,3236bf606fe9fa5b,2016-07-09,1,0,0,297,3,1,79,35,57,22,0,0,22,17,16,15,41,18,114.4,141.0
6601,1a66e67add5d55ef,3236bf606fe9fa5b,0ff11cc094e887bc,2016-07-09,0,0,0,297,0,0,27,5,27,0,0,0,0,0,1,1,26,5,0.0,182.6
6602,135760b07e1fb79b,80fa8218c99f9c58,b96619b3acd7d9da,2016-07-09,0,1,1,196,0,0,63,35,55,8,0,0,8,7,9,5,46,28,16.6,169.0
6603,135760b07e1fb79b,b96619b3acd7d9da,80fa8218c99f9c58,2016-07-09,0,0,0,196,5,0,15,2,15,0,0,0,0,0,3,1,12,2,0.0,179.4
6604,febbd4eb209b4579,8a59d346dc976a10,e93b04e308913c2e,2016-07-08,0,0,0,162,2,2,5,0,5,0,0,0,0,0,3,2,2,0,0.0,27.0
6605,febbd4eb209b4579,e93b04e308913c2e,8a59d346dc976a10,2016-07-08,1,0,0,162,0,0,7,4,6,1,0,0,1,1,0,0,6,3,17.0,145.0
6606,f990e8b2a08053db,30ea504870f8597b,9ab9912e0f8fa6d6,2016-07-08,0,0,0,900,2,0,107,47,85,22,2,1,20,14,16,13,69,33,312.0,430.8
6607,f990e8b2a08053db,9ab9912e0f8fa6d6,30ea504870f8597b,2016-07-08,0,0,0,900,2,0,118,23,117,1,0,0,1,0,35,24,82,23,1.2,570.0
6608,f8b9b5ee3d4a8ac3,b08012bbe542592a,d4a31850a7457f1b,2016-07-08,0,1,1,223,3,3,19,15,2,17,0,0,17,15,1,1,1,0,178.0,45.0
6609,f8b9b5ee3d4a8ac3,d4a31850a7457f1b,b08012bbe542592a,2016-07-08,0,2,0,223,0,0,4,1,4,0,0,0,0,0,0,0,4,1,0.0,19.0
6610,b3b5bd50fa34342c,8c822811eedc11ad,e64b96c07d7ce999,2016-07-08,0,0,0,166,2,2,9,1,9,0,0,0,0,0,4,4,5,1,0.0,65.0
6611,b3b5bd50fa34342c,e64b96c07d7ce999,8c822811eedc11ad,2016-07-08,1,0,0,166,1,1,15,5,10,5,0,0,5,5,2,1,8,0,20.0,146.0
6612,b319a24919106555,a845f0735bc67405,ee9ebceabfd16fa7,2016-07-08,0,0,0,246,0,0,13,4,13,0,0,0,0,0,2,1,11,4,0.0,105.5
6613,b319a24919106555,ee9ebceabfd16fa7,a845f0735bc67405,2016-07-08,1,0,0,246,2,1,38,21,9,29,0,0,29,20,3,3,6,1,140.5,91.0
6614,9fc85aef42733a16,749f572d1d3161fb,fccf811c1e8b01c7,2016-07-08,0,0,0,900,0,0,27,13,21,6,0,0,6,6,2,1,19,7,0.0,178.0
6615,9fc85aef42733a16,fccf811c1e8b01c7,749f572d1d3161fb,2016-07-08,0,0,0,900,12,6,43,23,18,25,3,3,22,18,7,5,11,5,722.0,178.0
6616,9275134accfb1adc,1a31ef98efce7a79,92437c6775b3f7d1,2016-07-08,0,0,0,900,1,0,85,13,85,0,0,0,0,0,39,28,46,13,0.0,857.0
6617,9275134accfb1adc,92437c6775b3f7d1,1a31ef98efce7a79,2016-07-08,0,0,0,900,2,0,113,19,113,0,0,0,0,0,18,12,95,19,0.0,900.0
6618,6c4b3cca92fcb9c7,66ab58d0b3783607,ae7fe94f117f98cf,2016-07-08,0,0,0,34,0,0,3,1,3,0,0,0,0,0,1,1,2,1,0.0,31.0
6619,6c4b3cca92fcb9c7,ae7fe94f117f98cf,66ab58d0b3783607,2016-07-08,1,0,0,34,1,0,8,6,3,5,0,0,5,5,0,0,3,1,3.0,31.0
6620,6ab9d2d334f613c8,3d6749c4267da18f,ec34349e7dffcde7,2016-07-08,0,0,0,1500,2,1,330,112,328,2,1,1,1,1,73,63,255,111,4.7,1194.9
6621,6ab9d2d334f613c8,ec34349e7dffcde7,3d6749c4267da18f,2016-07-08,1,0,0,1500,13,4,150,57,141,9,1,1,8,6,13,5,128,51,214.1,924.3
6622,36388dce4a8cc18f,7d96bc577e5178b2,b8c0f30ee9a98b69,2016-07-08,0,1,0,900,7,3,71,18,60,11,3,3,8,5,10,9,50,13,147.0,499.0
6623,36388dce4a8cc18f,b8c0f30ee9a98b69,7d96bc577e5178b2,2016-07-08,0,1,0,900,7,2,101,26,101,0,0,0,0,0,16,6,85,26,0.0,605.0
6624,1299f04f429bcc0e,4f732e58ed907eff,b6e6c3b1dcaae0a1,2016-07-08,0,0,0,900,2,0,115,15,114,1,0,0,1,0,50,39,64,15,4.5,735.8
6625,1299f04f429bcc0e,b6e6c3b1dcaae0a1,4f732e58ed907eff,2016-07-08,0,0,0,900,6,1,150,36,144,6,1,1,5,4,50,43,94,32,37.2,622.5
6626,0c703bf17c04fee4,d4c9dcd330403612,dbc17725b887860a,2016-07-08,0,1,0,900,0,0,63,22,61,2,0,0,2,1,18,11,43,21,0.7,429.0
6627,0c703bf17c04fee4,dbc17725b887860a,d4c9dcd330403612,2016-07-08,0,0,0,900,6,6,51,17,42,9,2,1,7,5,14,12,28,12,468.0,379.3
6628,e71a155192ff2f6c,23024fdfc966410a,fb41432b622992a9,2016-07-07,0,1,1,297,5,1,30,8,26,4,0,0,4,3,7,5,19,5,36.0,216.0
6629,e71a155192ff2f6c,fb41432b622992a9,23024fdfc966410a,2016-07-07,0,0,0,297,1,0,30,8,30,0,0,0,0,0,9,6,21,8,0.0,214.0
6630,d39010c3511fb972,654ae722109a0d31,c76ec2bc3a57666a,2016-07-07,1,1,1,25,0,0,7,3,2,5,0,0,5,2,0,0,2,1,15.0,10.0
6631,d39010c3511fb972,c76ec2bc3a57666a,654ae722109a0d31,2016-07-07,0,0,0,25,0,0,4,0,4,0,0,0,0,0,2,1,2,0,0.0,10.0
6632,d18b33bdd37f4683,4b1d46a1b5c0fd11,f5990c11974d8e9c,2016-07-07,1,0,0,377,2,2,43,12,24,19,2,2,17,7,5,2,19,5,176.0,201.0
6633,d18b33bdd37f4683,f5990c11974d8e9c,4b1d46a1b5c0fd11,2016-07-07,0,1,0,377,0,0,12,0,12,0,0,0,0,0,3,2,9,0,0.0,201.0
6634,caf3ca7fc0195412,6d4b63c767106d3a,74d35fbc9c6a61bd,2016-07-07,0,1,1,532,5,4,54,14,34,20,0,0,20,10,16,11,18,4,288.7,200.0
6635,caf3ca7fc0195412,74d35fbc9c6a61bd,6d4b63c767106d3a,2016-07-07,0,0,0,532,0,0,26,8,26,0,0,0,0,0,5,4,21,8,0.0,243.3
6636,bb9020ac324fb706,33a331684283900f,6a2f7c151031653d,2016-07-07,1,0,0,229,3,1,78,34,75,3,0,0,3,3,11,11,64,31,1.8,209.0
6637,bb9020ac324fb706,6a2f7c151031653d,33a331684283900f,2016-07-07,0,0,0,229,1,0,41,9,41,0,0,0,0,0,3,3,38,9,0.0,205.2
6638,a815119606930378,6bd02119599741a4,f50d95223751e6ca,2016-07-07,0,1,1,128,2,1,25,8,25,0,0,0,0,0,9,6,16,8,0.0,108.0
6639,a815119606930378,f50d95223751e6ca,6bd02119599741a4,2016-07-07,0,0,0,128,0,0,41,11,41,0,0,0,0,0,11,7,30,11,0.0,120.0
6640,9a984ea967886979,3f7c14c7eca7195d,d3df1add9d9a7efb,2016-07-07,0,0,0,900,10,7,19,3,18,1,0,0,1,0,1,1,17,3,145.2,319.0
6641,9a984ea967886979,d3df1add9d9a7efb,3f7c14c7eca7195d,2016-07-07,0,0,0,900,0,0,73,25,73,0,0,0,0,0,13,12,60,25,0.0,752.8
6642,95a0d706e1f4cfa2,8270c00fae24c922,c5a126ace82a6025,2016-07-07,0,0,0,900,12,2,87,22,87,0,0,0,0,0,13,3,74,22,0.0,563.1
6643,95a0d706e1f4cfa2,c5a126ace82a6025,8270c00fae24c922,2016-07-07,0,0,0,900,0,0,112,16,107,5,2,2,3,0,36,23,71,16,26.9,760.0
6644,5e13fbe15c887a33,c21a036b4e012f1c,e4d2564ea0e34e2b,2016-07-07,0,0,0,900,1,0,152,31,146,6,0,0,6,2,67,53,79,29,39.4,793.1
6645,5e13fbe15c887a33,e4d2564ea0e34e2b,c21a036b4e012f1c,2016-07-07,1,0,0,900,1,0,193,32,190,3,1,1,2,2,41,27,149,30,1.9,853.6
6646,5cf03fdfe557803f,ec71a892fada28c7,f9081770e28ea2e1,2016-07-07,1,1,1,484,0,0,48,15,44,4,0,0,4,2,8,5,36,13,5.3,364.9
6647,5cf03fdfe557803f,f9081770e28ea2e1,ec71a892fada28c7,2016-07-07,0,0,0,484,4,3,56,10,50,6,2,1,4,3,11,9,39,7,95.1,272.7
6648,509519d82e906c0f,12f1b140e248bdb9,71002dbc1743b9a7,2016-07-07,0,0,0,399,3,1,10,6,1,9,0,0,9,6,0,0,1,0,298.0,64.0
6649,509519d82e906c0f,71002dbc1743b9a7,12f1b140e248bdb9,2016-07-07,0,1,1,399,0,0,9,1,8,1,0,0,1,0,3,2,5,1,37.0,64.0
6650,420f4e4dc341eb57,b1b0729d27936f2f,cf65d56b0755ed3b,2016-07-07,0,0,0,900,8,2,199,71,194,5,0,0,5,3,9,6,185,68,63.9,641.6
6651,420f4e4dc341eb57,cf65d56b0755ed3b,b1b0729d27936f2f,2016-07-07,3,0,0,900,0,0,169,46,142,27,1,1,26,15,48,39,94,31,79.4,739.1
6652,fe6da751f2a4859a,12f91bfa8f1f723b,46a2f24feb258ae0,2016-06-18,2,0,0,764,6,3,208,58,191,17,1,1,16,8,80,56,111,50,136.0,503.8
6653,fe6da751f2a4859a,46a2f24feb258ae0,12f91bfa8f1f723b,2016-06-18,0,0,0,764,0,0,143,50,140,3,1,1,2,2,35,29,105,48,4.2,593.0
6654,f8b32aeb9b628d89,3dd92ff9fb0412b3,c169545ab0825f44,2016-06-18,0,0,0,900,8,5,124,49,59,65,16,13,49,39,30,28,29,10,484.6,365.0
6655,f8b32aeb9b628d89,c169545ab0825f44,3dd92ff9fb0412b3,2016-06-18,0,2,0,900,2,1,25,13,18,7,0,0,7,7,0,0,18,6,28.0,359.4
6656,c69c5830064fd591,51e86de150ee8be6,55ee431411ccf07a,2016-06-18,0,0,0,748,0,0,69,24,57,12,0,0,12,11,7,5,50,13,15.4,319.4
6657,c69c5830064fd591,55ee431411ccf07a,51e86de150ee8be6,2016-06-18,0,1,1,748,8,3,61,38,38,23,1,1,22,20,5,5,33,18,401.6,278.6
6658,b2039609019496d9,34f88592c0ab7a54,d156513a19acf856,2016-06-18,0,0,0,900,4,0,141,8,141,0,0,0,0,0,93,29,48,8,0.0,802.0
6659,b2039609019496d9,d156513a19acf856,34f88592c0ab7a54,2016-06-18,0,0,0,900,0,0,43,5,43,0,0,0,0,0,24,19,19,5,0.0,806.0
6660,afd53c8033f6ee82,1a98c9dbb7fc3959,4a57ebb14315b251,2016-06-18,0,0,0,900,1,1,235,60,235,0,0,0,0,0,27,19,208,60,0.0,744.9
6661,afd53c8033f6ee82,4a57ebb14315b251,1a98c9dbb7fc3959,2016-06-18,0,1,0,900,6,1,243,77,232,11,0,0,11,8,15,9,217,69,45.1,781.0
6662,ad61d042c43451a8,cb52f9490c2dc069,e023fa2e648ea0f1,2016-06-18,1,0,0,900,3,0,167,63,150,17,2,1,15,8,22,20,128,55,102.0,599.0
6663,ad61d042c43451a8,e023fa2e648ea0f1,cb52f9490c2dc069,2016-06-18,0,0,0,900,3,1,172,76,135,37,1,0,36,22,21,17,114,54,109.0,636.0
6664,911e151d1907197d,67f272324a030d00,cd13728ae1151f46,2016-06-18,0,1,1,682,3,1,94,36,94,0,0,0,0,0,16,8,78,36,0.0,607.2
6665,911e151d1907197d,cd13728ae1151f46,67f272324a030d00,2016-06-18,0,0,0,682,1,0,115,12,114,1,0,0,1,1,22,12,92,11,1.8,673.0
6666,75e21e2f5f3be42e,4a28cb716c19157a,cbd5d3cdd862e90e,2016-06-18,0,0,0,1500,0,0,259,71,254,5,0,0,5,5,51,39,203,66,31.8,1390.1
6667,75e21e2f5f3be42e,cbd5d3cdd862e90e,4a28cb716c19157a,2016-06-18,0,0,0,1500,2,0,152,50,148,4,0,0,4,3,15,11,133,47,1.9,1460.2
6668,68a93f8eb34f3251,4e06913c91da5200,eff47295daf721a6,2016-06-18,1,0,0,59,0,0,10,4,8,2,0,0,2,2,2,0,6,2,1.0,58.0
6669,68a93f8eb34f3251,eff47295daf721a6,4e06913c91da5200,2016-06-18,0,0,0,59,0,0,6,1,6,0,0,0,0,0,1,1,5,1,0.0,58.0
6670,4cf7792aef993be1,55f446032177b119,a4e85a58fbce64b2,2016-06-18,0,0,0,819,0,0,209,68,209,0,0,0,0,0,12,8,197,68,0.0,680.0
6671,4cf7792aef993be1,a4e85a58fbce64b2,55f446032177b119,2016-06-18,0,2,1,819,7,1,136,37,131,5,3,3,2,2,14,7,117,35,128.0,691.0
6672,4b8c8ae61251ff83,1d00756835ca67c9,9fa3bd637edd9aa2,2016-06-18,3,1,0,755,3,2,119,42,99,20,4,4,16,13,32,27,67,29,171.5,472.0
6673,4b8c8ae61251ff83,9fa3bd637edd9aa2,1d00756835ca67c9,2016-06-18,0,0,0,755,2,0,93,17,93,0,0,0,0,0,39,29,54,17,0.0,583.5
6674,315b6e91a0239148,5823ceab56741617,dc9572dd6ec74859,2016-06-18,0,0,0,654,0,0,23,10,10,13,2,2,11,8,5,4,5,2,0.0,105.0
6675,315b6e91a0239148,dc9572dd6ec74859,5823ceab56741617,2016-06-18,1,1,1,654,9,5,34,17,7,27,0,0,27,16,3,2,4,1,549.0,105.0
6676,2e11087e1a4f066b,159da492e000afbf,4ac1ecf8ce59ef23,2016-06-18,0,0,0,900,3,2,99,31,90,9,0,0,9,5,22,16,68,26,54.8,654.7
6677,2e11087e1a4f066b,4ac1ecf8ce59ef23,159da492e000afbf,2016-06-18,0,0,0,900,2,1,132,29,120,12,2,2,10,9,36,17,84,20,172.3,644.2
6678,e86a77b69d50a834,029eaff01e6bb8f0,887961364be5ceb3,2016-06-04,2,0,0,173,0,0,66,31,60,6,0,0,6,5,8,5,52,26,4.8,157.0
6679,e86a77b69d50a834,887961364be5ceb3,029eaff01e6bb8f0,2016-06-04,0,0,0,173,0,0,35,13,35,0,0,0,0,0,6,3,29,13,0.0,168.2
6680,e640fd983577d349,28c55b4087a6f136,8d9586726252dbf7,2016-06-04,0,0,0,900,0,0,121,29,110,11,0,0,11,6,39,35,71,23,12.5,597.0
6681,e640fd983577d349,8d9586726252dbf7,28c55b4087a6f136,2016-06-04,0,0,0,900,6,2,83,33,58,25,8,7,17,15,19,19,39,18,245.0,544.5
6682,e06f96f3484ad74a,6a1901c62ab3870f,c742287ed86a09bc,2016-06-04,1,0,0,476,0,0,205,90,205,0,0,0,0,0,34,27,171,90,0.0,444.0
6683,e06f96f3484ad74a,c742287ed86a09bc,6a1901c62ab3870f,2016-06-04,0,0,0,476,6,0,91,17,91,0,0,0,0,0,24,10,67,17,0.0,476.0
6684,db1be0ca226d3a2f,c47df9303d318c67,def8166ff24bd237,2016-06-04,1,0,0,880,6,0,192,42,192,0,0,0,0,0,28,20,164,42,0.0,847.0
6685,db1be0ca226d3a2f,def8166ff24bd237,c47df9303d318c67,2016-06-04,1,0,0,880,0,0,189,52,188,1,0,0,1,1,14,10,174,51,1.0,876.0
6686,c33cc8b85b9a202c,1ccf4e7caff270df,db1f2ed63b54b9a7,2016-06-04,1,0,0,387,0,0,31,9,29,2,0,0,2,2,6,4,23,7,0.8,334.0
6687,c33cc8b85b9a202c,db1f2ed63b54b9a7,1ccf4e7caff270df,2016-06-04,1,2,0,387,2,2,41,22,35,6,0,0,6,4,3,1,32,18,51.0,250.2
6688,9c884cbc3791bf60,10f3ba6cd2f44a97,78114b7199cef90c,2016-06-04,1,0,0,1500,7,3,261,62,253,8,0,0,8,4,38,25,215,58,91.6,1291.2
6689,9c884cbc3791bf60,78114b7199cef90c,10f3ba6cd2f44a97,2016-06-04,0,0,0,1500,6,1,159,26,156,3,0,0,3,3,17,8,139,23,2.8,1397.4
6690,812ff38f0ed409ca,00e11b5c8b7bfeeb,2b93ebd9f5417ad2,2016-06-04,0,0,0,216,0,0,37,6,37,0,0,0,0,0,13,11,24,6,0.0,213.8
6691,812ff38f0ed409ca,2b93ebd9f5417ad2,00e11b5c8b7bfeeb,2016-06-04,2,0,0,216,0,0,50,14,47,3,0,0,3,3,7,7,40,11,2.2,213.0
6692,5e794b8ef52c88cb,b0bd0c5425668b8f,cd01f0b768a32475,2016-06-04,1,0,0,551,0,0,136,55,101,35,6,5,29,26,29,21,72,29,43.0,436.1
6693,5e794b8ef52c88cb,cd01f0b768a32475,b0bd0c5425668b8f,2016-06-04,1,0,0,551,1,1,97,53,90,7,0,0,7,6,15,13,75,47,23.9,426.0
6694,5b55a8e33199d71e,282fa667ff9c51ed,7aa3d6964eff4877,2016-06-04,0,1,0,900,3,3,127,24,124,3,0,0,3,2,16,9,108,22,91.2,664.5
6695,5b55a8e33199d71e,7aa3d6964eff4877,282fa667ff9c51ed,2016-06-04,1,0,0,900,5,5,156,65,144,12,1,1,11,9,35,31,109,56,83.5,627.8
6696,3e020d62796a7ce3,0d8011111be000b2,1588b787bda7b540,2016-06-04,0,0,0,900,2,0,207,51,201,6,0,0,6,4,26,22,175,47,9.0,882.0
6697,3e020d62796a7ce3,1588b787bda7b540,0d8011111be000b2,2016-06-04,0,0,0,900,3,0,153,33,153,0,0,0,0,0,44,29,109,33,0.0,880.0
6698,345b1bc51f0f5e86,150ff4cc642270b9,3974fa35c917af1d,2016-06-04,0,2,0,900,0,0,205,80,194,11,1,1,10,9,25,22,169,71,44.9,796.4
6699,345b1bc51f0f5e86,3974fa35c917af1d,150ff4cc642270b9,2016-06-04,0,0,0,900,6,0,135,35,134,1,0,0,1,1,32,29,102,34,5.6,810.1
6700,2c65d5d20cc893e4,08af939f41b5a57b,6256b2b1562cb8e1,2016-06-04,2,0,0,256,2,0,70,33,43,27,0,0,27,19,14,13,29,14,50.2,176.0
6701,2c65d5d20cc893e4,6256b2b1562cb8e1,08af939f41b5a57b,2016-06-04,0,0,0,256,0,0,30,5,30,0,0,0,0,0,13,4,17,5,0.0,177.8
6702,1cbb930fb77a3781,98a6b2361045898f,edd02825c29028fe,2016-06-04,0,0,0,712,3,2,197,76,197,0,0,0,0,0,10,7,187,76,0.0,586.7
6703,1cbb930fb77a3781,edd02825c29028fe,98a6b2361045898f,2016-06-04,2,0,0,712,0,0,299,100,279,20,0,0,20,12,48,35,231,88,37.3,628.0
6704,f457d55f78d581f9,c07efc18b231f170,e14b5aa06eea9653,2016-05-29,0,1,0,900,7,2,58,14,57,1,0,0,1,1,9,4,48,13,58.0,524.5
6705,f457d55f78d581f9,e14b5aa06eea9653,c07efc18b231f170,2016-05-29,0,0,0,900,3,3,80,29,70,10,3,3,7,3,5,3,65,26,143.5,598.0
6706,b2c3f1783a0c8530,18968f97ad34f15c,2c99576fefe53c7c,2016-05-29,0,0,0,900,1,0,140,38,140,0,0,0,0,0,27,17,113,38,0.0,757.0
6707,b2c3f1783a0c8530,2c99576fefe53c7c,18968f97ad34f15c,2016-05-29,0,0,0,900,9,2,137,28,137,0,0,0,0,0,27,15,110,28,0.0,751.0
6708,a78ccbb549d36ddd,0749d968e932df53,5b5307450405abf0,2016-05-29,0,0,0,900,1,0,71,16,71,0,0,0,0,0,19,16,52,16,0.0,863.0
6709,a78ccbb549d36ddd,5b5307450405abf0,0749d968e932df53,2016-05-29,0,0,0,900,6,0,111,19,111,0,0,0,0,0,50,39,61,19,0.0,485.0
6710,969970fbe24945d0,72ffecf712673af1,e51ee8ded927fc51,2016-05-29,1,0,0,541,0,0,116,52,114,2,0,0,2,2,9,6,105,50,2.5,521.0
6711,969970fbe24945d0,e51ee8ded927fc51,72ffecf712673af1,2016-05-29,0,0,0,541,7,0,98,25,98,0,0,0,0,0,16,14,82,25,0.0,360.5
6712,934718256f4d082c,7be74a12d7352df2,f72465a784c1b084,2016-05-29,0,1,0,900,5,2,51,8,42,9,2,2,7,6,15,12,27,2,195.5,422.0
6713,934718256f4d082c,f72465a784c1b084,7be74a12d7352df2,2016-05-29,0,0,0,900,0,0,24,6,23,1,0,0,1,1,4,4,19,5,0.0,704.5
6714,8d9b460143ae19bc,2b074403b7c6cdb4,d8c7c61b176e3994,2016-05-29,0,0,0,173,0,0,25,9,25,0,0,0,0,0,2,1,23,9,0.0,171.0
6715,8d9b460143ae19bc,d8c7c61b176e3994,2b074403b7c6cdb4,2016-05-29,1,0,0,173,0,0,48,18,47,1,0,0,1,1,5,3,42,17,2.0,171.0
6716,8d975de5d033ccde,47b9e0e7703a4868,9450848a71d53776,2016-05-29,0,2,0,900,2,1,121,31,121,0,0,0,0,0,26,17,95,31,0.0,735.0
6717,8d975de5d033ccde,9450848a71d53776,47b9e0e7703a4868,2016-05-29,0,0,0,900,2,1,122,27,122,0,0,0,0,0,27,17,95,27,0.0,773.0
6718,6e093a1d4286dad6,5ef0088c1b19beeb,cb696ebfb6598724,2016-05-29,0,0,0,900,6,3,31,8,31,0,0,0,0,0,3,1,28,8,0.0,422.5
6719,6e093a1d4286dad6,cb696ebfb6598724,5ef0088c1b19beeb,2016-05-29,0,2,0,900,3,1,64,9,59,5,0,0,5,3,30,23,29,6,82.5,669.0
6720,6387fdb44c61ccdb,6da99156486ed6c2,e5010b1b94ca5755,2016-05-29,0,0,0,900,6,3,97,16,97,0,0,0,0,0,39,24,58,16,0.0,695.0
6721,6387fdb44c61ccdb,e5010b1b94ca5755,6da99156486ed6c2,2016-05-29,0,0,0,900,2,0,95,15,95,0,0,0,0,0,32,26,63,15,0.0,827.0
6722,5724a9cf463c8390,784285b7ae7dd85f,99bd87a300079ed9,2016-05-29,0,0,0,482,3,0,26,2,26,0,0,0,0,0,16,14,10,2,0.0,353.0
6723,5724a9cf463c8390,99bd87a300079ed9,784285b7ae7dd85f,2016-05-29,0,1,1,482,4,2,40,11,39,1,0,0,1,1,3,3,36,10,64.0,226.0
6724,313801a4262f1ea5,4bcb6eb12b4ad4aa,6c2030e0a143a94b,2016-05-29,0,0,0,900,2,1,92,9,88,4,0,0,4,2,37,18,51,7,8.0,669.4
6725,313801a4262f1ea5,6c2030e0a143a94b,4bcb6eb12b4ad4aa,2016-05-29,0,0,0,900,1,1,93,33,84,9,0,0,9,6,13,10,71,27,216.6,555.0
6726,09b8253a30360429,8f2deefe8c5dfb5d,92fa1401b7927da3,2016-05-29,0,0,0,366,2,1,27,12,25,2,0,0,2,1,8,3,17,11,11.1,229.2
6727,09b8253a30360429,92fa1401b7927da3,8f2deefe8c5dfb5d,2016-05-29,1,0,0,366,5,1,54,21,44,10,0,0,10,5,9,6,35,16,53.8,198.9
6728,e99f92b92e90b228,a8e6a69796280f17,dea070ed4a2a8281,2016-05-14,0,0,0,219,0,0,13,1,13,0,0,0,0,0,6,6,7,1,0.0,202.8
6729,e99f92b92e90b228,dea070ed4a2a8281,a8e6a69796280f17,2016-05-14,2,0,0,219,0,0,30,6,27,3,0,0,3,3,12,10,15,3,16.2,192.0
6730,e27504d07ebbc441,492b202d2064e7a9,d28dee5c705991df,2016-05-14,0,0,0,167,1,0,33,5,33,0,0,0,0,0,13,10,20,5,0.0,165.5
6731,e27504d07ebbc441,d28dee5c705991df,492b202d2064e7a9,2016-05-14,1,0,0,167,0,0,31,10,28,3,1,1,2,2,9,9,19,8,1.5,165.0
6732,bc6100e6dd239db7,1bcaac2d99b90fce,9ccf8371fd80d45d,2016-05-14,0,1,0,900,4,0,54,21,47,7,1,1,6,5,9,6,38,16,172.5,553.2
6733,bc6100e6dd239db7,9ccf8371fd80d45d,1bcaac2d99b90fce,2016-05-14,1,0,0,900,1,0,115,23,109,6,1,1,5,1,32,22,77,22,75.8,626.5
6734,958f3b45c132c3b7,aceffa19749c4dc0,b6452706b373eea1,2016-05-14,0,0,0,900,8,3,112,24,107,5,0,0,5,3,12,5,95,21,95.0,784.0
6735,958f3b45c132c3b7,b6452706b373eea1,aceffa19749c4dc0,2016-05-14,0,0,0,900,0,0,129,21,127,2,0,0,2,2,31,23,96,19,2.0,800.0
6736,93026e3763542c05,a331233f597090a5,d317a5e2b3f88c5f,2016-05-14,0,0,0,900,1,0,231,84,231,0,0,0,0,0,45,36,186,84,0.0,694.0
6737,93026e3763542c05,d317a5e2b3f88c5f,a331233f597090a5,2016-05-14,0,1,0,900,2,0,136,52,136,0,0,0,0,0,31,27,105,52,0.0,785.0
6738,9231cef371b89a46,31123249b0bbf52e,427b5953ac8e3a27,2016-05-14,0,0,0,871,0,0,23,9,13,10,0,0,10,8,3,1,10,1,53.6,89.0
6739,9231cef371b89a46,427b5953ac8e3a27,31123249b0bbf52e,2016-05-14,0,2,1,871,10,3,20,17,3,17,0,0,17,15,0,0,3,2,723.0,94.4
6740,8ec7d82619bfb564,140745cbbcb023ac,5e4eec08896c9423,2016-05-14,2,0,0,900,0,0,101,26,91,10,0,0,10,5,26,22,65,21,7.2,830.3
6741,8ec7d82619bfb564,5e4eec08896c9423,140745cbbcb023ac,2016-05-14,0,0,0,900,8,4,138,37,134,4,0,0,4,3,21,18,113,34,56.7,552.8
6742,80c4f70b7f7a1945,0ee783aa00e468f0,7a703c565ccaa18f,2016-05-14,0,0,0,278,0,0,5,3,2,3,0,0,3,3,1,1,1,0,1.5,99.69999999999999
6743,80c4f70b7f7a1945,7a703c565ccaa18f,0ee783aa00e468f0,2016-05-14,1,0,0,278,3,1,55,38,7,48,0,0,48,36,2,1,5,2,176.3,85.5
6744,65d777a16fce2be8,813550bc53b15fb0,a8283a4f415e1eb9,2016-05-14,1,0,0,900,1,0,163,36,154,9,1,1,8,7,28,14,126,29,57.0,744.7
6745,65d777a16fce2be8,a8283a4f415e1eb9,813550bc53b15fb0,2016-05-14,0,0,0,900,4,2,175,94,163,12,0,0,12,10,31,23,132,84,60.3,632.0
6746,375c2ecb6fe54cc6,73e09f837f3b5ecc,e51e5cb722bd47a8,2016-05-14,1,0,0,292,0,0,58,30,53,5,0,0,5,5,3,0,50,25,7.5,280.0
6747,375c2ecb6fe54cc6,e51e5cb722bd47a8,73e09f837f3b5ecc,2016-05-14,0,0,0,292,2,0,36,6,36,0,0,0,0,0,11,6,25,6,0.0,273.5
6748,040f227553de7838,05339613bf8e9808,c268b2cfebccf652,2016-05-14,0,0,0,900,3,0,114,27,114,0,0,0,0,0,20,13,94,27,0.0,771.4
6749,040f227553de7838,c268b2cfebccf652,05339613bf8e9808,2016-05-14,0,0,0,900,2,1,183,36,156,27,6,5,21,17,61,39,95,19,127.6,744.0
6750,d480d01418ae0143,8349d55cdecd393a,ebc1f40e00e0c481,2016-05-08,0,0,0,16,0,0,1,0,1,0,0,0,0,0,1,0,0,0,0.0,8.6
6751,d480d01418ae0143,ebc1f40e00e0c481,8349d55cdecd393a,2016-05-08,1,0,0,16,0,0,16,12,4,12,0,0,12,11,1,1,3,1,6.4,8.0
6752,d37ed975c2b70fd2,49a74b9fb2e45fdf,98aa60cf58071fd6,2016-05-08,0,1,0,900,5,0,101,36,96,5,0,0,5,3,10,4,86,33,12.0,672.4
6753,d37ed975c2b70fd2,98aa60cf58071fd6,49a74b9fb2e45fdf,2016-05-08,2,0,0,900,8,6,145,44,124,21,4,2,17,8,33,26,91,36,203.6,539.0
6754,c5990f9767b16c48,d7c3816669784109,dd4c16777fb2ccf9,2016-05-08,0,0,0,900,1,0,261,87,261,0,0,0,0,0,45,32,216,87,0.0,856.0
6755,c5990f9767b16c48,dd4c16777fb2ccf9,d7c3816669784109,2016-05-08,0,0,0,900,15,0,152,46,152,0,0,0,0,0,37,24,115,46,0.0,600.0
6756,97e895b7c2cb9db4,9b7694d064a8a0ad,c8097968da5e5f13,2016-05-08,0,0,0,900,9,6,73,39,43,30,0,0,30,28,14,11,29,11,360.9,422.0
6757,97e895b7c2cb9db4,c8097968da5e5f13,9b7694d064a8a0ad,2016-05-08,1,0,0,900,0,0,58,11,55,3,0,0,3,0,20,14,35,11,81.0,377.1
6758,7786b5fafee61c36,53ec9cb470e1a4ea,fba03cd6cc28dc41,2016-05-08,0,0,0,900,1,0,180,29,179,1,0,0,1,0,30,24,149,29,1.2,893.0
6759,7786b5fafee61c36,fba03cd6cc28dc41,53ec9cb470e1a4ea,2016-05-08,0,0,0,900,2,0,152,32,152,0,0,0,0,0,38,22,114,32,0.0,897.8
6760,711fcf95370fa90b,7cdd3e5d3aa9cb39,e25bcbcdaf6537a1,2016-05-08,0,0,0,716,10,1,85,19,84,1,0,0,1,1,15,13,69,18,8.2,527.0
6761,711fcf95370fa90b,e25bcbcdaf6537a1,7cdd3e5d3aa9cb39,2016-05-08,1,0,0,716,2,1,68,18,68,0,0,0,0,0,9,9,59,18,0.0,506.8
6762,6d47170d069df8bb,0e21976afc92e4d1,f215cfbd4ba3c270,2016-05-08,1,0,0,347,0,0,44,16,44,0,0,0,0,0,8,5,36,16,0.0,346.0
6763,6d47170d069df8bb,f215cfbd4ba3c270,0e21976afc92e4d1,2016-05-08,0,0,0,347,0,0,33,2,33,0,0,0,0,0,16,10,17,2,0.0,347.0
6764,6ccf478dca83757e,2de91c2244ad7e89,f1fac969a1d70b08,2016-05-08,0,0,0,900,12,4,16,1,16,0,0,0,0,0,4,2,12,1,0.0,284.6
6765,6ccf478dca83757e,f1fac969a1d70b08,2de91c2244ad7e89,2016-05-08,0,1,0,900,3,2,35,17,18,17,3,3,14,12,4,4,14,5,180.4,709.0
6766,692ceb2ac5fa4427,1536a25e16fc299b,1d239d571e342453,2016-05-08,0,0,0,226,5,0,10,2,10,0,0,0,0,0,7,4,3,2,0.0,112.0
6767,692ceb2ac5fa4427,1d239d571e342453,1536a25e16fc299b,2016-05-08,1,0,0,226,0,0,29,9,29,0,0,0,0,0,10,9,19,9,0.0,192.0
6768,61f80a1732d37288,1091d4d957141094,b69f24c500d783e7,2016-05-08,0,1,1,491,2,0,88,33,68,20,1,1,19,18,32,24,36,15,97.6,230.3
6769,61f80a1732d37288,b69f24c500d783e7,1091d4d957141094,2016-05-08,0,0,0,491,7,2,36,17,34,2,0,0,2,1,5,5,29,16,16.7,293.4
6770,5a9804cad2335272,6ded9184b2284645,7c3c48cf54a2848e,2016-05-08,0,0,0,510,0,0,32,7,28,4,1,1,3,2,6,5,22,5,144.8,103.0
6771,5a9804cad2335272,7c3c48cf54a2848e,6ded9184b2284645,2016-05-08,0,1,1,510,10,4,23,5,18,5,0,0,5,4,3,2,15,1,45.0,320.2
6772,5838305c25a54ea1,3738e68d2261e60f,b4ad3a06ee4d660c,2016-05-08,0,0,0,372,0,0,33,10,31,2,0,0,2,2,8,6,23,8,23.5,265.8
6773,5838305c25a54ea1,b4ad3a06ee4d660c,3738e68d2261e60f,2016-05-08,1,0,0,372,1,1,30,13,15,15,2,1,13,9,9,9,6,4,59.2,269.5
6774,03b9922d777e430c,fd55393021a8c255,ff6a1f63c254127e,2016-05-08,0,1,1,495,2,2,44,25,30,14,0,0,14,14,5,4,25,11,239.9,238.0
6775,03b9922d777e430c,ff6a1f63c254127e,fd55393021a8c255,2016-05-08,0,0,0,495,0,0,41,9,40,1,0,0,1,0,14,14,26,9,0.0,255.1
6776,f519753cc38362d0,00a3ff40c4b2cf21,6256b2b1562cb8e1,2016-04-23,0,0,0,900,10,4,114,20,112,2,0,0,2,1,25,19,87,19,329.0,571.0
6777,f519753cc38362d0,6256b2b1562cb8e1,00a3ff40c4b2cf21,2016-04-23,0,0,0,900,0,0,172,82,172,0,0,0,0,0,15,12,157,82,0.0,534.0
6778,e3a45f48dbda99c3,56c9acc4e86046a2,de75d1c45a39e221,2016-04-23,0,0,0,900,7,1,112,22,110,2,0,0,2,2,19,13,91,20,12.8,760.4
6779,e3a45f48dbda99c3,de75d1c45a39e221,56c9acc4e86046a2,2016-04-23,0,0,0,900,10,2,112,53,111,1,0,0,1,1,9,8,102,52,24.6,592.2
6780,c7e084949531a443,92b62174c175ce19,ab943cd2c3c17825,2016-04-23,0,0,0,275,0,0,5,0,5,0,0,0,0,0,0,0,5,0,0.0,37.0
6781,c7e084949531a443,ab943cd2c3c17825,92b62174c175ce19,2016-04-23,1,1,1,275,0,0,41,24,13,28,1,1,27,21,5,4,8,3,238.0,37.0
6782,be0af5916c8e8e99,68c11c27d4d56572,a6cba6bb66c1a8c9,2016-04-23,1,0,0,900,14,6,75,20,69,6,2,1,4,2,18,13,51,18,65.6,424.8
6783,be0af5916c8e8e99,a6cba6bb66c1a8c9,68c11c27d4d56572,2016-04-23,0,0,0,900,0,0,112,34,101,11,1,1,10,9,33,25,68,25,16.2,769.4
6784,b65d0243d397802c,0dba4df5f34d5ff0,e1147d3d2dabe1ce,2016-04-23,0,0,0,900,4,0,137,36,137,0,0,0,0,0,42,26,95,36,0.0,898.8
6785,b65d0243d397802c,e1147d3d2dabe1ce,0dba4df5f34d5ff0,2016-04-23,0,0,0,900,0,0,176,51,170,6,0,0,6,4,47,38,123,47,1.2,898.0
6786,92049ba4483fc840,03f982ca3735070c,5713c1d2fac539ac,2016-04-23,1,0,0,258,0,0,58,25,38,20,0,0,20,14,7,6,31,11,0.0,258.0
6787,92049ba4483fc840,5713c1d2fac539ac,03f982ca3735070c,2016-04-23,0,0,0,258,0,0,62,16,62,0,0,0,0,0,15,10,47,16,0.0,219.0
6788,8b52a32f3644f493,64a50dad704d1d49,cbb682f5fcc44bfc,2016-04-23,0,0,0,900,0,0,164,27,164,0,0,0,0,0,63,46,101,27,0.0,900.0
6789,8b52a32f3644f493,cbb682f5fcc44bfc,64a50dad704d1d49,2016-04-23,0,0,0,900,3,0,131,35,131,0,0,0,0,0,15,13,116,35,0.0,900.0
6790,43b416cf0c75dbd7,8fd808923cffff82,cbf5e6f231b55443,2016-04-23,0,0,0,435,2,1,31,6,27,4,2,2,2,0,5,3,22,6,7.0,194.0
6791,43b416cf0c75dbd7,cbf5e6f231b55443,8fd808923cffff82,2016-04-23,1,0,0,435,2,2,53,11,37,16,2,2,14,7,14,12,23,4,234.0,194.0
6792,2c0ece9f70a62408,75a6a390fd5dca46,d910665038efc639,2016-04-23,0,0,0,900,3,0,43,18,23,20,2,1,18,13,7,7,16,5,103.1,230.70000000000005
6793,2c0ece9f70a62408,d910665038efc639,75a6a390fd5dca46,2016-04-23,0,0,0,900,7,5,42,15,15,27,13,13,14,9,2,0,13,6,535.3,221.9
6794,20dda78057d17a5a,056c493bbd76a918,8a304bfd6bf04a57,2016-04-23,0,0,0,169,1,1,17,1,17,0,0,0,0,0,10,5,7,1,0.0,134.3
6795,20dda78057d17a5a,8a304bfd6bf04a57,056c493bbd76a918,2016-04-23,1,0,0,169,0,0,33,10,31,2,0,0,2,0,14,11,17,10,1.7,153.0
6796,083a0283b7bc503b,83fd97284f4bb4a4,ee9ebceabfd16fa7,2016-04-23,0,0,0,900,7,1,114,34,114,0,0,0,0,0,45,36,69,34,0.0,633.9
6797,083a0283b7bc503b,ee9ebceabfd16fa7,83fd97284f4bb4a4,2016-04-23,0,1,0,900,4,1,160,44,147,13,1,1,12,7,25,19,122,37,133.1,644.0
6798,05c8aeb2806be99c,07f72a2a7591b409,50db8711c70196cd,2016-04-23,0,0,0,1500,5,3,157,35,138,19,3,2,16,16,91,68,47,19,120.7,1265.0
6799,05c8aeb2806be99c,50db8711c70196cd,07f72a2a7591b409,2016-04-23,0,0,0,1500,0,0,160,29,160,0,0,0,0,0,47,28,113,29,0.0,1379.3
6800,e5a88d0e816fd0f1,7ff97850e8c32bda,ee779c43a8926d52,2016-04-16,1,0,0,108,0,0,17,5,14,3,0,0,3,1,1,1,13,4,1.2,106.0
6801,e5a88d0e816fd0f1,ee779c43a8926d52,7ff97850e8c32bda,2016-04-16,0,0,0,108,0,0,14,7,14,0,0,0,0,0,0,0,14,7,0.0,99.8
6802,8d9c71e110196262,3f1d23b01c552a13,c6aee362c7a7d482,2016-04-16,0,1,1,451,7,2,22,10,5,17,0,0,17,9,2,1,3,1,294.4,114.2
6803,8d9c71e110196262,c6aee362c7a7d482,3f1d23b01c552a13,2016-04-16,0,1,0,451,1,0,19,7,18,1,0,0,1,1,3,3,15,6,7.8,94.60000000000002
6804,815fd4ebdc288e83,16690d100f995f8f,8adcbd525fab8d9b,2016-04-16,0,1,0,783,7,3,105,28,100,5,0,0,5,3,15,8,85,25,20.8,700.3
6805,815fd4ebdc288e83,8adcbd525fab8d9b,16690d100f995f8f,2016-04-16,1,1,0,783,3,0,146,50,145,1,0,0,1,1,27,22,118,49,3.7,591.2
6806,613a288e8819fead,08af939f41b5a57b,c58f51dedb310998,2016-04-16,0,0,0,380,4,1,53,11,53,0,0,0,0,0,20,16,33,11,0.0,320.0
6807,613a288e8819fead,c58f51dedb310998,08af939f41b5a57b,2016-04-16,0,2,1,380,2,1,52,7,52,0,0,0,0,0,7,4,45,7,0.0,304.0
6808,43e416795dbd10e9,d247691a6c0e9034,ed209f6618c82e41,2016-04-16,2,0,0,900,0,0,148,36,110,38,12,12,26,16,44,35,66,20,167.2,724.0
6809,43e416795dbd10e9,ed209f6618c82e41,d247691a6c0e9034,2016-04-16,0,0,0,900,1,0,131,37,129,2,0,0,2,0,28,18,101,37,0.0,732.8
6810,3daf1c5fb854e626,04b39f4e8eb59d7c,dbc17725b887860a,2016-04-16,1,0,0,900,0,0,51,13,36,15,2,2,13,6,8,5,28,7,54.0,435.0
6811,3daf1c5fb854e626,dbc17725b887860a,04b39f4e8eb59d7c,2016-04-16,0,0,0,900,5,3,58,21,27,31,2,1,29,17,9,4,18,4,411.0,435.0
6812,377c8eb085bb8e00,673ea7dcc786b1b3,fc169c387b4b465d,2016-04-16,0,0,0,900,1,0,171,45,171,0,0,0,0,0,34,21,137,45,0.0,775.0
6813,377c8eb085bb8e00,fc169c387b4b465d,673ea7dcc786b1b3,2016-04-16,0,0,0,900,4,0,130,45,130,0,0,0,0,0,34,30,96,45,0.0,837.0
6814,28f5f50617f2b686,31ef8b67e13495b3,47b63240018d5d86,2016-04-16,0,0,0,900,1,0,121,20,120,1,1,1,0,0,46,40,74,20,3.5,796.8
6815,28f5f50617f2b686,47b63240018d5d86,31ef8b67e13495b3,2016-04-16,0,0,0,900,4,2,156,27,148,8,1,1,7,4,29,18,119,23,58.2,816.5
6816,249b75a787dccfe6,99506df1af6c8b3b,cc6f9d1e89f3449a,2016-04-16,1,0,0,37,0,0,19,15,16,3,0,0,3,2,1,1,15,13,0.9,33.0
6817,249b75a787dccfe6,cc6f9d1e89f3449a,99506df1af6c8b3b,2016-04-16,0,0,0,37,0,0,2,1,2,0,0,0,0,0,1,1,1,1,0.0,36.1
6818,110e1d794443b736,523fa774700d7d3f,6d1bffff14897645,2016-04-16,0,0,0,255,4,0,95,26,95,0,0,0,0,0,17,9,78,26,0.0,239.3
6819,110e1d794443b736,6d1bffff14897645,523fa774700d7d3f,2016-04-16,1,0,0,255,0,0,73,34,68,5,0,0,5,3,8,4,60,31,2.7,247.0
6820,fcb225f454ebf1a1,77d7295d1b22c694,fcce75a25c14a804,2016-04-10,0,0,0,900,3,2,148,40,145,3,0,0,3,2,37,25,108,38,13.5,873.0
6821,fcb225f454ebf1a1,fcce75a25c14a804,77d7295d1b22c694,2016-04-10,0,1,0,900,5,1,135,16,135,0,0,0,0,0,46,29,89,16,0.0,840.5
6822,f4d9138ba502b7ec,270b89c00ef0c55c,d3df1add9d9a7efb,2016-04-10,0,0,0,288,6,1,7,3,4,3,0,0,3,3,2,2,2,0,131.4,68.4
6823,f4d9138ba502b7ec,d3df1add9d9a7efb,270b89c00ef0c55c,2016-04-10,1,0,0,288,0,0,25,15,23,2,1,0,1,1,4,2,19,14,0.6,152.6
6824,eb53ec8983cb2a95,c9cf753cfdf77fc2,cc900af167fbedfd,2016-04-10,0,0,0,900,3,1,101,30,101,0,0,0,0,0,23,18,78,30,0.0,823.0
6825,eb53ec8983cb2a95,cc900af167fbedfd,c9cf753cfdf77fc2,2016-04-10,0,0,0,900,0,0,127,34,127,0,0,0,0,0,14,11,113,34,0.0,676.0
6826,d1d7400c131ed40e,80daefbed11ce998,d7adfcfdf7c6c1f8,2016-04-10,1,0,0,244,0,0,67,48,4,63,0,0,63,46,0,0,4,2,106.0,138.0
6827,d1d7400c131ed40e,d7adfcfdf7c6c1f8,80daefbed11ce998,2016-04-10,0,1,0,244,1,0,2,0,2,0,0,0,0,0,0,0,2,0,0.0,125.0
6828,a020b5b917c27bb8,13a0275fa13c4d26,9be6020024133293,2016-04-10,1,0,0,164,0,0,34,15,28,6,0,0,6,6,12,12,16,9,3.6,158.0
6829,a020b5b917c27bb8,9be6020024133293,13a0275fa13c4d26,2016-04-10,0,0,0,164,3,0,39,10,39,0,0,0,0,0,4,3,35,10,0.0,120.4
6830,9b79c05aa978c066,8d03ce87ca14e778,fa6796c55d6c5440,2016-04-10,1,0,0,600,0,0,84,32,84,0,0,0,0,0,6,4,78,32,0.0,523.0
6831,9b79c05aa978c066,fa6796c55d6c5440,8d03ce87ca14e778,2016-04-10,0,0,0,600,6,2,58,16,58,0,0,0,0,0,12,8,46,16,0.0,535.0
6832,79884c0df84662b9,38c626ca912c7bac,8f5c8850b2484173,2016-04-10,0,0,0,224,0,0,43,9,43,0,0,0,0,0,3,2,40,9,0.0,224.0
6833,79884c0df84662b9,8f5c8850b2484173,38c626ca912c7bac,2016-04-10,1,0,0,224,0,0,59,18,59,0,0,0,0,0,11,7,48,18,0.0,223.0
6834,5f6b8e48e7d3b66f,63def5a5662a6917,bd58d34e39b7b12a,2016-04-10,0,0,0,1500,0,0,247,65,247,0,0,0,0,0,100,92,147,65,0.0,1498.0
6835,5f6b8e48e7d3b66f,bd58d34e39b7b12a,63def5a5662a6917,2016-04-10,0,0,0,1500,0,0,212,51,212,0,0,0,0,0,33,26,179,51,0.0,1499.0
6836,5aa7ecc6507841bd,4ba8d454f762005d,9d19d9e4aa2662e8,2016-04-10,1,1,0,900,3,1,158,38,151,7,3,3,4,1,23,15,128,37,185.5,686.7
6837,5aa7ecc6507841bd,9d19d9e4aa2662e8,4ba8d454f762005d,2016-04-10,0,0,0,900,1,0,150,29,148,2,0,0,2,1,47,28,101,28,1.3,707.5
6838,42afd8c4fc85f485,1dafccb62a0f98ec,7413b80dbb0f8f9f,2016-04-10,0,0,0,900,4,1,99,20,99,0,0,0,0,0,35,25,64,20,0.0,804.0
6839,42afd8c4fc85f485,7413b80dbb0f8f9f,1dafccb62a0f98ec,2016-04-10,0,0,0,900,0,0,87,20,87,0,0,0,0,0,18,10,69,20,0.0,900.0
6840,3b5e1d6cbf9c8c9f,38ed5a2299230227,42a7e90605df3c8a,2016-04-10,0,0,0,136,0,0,2,0,2,0,0,0,0,0,0,0,2,0,0.0,12.0
6841,3b5e1d6cbf9c8c9f,42a7e90605df3c8a,38ed5a2299230227,2016-04-10,0,1,1,136,2,2,3,1,1,2,0,0,2,1,1,1,0,0,102.0,34.0
6842,26779cfb01372664,53278852bcd91e11,99df7d0a2a08a8a8,2016-04-10,0,0,0,900,1,0,73,33,63,10,0,0,10,9,3,2,60,24,73.0,391.0
6843,26779cfb01372664,99df7d0a2a08a8a8,53278852bcd91e11,2016-04-10,0,0,0,900,4,4,153,70,88,65,13,12,52,34,22,16,66,36,312.0,323.0
6844,1a0bf11582ae518b,175852708cb55776,b4192a975027aab6,2016-04-10,0,2,0,900,1,1,76,15,67,9,3,3,6,5,27,21,40,10,137.1,444.0
6845,1a0bf11582ae518b,b4192a975027aab6,175852708cb55776,2016-04-10,0,1,0,900,3,1,85,18,71,14,6,6,8,7,17,11,54,11,258.0,504.9
6846,fb98219ce569b384,1ff9589f9065a9ed,eef9b891edbd4604,2016-03-19,0,0,0,181,3,0,10,1,10,0,0,0,0,0,0,0,10,1,0.0,181.0
6847,fb98219ce569b384,eef9b891edbd4604,1ff9589f9065a9ed,2016-03-19,1,0,0,181,0,0,19,6,19,0,0,0,0,0,5,2,14,6,0.0,179.0
6848,f7c9f7a6edca5299,4f732e58ed907eff,c03a5022f8439f2a,2016-03-19,0,0,0,900,1,0,155,21,155,0,0,0,0,0,47,31,108,21,0.0,900.0
6849,f7c9f7a6edca5299,c03a5022f8439f2a,4f732e58ed907eff,2016-03-19,0,0,0,900,0,0,214,63,214,0,0,0,0,0,20,15,194,63,0.0,899.0
6850,ee31f081cf576273,494b0bfdbac74502,cf65d56b0755ed3b,2016-03-19,0,0,0,135,1,1,17,3,16,1,0,0,1,0,5,5,11,3,5.8,80.8
6851,ee31f081cf576273,cf65d56b0755ed3b,494b0bfdbac74502,2016-03-19,1,0,0,135,0,0,40,22,34,6,0,0,6,5,10,10,24,17,8.2,95.2
6852,e3fb9146a7eaaa47,193b9d1858bc4df3,40ff198adda94b9f,2016-03-19,0,1,1,84,0,0,9,2,9,0,0,0,0,0,4,3,5,2,0.0,71.0
6853,e3fb9146a7eaaa47,40ff198adda94b9f,193b9d1858bc4df3,2016-03-19,0,0,0,84,2,0,8,1,8,0,0,0,0,0,4,3,4,1,0.0,67.0
6854,d2105d00baa3e15e,303a05a7aa3ff761,d221ee27afc7a60e,2016-03-19,1,0,0,900,3,1,130,37,116,14,0,0,14,10,22,9,94,27,87.1,510.0
6855,d2105d00baa3e15e,d221ee27afc7a60e,303a05a7aa3ff761,2016-03-19,0,1,0,900,8,5,88,30,80,8,1,1,7,5,10,7,70,25,278.0,395.9
6856,cf13dd810b2bd061,e023fa2e648ea0f1,f5431394fb284bb9,2016-03-19,1,0,0,52,0,0,12,3,12,0,0,0,0,0,4,2,8,3,0.0,51.0
6857,cf13dd810b2bd061,f5431394fb284bb9,e023fa2e648ea0f1,2016-03-19,0,0,0,52,0,0,7,0,7,0,0,0,0,0,3,1,4,0,0.0,52.0
6858,b33d1e693e3c9958,52e76bb4b3e852f3,bdcbb976816fd256,2016-03-19,0,0,0,696,9,2,62,22,56,6,0,0,6,5,15,11,41,17,178.8,332.2
6859,b33d1e693e3c9958,bdcbb976816fd256,52e76bb4b3e852f3,2016-03-19,1,0,0,696,1,0,88,30,42,46,4,4,42,22,4,3,38,8,65.8,444.2
6860,aa92030dfd8b5d40,76984112f697631f,f9ae6914f604aa9f,2016-03-19,0,0,0,900,0,0,181,51,181,0,0,0,0,0,14,11,167,51,0.0,898.0
6861,aa92030dfd8b5d40,f9ae6914f604aa9f,76984112f697631f,2016-03-19,0,1,0,900,13,3,92,26,92,0,0,0,0,0,11,5,81,26,0.0,568.0
6862,a26db2cee9eab1f9,84b3e7d38f2d2ec5,db1f2ed63b54b9a7,2016-03-19,1,2,0,646,2,1,197,133,85,112,0,0,112,100,16,15,69,33,121.6,273.8
6863,a26db2cee9eab1f9,db1f2ed63b54b9a7,84b3e7d38f2d2ec5,2016-03-19,2,0,0,646,3,1,79,54,30,49,2,2,47,39,6,4,24,15,233.2,248.4
6864,95d46f7a7e72f91c,cd7763bcadb5d4c8,d024ed963e8bf7ea,2016-03-19,0,1,0,900,7,5,39,23,12,27,0,0,27,18,3,2,9,5,741.0,128.1
6865,95d46f7a7e72f91c,d024ed963e8bf7ea,cd7763bcadb5d4c8,2016-03-19,0,1,0,900,3,1,25,13,13,12,0,0,12,8,4,2,9,5,30.9,123.0
6866,8bf419824ca91470,165c244bcca3ed26,907e60fd13407e1e,2016-03-19,0,1,0,900,2,0,247,61,242,5,0,0,5,4,45,31,197,57,19.4,711.3
6867,8bf419824ca91470,907e60fd13407e1e,165c244bcca3ed26,2016-03-19,0,0,0,900,3,1,183,61,175,8,1,1,7,7,26,15,149,54,126.7,579.6
6868,784a57385d0e87ff,1f4b04a926ef1287,a845f0735bc67405,2016-03-19,0,0,0,885,6,1,100,15,92,8,1,1,7,5,33,19,59,10,112.0,662.6
6869,784a57385d0e87ff,a845f0735bc67405,1f4b04a926ef1287,2016-03-19,0,2,1,885,4,0,114,15,109,5,0,0,5,2,33,21,76,13,26.4,699.0
6870,e86f7b7f3a047d2a,638cfec7ec559d6e,aec185309b4843d0,2016-03-05,0,0,0,851,2,1,53,16,50,3,0,0,3,3,20,14,30,13,8.7,463.2
6871,e86f7b7f3a047d2a,aec185309b4843d0,638cfec7ec559d6e,2016-03-05,0,1,1,851,3,3,138,67,74,64,2,2,62,45,18,15,56,22,358.8,343.3
6872,d3255f2b8ef2b559,4bd6b4800070b069,92a9aa9c93192871,2016-03-05,0,2,0,900,1,0,72,23,70,2,0,0,2,2,7,4,63,21,12.6,528.5
6873,d3255f2b8ef2b559,92a9aa9c93192871,4bd6b4800070b069,2016-03-05,0,0,0,900,11,7,153,73,101,52,9,9,43,39,26,22,75,34,308.5,365.4
6874,ba2f3b9a12400aa0,132deb59abae64b1,80fa8218c99f9c58,2016-03-05,0,0,0,900,1,1,67,22,59,8,1,1,7,6,8,5,51,16,39.5,542.0
6875,ba2f3b9a12400aa0,80fa8218c99f9c58,132deb59abae64b1,2016-03-05,0,2,0,900,6,2,81,21,50,31,0,0,31,19,28,18,22,2,279.0,581.5
6876,90a5ddd6738605d9,49858bf46dabf6fb,5866fc86183a9fb8,2016-03-05,1,0,0,394,1,1,50,10,47,3,0,0,3,2,16,16,31,8,3.0,389.0
6877,90a5ddd6738605d9,5866fc86183a9fb8,49858bf46dabf6fb,2016-03-05,0,0,0,394,1,0,32,2,32,0,0,0,0,0,18,9,14,2,0.0,391.0
6878,8295c37ad4b6187e,4ac1ecf8ce59ef23,9b198c73e3d0d289,2016-03-05,1,0,0,271,0,0,35,19,7,28,0,0,28,19,2,1,5,0,141.0,130.0
6879,8295c37ad4b6187e,9b198c73e3d0d289,4ac1ecf8ce59ef23,2016-03-05,0,0,0,271,1,1,3,0,3,0,0,0,0,0,2,1,1,0,0.0,89.0
6880,7ffd80b65b0ff942,634e2fb70bde3fd5,b96619b3acd7d9da,2016-03-05,0,0,0,1410,0,0,142,35,142,0,0,0,0,0,33,24,109,35,0.0,1130.2
6881,7ffd80b65b0ff942,b96619b3acd7d9da,634e2fb70bde3fd5,2016-03-05,0,2,1,1410,9,2,104,29,92,12,0,0,12,10,21,11,71,19,228.8,1105.0
6882,6ecd93dbbaba7e10,88cd34d836b4ebcd,902ec2cc48c8ae8a,2016-03-05,1,0,0,334,0,0,51,19,43,8,0,0,8,4,9,8,34,15,5.3,304.7
6883,6ecd93dbbaba7e10,902ec2cc48c8ae8a,88cd34d836b4ebcd,2016-03-05,0,0,0,334,1,1,44,4,42,2,1,0,1,0,16,12,26,4,21.3,264.7
6884,4ace70bff9debdfb,8355922d564b152c,f4c49976c75c5ab2,2016-03-05,0,2,1,552,1,1,152,65,145,7,0,0,7,5,21,12,124,60,25.8,465.3
6885,4ace70bff9debdfb,f4c49976c75c5ab2,8355922d564b152c,2016-03-05,0,0,0,552,1,0,140,47,137,3,0,0,3,2,23,14,114,45,16.7,487.2
6886,49f83168974fb60f,0c9c0a43d3f3f49d,4bcb6eb12b4ad4aa,2016-03-05,0,0,0,369,5,1,44,6,43,1,1,1,0,0,21,16,22,6,33.9,132.0
6887,49f83168974fb60f,4bcb6eb12b4ad4aa,0c9c0a43d3f3f49d,2016-03-05,1,0,0,369,0,0,71,38,71,0,0,0,0,0,13,8,58,38,0.0,333.1
6888,3f3b8dcd16dd7383,82e7929bf6c2b689,d1941565abf50b16,2016-03-05,0,0,0,900,9,2,125,35,120,5,1,1,4,4,23,12,97,31,115.0,684.3
6889,3f3b8dcd16dd7383,d1941565abf50b16,82e7929bf6c2b689,2016-03-05,0,0,0,900,1,0,115,37,111,4,1,1,3,3,22,18,89,34,8.7,761.0
6890,17c598d7841daae0,e9a3aeb207578eea,fcd448a2fe1a23cc,2016-03-05,0,0,0,900,12,3,53,21,49,4,0,0,4,3,12,9,37,18,79.1,623.0
6891,17c598d7841daae0,fcd448a2fe1a23cc,e9a3aeb207578eea,2016-03-05,0,0,0,900,1,0,68,14,68,0,0,0,0,0,22,9,46,14,0.0,811.9
6892,0bdea30d7a7322f7,4d44f37107f01b9b,5e4eec08896c9423,2016-03-05,0,0,0,900,1,1,99,28,99,0,0,0,0,0,5,3,94,28,0.0,810.0
6893,0bdea30d7a7322f7,5e4eec08896c9423,4d44f37107f01b9b,2016-03-05,0,0,0,900,4,1,153,33,148,5,1,1,4,3,25,21,123,30,75.0,735.0
6894,dcf052ef89a66397,87a1dc546b1c5caf,cfaf010d5b389c09,2016-02-27,0,0,0,900,7,4,50,32,8,42,0,0,42,27,1,0,7,5,607.0,147.1
6895,dcf052ef89a66397,cfaf010d5b389c09,87a1dc546b1c5caf,2016-02-27,0,2,0,900,0,0,23,13,7,16,0,0,16,11,0,0,7,2,145.9,138.0
6896,c959b92fb36220a3,113df4fde64735c6,7c7332319c14094c,2016-02-27,0,0,0,900,5,1,109,46,80,29,12,10,17,13,21,16,59,33,294.0,336.9
6897,c959b92fb36220a3,7c7332319c14094c,113df4fde64735c6,2016-02-27,0,0,0,900,6,1,66,9,56,10,0,0,10,4,20,14,36,5,46.1,523.0
6898,c82f9bc365ff1074,040a74bb0a465c54,3623bd267a2eef2e,2016-02-27,1,0,0,900,4,4,101,20,90,11,8,6,3,3,8,5,82,17,138.6,648.0
6899,c82f9bc365ff1074,3623bd267a2eef2e,040a74bb0a465c54,2016-02-27,0,0,0,900,8,0,61,10,61,0,0,0,0,0,18,15,43,10,0.0,639.4
6900,b45d0e0d2bba01e9,232c582f29f8f65e,cfb65863d5099327,2016-02-27,0,0,0,900,0,0,171,55,163,8,1,1,7,5,29,25,134,50,104.5,678.0
6901,b45d0e0d2bba01e9,cfb65863d5099327,232c582f29f8f65e,2016-02-27,0,0,0,900,10,0,70,12,70,0,0,0,0,0,10,5,60,12,0.0,704.5
6902,b29d4e0117776bb3,14ff46596ad80609,9b7694d064a8a0ad,2016-02-27,0,0,0,900,3,1,72,6,69,3,0,0,3,2,19,11,50,4,81.0,540.9
6903,b29d4e0117776bb3,9b7694d064a8a0ad,14ff46596ad80609,2016-02-27,0,0,0,900,9,6,85,30,64,21,1,1,20,15,5,2,59,15,251.1,544.0
6904,a80579fe679d24e2,470fedbc8563ac47,8614b7134913f5d5,2016-02-27,0,0,0,691,2,0,135,30,130,5,1,1,4,2,55,46,75,28,6.4,646.0
6905,a80579fe679d24e2,8614b7134913f5d5,470fedbc8563ac47,2016-02-27,0,0,0,691,0,0,88,25,88,0,0,0,0,0,17,13,71,25,0.0,519.6
6906,7c20284c4c2dc9d3,7ea4a9f07df33a45,c945adc22c2bfe8f,2016-02-27,0,0,0,900,2,2,165,59,165,0,0,0,0,0,13,10,152,59,0.0,754.6
6907,7c20284c4c2dc9d3,c945adc22c2bfe8f,7ea4a9f07df33a45,2016-02-27,0,0,0,900,5,3,137,13,132,5,4,3,1,0,47,23,85,13,124.4,701.0
6908,5bff1ece35abac7f,06827d70c53ff0d9,dfae5da5676e4194,2016-02-27,1,0,0,285,2,1,9,6,6,3,0,0,3,3,3,1,3,3,25.8,222.1
6909,5bff1ece35abac7f,dfae5da5676e4194,06827d70c53ff0d9,2016-02-27,0,0,0,285,4,1,10,2,9,1,0,0,1,1,5,4,4,1,19.9,60.2
6910,4bf6b6904ec94421,51e86de150ee8be6,8f4eeaf7a0df7c1a,2016-02-27,0,0,0,24,0,0,1,0,1,0,0,0,0,0,0,0,1,0,0.0,14.0
6911,4bf6b6904ec94421,8f4eeaf7a0df7c1a,51e86de150ee8be6,2016-02-27,1,1,1,24,0,0,11,6,5,6,0,0,6,4,0,0,5,2,10.0,14.0
6912,2af50cc7f34f6fc2,34e552520a934063,4e06913c91da5200,2016-02-27,0,0,0,900,1,0,109,30,109,0,0,0,0,0,28,15,81,30,0.0,777.2
6913,2af50cc7f34f6fc2,4e06913c91da5200,34e552520a934063,2016-02-27,0,0,0,900,4,2,170,33,163,7,1,1,6,4,32,25,131,29,9.8,872.0
6914,0e9091311ca565ce,1f454354805b6f75,2b93ebd9f5417ad2,2016-02-27,1,0,0,1500,0,0,135,47,131,4,1,1,3,1,30,27,101,46,2.2,1466.5
6915,0e9091311ca565ce,2b93ebd9f5417ad2,1f454354805b6f75,2016-02-27,1,0,0,1500,1,0,316,58,305,11,0,0,11,6,65,50,240,52,28.5,1453.8
6916,0d043ecaf5bbc3ae,1588b787bda7b540,65ddc8a9ac4e8531,2016-02-27,0,1,0,900,0,0,59,26,42,17,2,1,15,9,7,5,35,17,234.4,514.0
6917,0d043ecaf5bbc3ae,65ddc8a9ac4e8531,1588b787bda7b540,2016-02-27,0,1,0,900,6,3,16,4,16,0,0,0,0,0,7,2,9,4,0.0,426.6
6918,0845e0f9e8d61b0f,2747c60e42d9d75f,bcad7223af3c19da,2016-02-27,1,0,0,386,1,1,62,15,57,5,0,0,5,4,28,23,29,11,29.0,347.5
6919,0845e0f9e8d61b0f,bcad7223af3c19da,2747c60e42d9d75f,2016-02-27,0,0,0,386,4,0,34,3,33,1,0,0,1,1,12,10,21,2,9.5,338.0
6920,eadb215519406e92,1c86754617d9813a,b1a3e0aca758b322,2016-02-21,0,0,0,158,1,0,13,0,13,0,0,0,0,0,0,0,13,0,0.0,116.0
6921,eadb215519406e92,b1a3e0aca758b322,1c86754617d9813a,2016-02-21,1,0,0,158,0,0,51,22,9,42,0,0,42,21,1,1,8,1,42.0,116.0
6922,e508ba268cb295c0,2f5cbecbbe18bac4,c727c7d31c50c4cf,2016-02-21,0,0,0,900,2,0,104,49,102,2,0,0,2,2,20,13,82,47,0.2,896.0
6923,e508ba268cb295c0,c727c7d31c50c4cf,2f5cbecbbe18bac4,2016-02-21,0,0,0,900,4,0,77,19,77,0,0,0,0,0,25,21,52,19,0.0,884.8
6924,d373de3e072f7e57,cc98d857b148e33a,d4c9dcd330403612,2016-02-21,0,0,0,900,0,0,108,46,89,19,4,4,15,15,20,14,69,31,113.5,588.0
6925,d373de3e072f7e57,d4c9dcd330403612,cc98d857b148e33a,2016-02-21,0,0,0,900,5,2,101,40,92,9,1,1,8,7,22,16,70,33,97.0,549.5
6926,cc4a23ed2cbc8aa4,729d4bd5a6cd0a97,9c42a0de8e012870,2016-02-21,1,0,0,895,3,1,171,67,128,43,6,6,37,30,24,22,104,37,274.0,519.0
6927,cc4a23ed2cbc8aa4,9c42a0de8e012870,729d4bd5a6cd0a97,2016-02-21,0,0,0,895,2,0,145,50,145,0,0,0,0,0,34,26,111,50,0.0,560.0
6928,b7653a82f4b07b1f,784285b7ae7dd85f,8f6a18831a120817,2016-02-21,0,0,0,900,3,2,129,33,113,16,4,3,12,10,54,46,59,23,130.6,696.0
6929,b7653a82f4b07b1f,8f6a18831a120817,784285b7ae7dd85f,2016-02-21,0,2,0,900,14,2,111,35,111,0,0,0,0,0,15,12,96,35,0.0,427.4
6930,a06a3bc70d7c4264,6c2030e0a143a94b,d512d9f204059f57,2016-02-21,1,0,0,26,0,0,13,8,13,0,0,0,0,0,3,3,10,8,0.0,25.0
6931,a06a3bc70d7c4264,d512d9f204059f57,6c2030e0a143a94b,2016-02-21,0,0,0,26,0,0,0,0,0,0,0,0,0,0,0,0,0,0,0.0,26.0
6932,94d708a8a8fefdef,15ec018d144710db,f40ec51dd4de47c3,2016-02-21,0,0,0,900,5,3,112,23,92,20,8,8,12,10,11,6,81,13,275.0,447.2
6933,94d708a8a8fefdef,f40ec51dd4de47c3,15ec018d144710db,2016-02-21,0,0,0,900,8,3,77,13,71,6,1,0,5,2,11,8,60,11,12.8,591.0
6934,607d22f0b3db4f1f,0d8011111be000b2,a2b12c3f3d60ff69,2016-02-21,1,0,0,865,2,1,173,67,151,22,0,0,22,14,19,17,132,53,122.5,513.6
6935,607d22f0b3db4f1f,a2b12c3f3d60ff69,0d8011111be000b2,2016-02-21,0,0,0,865,7,3,67,20,52,15,0,0,15,8,6,3,46,12,184.4,533.5
6936,5d000de6fa836f66,c7d297714d9ab1a4,fc6e681bf6658faf,2016-02-21,0,1,0,900,1,1,140,24,137,3,0,0,3,0,34,29,103,24,1.4,873.5
6937,5d000de6fa836f66,fc6e681bf6658faf,c7d297714d9ab1a4,2016-02-21,0,0,0,900,2,1,213,25,207,6,1,1,5,1,45,29,162,24,15.5,849.6
6938,3bd5dbc1598c409d,6f242453c91a5af0,80d918336163b80c,2016-02-21,0,1,0,900,5,4,80,51,36,44,2,2,42,41,10,8,26,10,215.8,342.7
6939,3bd5dbc1598c409d,80d918336163b80c,6f242453c91a5af0,2016-02-21,0,0,0,900,7,1,26,7,24,2,0,0,2,2,8,5,16,5,297.3,238.2
6940,214fa13c3f230259,1d00756835ca67c9,57b10fca4f9c9a7a,2016-02-21,0,1,1,153,2,1,6,0,6,0,0,0,0,0,5,4,1,0,0.0,120.0
6941,214fa13c3f230259,57b10fca4f9c9a7a,1d00756835ca67c9,2016-02-21,0,0,0,153,0,0,24,4,24,0,0,0,0,0,11,10,13,4,0.0,102.0
6942,014a3acf91ada8af,04b39f4e8eb59d7c,7e47047d0971d566,2016-02-21,1,0,0,60,0,0,20,6,13,7,0,0,7,5,5,2,8,1,5.0,55.0
6943,014a3acf91ada8af,7e47047d0971d566,04b39f4e8eb59d7c,2016-02-21,0,0,0,60,0,0,0,0,0,0,0,0,0,0,0,0,0,0,0.0,55.0
6944,ee9173615ef4cfae,0641c21bec209472,9e50097a89442158,2016-02-06,0,0,0,45,0,0,6,3,6,0,0,0,0,0,1,0,5,3,0.0,31.0
6945,ee9173615ef4cfae,9e50097a89442158,0641c21bec209472,2016-02-06,1,1,1,45,0,0,4,2,3,1,0,0,1,1,0,0,3,1,14.0,31.0
6946,d6e1205babf27a9d,ab850a77a0fa487d,f5990c11974d8e9c,2016-02-06,1,0,0,865,0,0,208,40,206,2,0,0,2,1,17,10,189,39,22.0,822.6
6947,d6e1205babf27a9d,f5990c11974d8e9c,ab850a77a0fa487d,2016-02-06,1,0,0,865,4,1,177,57,175,2,1,1,1,1,22,17,153,56,9.4,730.0
6948,d0a8304574e65ec9,6da99156486ed6c2,b7ffa72aa148599a,2016-02-06,0,0,0,900,10,3,108,16,103,5,2,1,3,2,47,40,56,14,101.7,717.0
6949,d0a8304574e65ec9,b7ffa72aa148599a,6da99156486ed6c2,2016-02-06,0,0,0,900,0,0,63,26,63,0,0,0,0,0,13,7,50,26,0.0,798.3
6950,a3935c950c40462b,3f7c14c7eca7195d,91ea901c458e95dd,2016-02-06,0,0,0,900,1,0,121,36,121,0,0,0,0,0,7,6,114,36,0.0,900.0
6951,a3935c950c40462b,91ea901c458e95dd,3f7c14c7eca7195d,2016-02-06,0,0,0,900,2,0,120,26,120,0,0,0,0,0,14,10,106,26,0.0,900.0
6952,98035e427b476717,57ab4d7c0bc09a30,80eacd4da0617c57,2016-02-06,0,0,0,900,19,4,96,24,96,0,0,0,0,0,17,16,79,24,0.0,819.8
6953,98035e427b476717,80eacd4da0617c57,57ab4d7c0bc09a30,2016-02-06,0,0,0,900,0,0,197,45,196,1,0,0,1,1,32,21,164,44,1.2,865.0
6954,640dbb5a89c0aad6,3f11b5d4bd76a6d9,d3df1add9d9a7efb,2016-02-06,0,0,0,137,1,0,3,1,1,2,0,0,2,1,1,0,0,0,0.0,18.0
6955,640dbb5a89c0aad6,d3df1add9d9a7efb,3f11b5d4bd76a6d9,2016-02-06,1,0,0,137,1,1,30,13,4,26,1,1,25,12,0,0,4,1,119.0,18.0
6956,45500515780758f0,2b6d855c6e280fb1,67f272324a030d00,2016-02-06,0,0,0,388,0,0,51,10,51,0,0,0,0,0,11,6,40,10,0.0,376.9
6957,45500515780758f0,67f272324a030d00,2b6d855c6e280fb1,2016-02-06,0,1,1,388,6,3,63,23,61,2,0,0,2,2,15,9,46,21,11.1,260.0
6958,3cbbf947fd0d2144,0941df56f6ac954b,4a28cb716c19157a,2016-02-06,0,0,0,211,2,0,16,3,16,0,0,0,0,0,5,4,11,3,0.0,182.0
6959,3cbbf947fd0d2144,4a28cb716c19157a,0941df56f6ac954b,2016-02-06,1,0,0,211,0,0,46,17,44,2,0,0,2,2,8,7,36,15,0.0,211.0
6960,3760216f68f448b7,09f579be4520394a,9f755fb04cc21499,2016-02-06,1,0,0,323,1,1,9,5,5,4,0,0,4,4,0,0,5,1,17.0,106.0
6961,3760216f68f448b7,9f755fb04cc21499,09f579be4520394a,2016-02-06,0,3,0,323,1,1,13,4,8,5,0,0,5,3,4,3,4,1,200.0,66.0
6962,37008594c087470c,50db8711c70196cd,5c1ca0c72b599a3c,2016-02-06,0,0,0,900,2,1,102,43,61,41,0,0,41,28,16,8,45,15,330.5,505.0
6963,37008594c087470c,5c1ca0c72b599a3c,50db8711c70196cd,2016-02-06,0,0,0,900,1,0,22,7,20,2,0,0,2,2,6,3,14,5,0.0,569.5
6964,311156891c7bdf60,9fa568ad2bf2cb0b,a4de54ea806fb525,2016-02-06,0,0,0,900,6,4,120,35,104,16,6,6,10,10,26,16,78,25,239.4,434.5
6965,311156891c7bdf60,a4de54ea806fb525,9fa568ad2bf2cb0b,2016-02-06,0,0,0,900,8,1,44,13,36,8,1,1,7,6,8,6,28,7,31.5,597.6
6966,02ace8fdd83c6480,02f2a9702ba3d167,c17041f1bb5768d8,2016-02-06,0,0,0,900,0,0,108,17,108,0,0,0,0,0,12,6,96,17,0.0,690.5
6967,02ace8fdd83c6480,c17041f1bb5768d8,02f2a9702ba3d167,2016-02-06,0,0,0,900,7,3,172,36,170,2,0,0,2,1,57,42,113,35,8.5,832.0
6968,fa5244817650f401,5aedf14771ca82d2,f53c1f4ceeed8c08,2016-01-30,0,0,0,900,23,9,125,36,112,13,3,2,10,8,11,10,101,28,184.2,486.8
6969,fa5244817650f401,f53c1f4ceeed8c08,5aedf14771ca82d2,2016-01-30,0,0,0,900,6,1,130,31,127,3,0,0,3,2,19,14,108,29,2.2,700.8
6970,df8391ca39160d8c,29af297d9f1de0f8,938ad489fb7a1f31,2016-01-30,0,0,0,900,6,0,131,22,130,1,0,0,1,1,27,22,103,21,12.5,498.4
6971,df8391ca39160d8c,938ad489fb7a1f31,29af297d9f1de0f8,2016-01-30,0,0,0,900,5,2,114,32,113,1,0,0,1,1,37,33,76,31,2.6,766.5
6972,d2591df4fa9cc44e,a331233f597090a5,ed9d8ee3a4239b1c,2016-01-30,0,1,1,486,1,1,48,23,30,18,1,1,17,16,7,2,23,7,146.2,280.5
6973,d2591df4fa9cc44e,ed9d8ee3a4239b1c,a331233f597090a5,2016-01-30,0,0,0,486,5,1,45,11,44,1,0,0,1,1,9,7,35,10,10.5,255.8
6974,b810951e39a0af1b,55ee431411ccf07a,f53d4f21d1b5f2dc,2016-01-30,0,0,0,900,5,1,93,39,91,2,0,0,2,1,15,10,76,38,16.3,762.0
6975,b810951e39a0af1b,f53d4f21d1b5f2dc,55ee431411ccf07a,2016-01-30,0,0,0,900,5,0,152,46,147,5,0,0,5,5,31,19,116,41,81.0,640.7
6976,7bb335510a749419,0dba4df5f34d5ff0,8d9586726252dbf7,2016-01-30,1,0,0,817,7,4,87,43,44,43,0,0,43,31,13,11,31,12,274.5,485.0
6977,7bb335510a749419,8d9586726252dbf7,0dba4df5f34d5ff0,2016-01-30,0,0,0,817,2,0,49,10,49,0,0,0,0,0,8,6,41,10,0.0,412.5
6978,6eb4b84c4b10854a,6c7e25571490aa3b,d06f8869449ba7bd,2016-01-30,0,0,0,239,0,0,22,1,22,0,0,0,0,0,16,13,6,1,0.0,137.0
6979,6eb4b84c4b10854a,d06f8869449ba7bd,6c7e25571490aa3b,2016-01-30,1,0,0,239,2,2,18,5,14,4,1,1,3,3,10,9,4,2,0.0,239.0
6980,6c1dba8a3ba4f42e,ad3f53c454cbbead,bd58d34e39b7b12a,2016-01-30,0,0,0,528,1,0,68,21,68,0,0,0,0,0,16,14,52,21,0.0,500.0
6981,6c1dba8a3ba4f42e,bd58d34e39b7b12a,ad3f53c454cbbead,2016-01-30,0,1,1,528,0,0,91,24,91,0,0,0,0,0,14,11,77,24,0.0,521.0
6982,6066dc40bb3ce8db,4638cc6479cc0afe,7aa3d6964eff4877,2016-01-30,0,0,0,900,1,0,108,17,108,0,0,0,0,0,26,19,82,17,0.0,884.8
6983,6066dc40bb3ce8db,7aa3d6964eff4877,4638cc6479cc0afe,2016-01-30,0,0,0,900,3,1,144,39,142,2,0,0,2,2,52,35,90,37,10.2,793.0
6984,4ce0a62cdad7bf32,2f95a3c6d58b2aad,9c907996820d2d69,2016-01-30,0,0,0,900,0,0,106,18,106,0,0,0,0,0,33,23,73,18,0.0,877.0
6985,4ce0a62cdad7bf32,9c907996820d2d69,2f95a3c6d58b2aad,2016-01-30,0,0,0,900,6,3,102,21,99,3,0,0,3,0,35,24,64,21,22.0,768.0
6986,4c7390e4d169f6ff,365fee2da473b177,c0ab242c40decc55,2016-01-30,1,0,0,86,0,0,13,11,0,13,0,0,13,11,0,0,0,0,73.0,13.0
6987,4c7390e4d169f6ff,c0ab242c40decc55,365fee2da473b177,2016-01-30,0,0,0,86,1,0,0,0,0,0,0,0,0,0,0,0,0,0,0.0,13.0
6988,44c6d87116bb3a10,0749d968e932df53,d81ac739417d7f53,2016-01-30,0,0,0,900,1,0,131,30,131,0,0,0,0,0,28,24,103,30,0.0,839.0
6989,44c6d87116bb3a10,d81ac739417d7f53,0749d968e932df53,2016-01-30,0,0,0,900,4,0,99,24,99,0,0,0,0,0,9,6,90,24,0.0,846.0
6990,318449b3f9346566,5331b25a60417ffb,948880beac71f028,2016-01-30,0,1,1,782,7,2,141,55,141,0,0,0,0,0,9,5,132,55,0.0,541.0
6991,318449b3f9346566,948880beac71f028,5331b25a60417ffb,2016-01-30,0,0,0,782,1,0,150,31,150,0,0,0,0,0,69,56,81,31,0.0,763.0
6992,15f48dd8cf8ae455,8f0d576beba1cfcd,c6aee362c7a7d482,2016-01-30,0,0,0,900,8,1,97,16,97,0,0,0,0,0,35,30,62,16,0.0,714.5
6993,15f48dd8cf8ae455,c6aee362c7a7d482,8f0d576beba1cfcd,2016-01-30,0,1,0,900,4,1,108,31,106,2,0,0,2,2,24,17,82,29,13.5,691.0
6994,f8ad660497e49187,06f36cf4bd97ec77,c80095f6092271a7,2016-01-17,1,0,0,399,0,0,82,31,79,3,0,0,3,3,19,16,60,28,1.9,384.0
6995,f8ad660497e49187,c80095f6092271a7,06f36cf4bd97ec77,2016-01-17,0,0,0,399,0,0,64,16,64,0,0,0,0,0,14,11,50,16,0.0,389.1
6996,d0dc419dc7acb7e2,4f732e58ed907eff,a8283a4f415e1eb9,2016-01-17,0,0,0,900,2,2,85,9,81,4,1,1,3,2,27,18,54,7,27.6,838.0
6997,d0dc419dc7acb7e2,a8283a4f415e1eb9,4f732e58ed907eff,2016-01-17,0,0,0,900,3,1,112,34,112,0,0,0,0,0,22,17,90,34,0.0,807.4
6998,cdf048ec9b917cfa,4a1329cc8eb0928a,96428b9e9bd048ea,2016-01-17,0,1,0,218,1,1,39,2,38,1,0,0,1,0,14,14,24,2,14.5,184.2
6999,cdf048ec9b917cfa,96428b9e9bd048ea,4a1329cc8eb0928a,2016-01-17,1,1,1,218,0,0,48,21,46,2,0,0,2,2,6,5,40,19,4.8,191.5
7000,c4938baf92d2dc31,10f3ba6cd2f44a97,c849740a3ff51931,2016-01-17,0,0,0,1500,11,4,302,97,300,2,0,0,2,0,20,15,280,97,8.2,1461.9
7001,c4938baf92d2dc31,c849740a3ff51931,10f3ba6cd2f44a97,2016-01-17,0,0,0,1500,8,1,408,64,407,1,0,0,1,1,65,45,342,63,5.1,1419.8
7002,a7adbceeff234b61,484acc7b0f856ce9,9fa3bd637edd9aa2,2016-01-17,0,0,0,374,1,1,27,4,26,1,0,0,1,1,9,7,17,3,23.5,216.8
7003,a7adbceeff234b61,9fa3bd637edd9aa2,484acc7b0f856ce9,2016-01-17,1,1,0,374,0,0,63,31,37,26,2,2,24,18,17,9,20,13,63.2,260.5
7004,762de3b0b32ba937,3236bf606fe9fa5b,ba280572acfba13f,2016-01-17,1,0,0,849,3,2,114,31,75,39,0,0,39,25,37,20,38,6,154.1,683.0
7005,762de3b0b32ba937,ba280572acfba13f,3236bf606fe9fa5b,2016-01-17,1,0,0,849,1,0,61,14,61,0,0,0,0,0,13,13,48,14,0.0,694.9
7006,649b2db3709b07fe,28c55b4087a6f136,b69f24c500d783e7,2016-01-17,0,0,0,900,0,0,120,22,110,10,0,0,10,7,20,16,90,15,0.0,803.0
7007,649b2db3709b07fe,b69f24c500d783e7,28c55b4087a6f136,2016-01-17,0,0,0,900,10,1,95,34,89,6,2,1,4,2,24,22,65,32,97.0,706.0
7008,5afd44d1e567d2e8,40093d1d2d78394e,c5af5750e8bae4f0,2016-01-17,0,0,0,900,8,1,232,54,232,0,0,0,0,0,61,38,171,54,0.0,823.5
7009,5afd44d1e567d2e8,c5af5750e8bae4f0,40093d1d2d78394e,2016-01-17,1,0,0,900,5,1,129,37,125,4,0,0,4,2,20,15,105,35,13.5,856.0
7010,52abce3a11b43b1d,5f99b2bafb10305f,e5010b1b94ca5755,2016-01-17,0,0,0,836,8,3,58,18,56,2,0,0,2,1,19,14,37,17,20.8,473.0
7011,52abce3a11b43b1d,e5010b1b94ca5755,5f99b2bafb10305f,2016-01-17,0,3,1,836,4,2,87,32,62,25,4,4,21,17,15,10,47,15,186.0,443.2
7012,3ce6f9eb59a1e149,33a331684283900f,cbb682f5fcc44bfc,2016-01-17,0,0,0,900,15,6,90,20,86,4,1,1,3,2,28,21,58,18,229.0,442.0
7013,3ce6f9eb59a1e149,cbb682f5fcc44bfc,33a331684283900f,2016-01-17,0,0,0,900,0,0,109,33,109,0,0,0,0,0,30,23,79,33,0.0,671.0
7014,2e0493171c4ee80f,cb52f9490c2dc069,e9a3aeb207578eea,2016-01-17,0,0,0,30,0,0,3,1,3,0,0,0,0,0,0,0,3,1,0.0,30.0
7015,2e0493171c4ee80f,e9a3aeb207578eea,cb52f9490c2dc069,2016-01-17,1,0,0,30,0,0,3,2,3,0,0,0,0,0,0,0,3,2,0.0,29.0
7016,226c6a86f4f81122,c8097968da5e5f13,e4d2564ea0e34e2b,2016-01-17,0,1,1,270,2,2,13,4,3,10,1,1,9,3,0,0,3,1,256.0,14.0
7017,226c6a86f4f81122,e4d2564ea0e34e2b,c8097968da5e5f13,2016-01-17,0,0,0,270,0,0,5,1,4,1,0,0,1,1,0,0,4,0,0.0,14.0
7018,18cdc16fc7ab7ce1,05339613bf8e9808,0778f94eb5d588a5,2016-01-17,1,0,0,553,5,1,110,29,109,1,0,0,1,0,29,23,80,29,3.9,487.0
7019,18cdc16fc7ab7ce1,0778f94eb5d588a5,05339613bf8e9808,2016-01-17,0,0,0,553,1,1,71,10,71,0,0,0,0,0,7,5,64,10,0.0,525.1
7020,f2916c10b7ecfcee,3738e68d2261e60f,d28dee5c705991df,2016-01-02,0,0,0,54,0,0,12,4,12,0,0,0,0,0,6,3,6,4,0.0,52.6
7021,f2916c10b7ecfcee,d28dee5c705991df,3738e68d2261e60f,2016-01-02,1,0,0,54,0,0,15,11,10,5,0,0,5,5,0,0,10,6,1.4,52.0
7022,f079cb2db8dbbf04,f2925e6db404bf1d,f9f07bb5a43535ed,2016-01-02,1,0,0,1500,0,0,177,82,173,4,0,0,4,2,10,10,163,80,7.0,1458.0
7023,f079cb2db8dbbf04,f9f07bb5a43535ed,f2925e6db404bf1d,2016-01-02,0,0,0,1500,0,0,495,96,495,0,0,0,0,0,123,80,372,96,0.0,1483.0
7024,d5778494ce663d7f,8d49545dadf9b919,ec2d13a87d3d9541,2016-01-02,0,0,0,192,0,0,3,1,3,0,0,0,0,0,0,0,3,1,0.0,45.0
7025,d5778494ce663d7f,ec2d13a87d3d9541,8d49545dadf9b919,2016-01-02,1,0,0,192,1,1,79,33,6,73,0,0,73,33,2,0,4,0,147.0,45.0
7026,b46b27222e62aec1,64788ee44b062ded,a4e85a58fbce64b2,2016-01-02,0,0,0,900,6,3,190,46,176,14,3,2,11,8,9,9,167,38,267.8,582.8
7027,b46b27222e62aec1,a4e85a58fbce64b2,64788ee44b062ded,2016-01-02,0,4,0,900,3,1,111,54,107,4,0,0,4,4,23,17,84,50,11.2,618.2
7028,a19d619f1b9bee7b,d0314416a7f26527,f3a078277b3b8ff4,2016-01-02,0,2,1,429,0,0,13,4,13,0,0,0,0,0,3,1,10,4,0.0,67.0
7029,a19d619f1b9bee7b,f3a078277b3b8ff4,d0314416a7f26527,2016-01-02,0,1,0,429,2,2,17,4,5,12,9,9,3,3,2,2,3,1,350.0,79.0
7030,99a7172fb7438244,519e4fe37ce9ff75,df1eb4354d18a906,2016-01-02,0,0,0,900,14,5,88,29,82,6,1,1,5,3,9,6,73,26,70.0,461.4
7031,99a7172fb7438244,df1eb4354d18a906,519e4fe37ce9ff75,2016-01-02,0,0,0,900,5,2,69,33,54,15,0,0,15,11,7,5,47,22,123.6,591.0
7032,71499934c065fecb,c2e3e67b5911bfb7,def8166ff24bd237,2016-01-02,0,0,0,697,3,2,108,38,99,9,0,0,9,5,21,18,78,33,20.0,677.0
7033,71499934c065fecb,def8166ff24bd237,c2e3e67b5911bfb7,2016-01-02,0,2,1,697,1,0,110,18,110,0,0,0,0,0,19,11,91,18,0.0,574.0
7034,595557b808febe27,928ae2e5b5f7a9ec,d343df8ba11f4c4e,2016-01-02,0,0,0,900,10,3,135,45,129,6,1,1,5,4,40,26,89,41,35.4,715.7
7035,595557b808febe27,d343df8ba11f4c4e,928ae2e5b5f7a9ec,2016-01-02,0,0,0,900,2,1,174,50,172,2,0,0,2,1,57,42,115,49,13.3,704.6
7036,5337461354f23b98,57bad6a84230f0c9,e14b5aa06eea9653,2016-01-02,0,0,0,198,1,1,12,5,12,0,0,0,0,0,0,0,12,5,0.0,186.0
7037,5337461354f23b98,e14b5aa06eea9653,57bad6a84230f0c9,2016-01-02,0,1,1,198,2,0,11,2,11,0,0,0,0,0,3,2,8,2,0.0,181.0
7038,4fa02674b920ff0a,029eaff01e6bb8f0,654ae722109a0d31,2016-01-02,0,0,0,900,7,4,137,58,97,40,2,2,38,25,14,12,83,33,375.3,335.9
7039,4fa02674b920ff0a,654ae722109a0d31,029eaff01e6bb8f0,2016-01-02,0,1,0,900,0,0,100,29,98,2,0,0,2,2,8,8,90,27,1.1,516.7
7040,454861874ecc52d7,7339d340aa2889cb,cdb96af67d096b1e,2016-01-02,0,0,0,900,3,1,134,24,117,17,6,6,11,6,50,29,67,18,115.4,689.4
7041,454861874ecc52d7,cdb96af67d096b1e,7339d340aa2889cb,2016-01-02,0,1,0,900,0,0,125,34,120,5,0,0,5,4,15,9,105,30,20.6,718.6
7042,050eb872a69c66bd,9450848a71d53776,ff6a1f63c254127e,2016-01-02,0,0,0,900,2,0,155,12,155,0,0,0,0,0,71,57,84,12,0.0,886.0
7043,050eb872a69c66bd,ff6a1f63c254127e,9450848a71d53776,2016-01-02,0,0,0,900,2,0,194,52,194,0,0,0,0,0,27,24,167,52,0.0,883.0
7044,f7fd4b82e827c9c4,8d03ce87ca14e778,e5bda12faabfc850,2015-12-19,1,0,0,473,0,0,45,19,36,9,2,1,7,4,5,5,31,15,0.7,183.0
7045,f7fd4b82e827c9c4,e5bda12faabfc850,8d03ce87ca14e778,2015-12-19,0,0,0,473,6,1,10,5,9,1,0,0,1,0,0,0,9,5,289.0,183.3
7046,e1ec8774466db669,6d4b63c767106d3a,cf615eb4b7862c76,2015-12-19,0,1,1,133,0,0,26,6,26,0,0,0,0,0,6,6,20,6,0.0,112.0
7047,e1ec8774466db669,cf615eb4b7862c76,6d4b63c767106d3a,2015-12-19,0,0,0,133,1,0,28,9,28,0,0,0,0,0,7,6,21,9,0.0,133.0
7048,b2857e799319f931,282fa667ff9c51ed,fe5a9547479396ab,2015-12-19,0,0,0,394,0,0,77,17,77,0,0,0,0,0,13,11,64,17,0.0,394.0
7049,b2857e799319f931,fe5a9547479396ab,282fa667ff9c51ed,2015-12-19,0,0,0,394,0,0,79,9,79,0,0,0,0,0,24,16,55,9,0.0,394.0
7050,b26ec098a5a57401,132deb59abae64b1,36df8e119aec6175,2015-12-19,0,0,0,900,9,4,44,21,39,5,0,0,5,4,15,11,24,17,84.8,394.7
7051,b26ec098a5a57401,36df8e119aec6175,132deb59abae64b1,2015-12-19,0,0,0,900,4,1,44,14,34,10,2,2,8,7,16,11,18,7,132.3,524.2
7052,95ead23dc0c73285,4a57ebb14315b251,d7c3816669784109,2015-12-19,0,0,0,900,9,1,100,21,100,0,0,0,0,0,18,13,82,21,0.0,532.5
7053,95ead23dc0c73285,d7c3816669784109,4a57ebb14315b251,2015-12-19,0,0,0,900,0,0,169,40,157,12,3,2,9,8,29,24,128,32,48.5,811.0
7054,81f287d035190506,1d00756835ca67c9,6a2f7c151031653d,2015-12-19,0,0,0,66,1,0,7,2,7,0,0,0,0,0,2,2,5,2,0.0,58.4
7055,81f287d035190506,6a2f7c151031653d,1d00756835ca67c9,2015-12-19,1,0,0,66,0,0,44,21,33,11,0,0,11,6,5,5,28,15,7.6,57.0
7056,7c883cf0b5eedc59,9deff9e3e8d94d47,eff47295daf721a6,2015-12-19,0,0,0,850,4,2,19,6,7,12,3,3,9,6,1,1,6,0,380.0,67.0
7057,7c883cf0b5eedc59,eff47295daf721a6,9deff9e3e8d94d47,2015-12-19,0,1,1,850,4,2,53,36,7,46,0,0,46,34,4,3,3,2,403.0,32.0
7058,4942323a5d5a6594,511e82663651438d,8355922d564b152c,2015-12-19,0,0,0,900,1,1,301,44,301,0,0,0,0,0,116,59,185,44,0.0,881.0
7059,4942323a5d5a6594,8355922d564b152c,511e82663651438d,2015-12-19,0,0,0,900,0,0,300,135,300,0,0,0,0,0,27,18,273,135,0.0,900.0
7060,3fc9fea36fc7ec37,5d7bdab5e03e3216,a8e6a69796280f17,2015-12-19,0,0,0,328,1,0,35,9,35,0,0,0,0,0,11,6,24,9,0.0,323.0
7061,3fc9fea36fc7ec37,a8e6a69796280f17,5d7bdab5e03e3216,2015-12-19,1,0,0,328,0,0,27,4,26,1,0,0,1,1,15,12,11,3,2.0,324.0
7062,2f0bfdc3c325662d,f1b2aa7853d1ed6e,f1fac969a1d70b08,2015-12-19,0,0,0,900,13,6,80,28,45,35,8,8,27,17,17,12,28,11,455.0,242.0
7063,2f0bfdc3c325662d,f1fac969a1d70b08,f1b2aa7853d1ed6e,2015-12-19,0,0,0,900,0,0,57,17,55,2,0,0,2,2,10,9,45,15,8.0,405.0
7064,1f0254eeb2025e4f,63def5a5662a6917,b4ad3a06ee4d660c,2015-12-19,0,0,0,583,0,0,46,12,46,0,0,0,0,0,17,10,29,12,0.0,580.0
7065,1f0254eeb2025e4f,b4ad3a06ee4d660c,63def5a5662a6917,2015-12-19,1,0,0,583,1,0,43,11,39,4,1,1,3,3,25,20,14,8,3.0,580.0
7066,164f56eb25d6a9b4,07225ba28ae309b6,08e908ed6d18d6a0,2015-12-19,0,1,1,185,1,1,10,0,10,0,0,0,0,0,6,5,4,0,0.0,174.0
7067,164f56eb25d6a9b4,08e908ed6d18d6a0,07225ba28ae309b6,2015-12-19,0,0,0,185,0,0,16,3,16,0,0,0,0,0,2,2,14,3,0.0,88.0
7068,0ad5c6752e679de5,6fb1ba67bef41b37,d1e7fc58d4225cdf,2015-12-19,0,2,0,900,6,3,132,38,132,0,0,0,0,0,31,21,101,38,0.0,758.4
7069,0ad5c6752e679de5,d1e7fc58d4225cdf,6fb1ba67bef41b37,2015-12-19,0,0,0,900,6,2,124,47,122,2,0,0,2,0,12,10,110,47,47.6,686.0
7070,ff389a4326fc9255,00e11b5c8b7bfeeb,3a8176e15b9887c1,2015-12-12,1,1,0,1092,4,2,191,96,96,95,1,1,94,72,33,29,63,24,292.0,726.6
7071,ff389a4326fc9255,3a8176e15b9887c1,00e11b5c8b7bfeeb,2015-12-12,0,0,0,1092,6,3,75,25,74,1,0,0,1,1,24,23,50,24,33.4,533.0
7072,fa2e2a035b36b9d6,9c65736747ca92ec,ee9ebceabfd16fa7,2015-12-12,1,0,0,206,1,1,48,22,30,18,0,0,18,14,10,10,20,8,30.0,176.0
7073,fa2e2a035b36b9d6,ee9ebceabfd16fa7,9c65736747ca92ec,2015-12-12,0,0,0,206,0,0,46,5,46,0,0,0,0,0,6,5,40,5,0.0,176.0
7074,f83c6bdd553b5851,7a703c565ccaa18f,f77c68bb4be8516d,2015-12-12,0,0,0,900,7,1,52,16,44,8,2,2,6,6,15,12,29,10,153.0,631.8
7075,f83c6bdd553b5851,f77c68bb4be8516d,7a703c565ccaa18f,2015-12-12,1,0,0,900,1,0,92,37,51,41,4,2,37,20,8,7,43,17,115.2,629.0
7076,d48f938269b8ed0b,523fa774700d7d3f,d53482bef23235ba,2015-12-12,0,0,0,900,13,2,99,28,77,22,0,0,22,19,32,30,45,9,359.6,475.0
7077,d48f938269b8ed0b,d53482bef23235ba,523fa774700d7d3f,2015-12-12,0,1,0,900,0,0,48,12,48,0,0,0,0,0,12,11,36,12,0.0,535.4
7078,c4fd59db24f978ec,78114b7199cef90c,9ba2226646046b63,2015-12-12,0,0,0,900,13,2,111,53,110,1,0,0,1,1,24,22,86,52,2.3,775.9
7079,c4fd59db24f978ec,9ba2226646046b63,78114b7199cef90c,2015-12-12,0,0,0,900,3,0,136,29,133,3,0,0,3,1,47,37,86,28,10.1,776.7
7080,b302e12550278ffd,d0f3959b4a9747e6,f4c49976c75c5ab2,2015-12-12,0,0,0,13,0,0,3,1,3,0,0,0,0,0,0,0,3,1,0.0,11.0
7081,b302e12550278ffd,f4c49976c75c5ab2,d0f3959b4a9747e6,2015-12-12,1,0,0,13,0,0,6,4,4,2,0,0,2,2,2,1,2,2,2.0,11.0
7082,8fe1859721e95ce3,427b5953ac8e3a27,fd55393021a8c255,2015-12-12,0,1,0,900,8,2,58,45,8,50,1,1,49,39,1,1,7,6,609.3,108.0
7083,8fe1859721e95ce3,fd55393021a8c255,427b5953ac8e3a27,2015-12-12,0,0,0,900,1,1,4,2,2,2,0,0,2,1,0,0,2,1,134.0,156.70000000000005
7084,5edfc539cc58a28d,31d7446b184e3305,a36556bb1565e32d,2015-12-12,1,0,0,114,0,0,27,13,22,5,0,0,5,5,5,5,17,8,3.3,108.0
7085,5edfc539cc58a28d,a36556bb1565e32d,31d7446b184e3305,2015-12-12,0,0,0,114,0,0,13,3,13,0,0,0,0,0,6,6,7,3,0.0,110.7
7086,3b321550c8b4aae6,150ff4cc642270b9,18968f97ad34f15c,2015-12-12,0,0,0,900,1,1,99,40,89,10,1,1,9,8,21,16,68,32,115.0,693.0
7087,3b321550c8b4aae6,18968f97ad34f15c,150ff4cc642270b9,2015-12-12,0,0,0,900,12,0,95,12,95,0,0,0,0,0,40,35,55,12,0.0,656.0
7088,0eab2845f901f8b6,1a98c9dbb7fc3959,31ef8b67e13495b3,2015-12-12,0,0,0,900,2,0,106,15,103,3,0,0,3,3,19,14,84,12,47.0,640.1
7089,0eab2845f901f8b6,31ef8b67e13495b3,1a98c9dbb7fc3959,2015-12-12,0,0,0,900,4,0,133,67,122,11,0,0,11,9,17,10,105,58,118.9,518.0
7090,064404b0aaf6f95d,813550bc53b15fb0,c21a036b4e012f1c,2015-12-12,1,0,0,900,1,0,268,50,268,0,0,0,0,0,41,30,227,50,0.0,886.0
7091,064404b0aaf6f95d,c21a036b4e012f1c,813550bc53b15fb0,2015-12-12,0,0,0,900,0,0,196,38,196,0,0,0,0,0,97,76,99,38,0.0,900.0
7092,01924e35b149b28f,d317a5e2b3f88c5f,dc9572dd6ec74859,2015-12-12,0,1,1,86,0,0,4,0,4,0,0,0,0,0,2,2,2,0,0.0,54.5
7093,01924e35b149b28f,dc9572dd6ec74859,d317a5e2b3f88c5f,2015-12-12,0,0,0,86,2,1,2,2,1,1,0,0,1,1,0,0,1,1,31.5,23.0
7094,ce82f34bc14f7af0,80d918336163b80c,bb1a2cdad6ff34db,2015-12-11,0,0,0,900,8,6,38,25,12,26,1,1,25,21,2,2,10,4,815.0,85.0
7095,ce82f34bc14f7af0,bb1a2cdad6ff34db,80d918336163b80c,2015-12-11,0,1,0,900,0,0,42,28,23,19,0,0,19,18,1,0,22,10,0.0,85.0
7096,c64c2ca5d4d2c7b8,22a92d7f62195791,64a50dad704d1d49,2015-12-11,0,1,1,474,2,0,116,42,100,16,0,0,16,15,21,19,79,27,19.8,336.0
7097,c64c2ca5d4d2c7b8,64a50dad704d1d49,22a92d7f62195791,2015-12-11,0,0,0,474,3,2,85,20,80,5,3,3,2,1,29,18,51,19,117.0,337.2
7098,c5ce4f39269c842c,b12fc8a41e82d3a2,c169545ab0825f44,2015-12-11,0,0,0,568,1,0,154,30,154,0,0,0,0,0,34,25,120,30,0.0,564.4
7099,c5ce4f39269c842c,c169545ab0825f44,b12fc8a41e82d3a2,2015-12-11,1,0,0,568,1,1,118,34,113,5,0,0,5,5,7,6,106,29,3.6,560.0
7100,b22dbe21c21060b9,6448e57a9533b7e4,feaf00f3373435d6,2015-12-11,0,0,0,900,10,2,189,55,189,0,0,0,0,0,46,39,143,55,0.0,727.2
7101,b22dbe21c21060b9,feaf00f3373435d6,6448e57a9533b7e4,2015-12-11,0,0,0,900,0,0,182,42,180,2,0,0,2,0,71,61,109,42,1.8,870.0
7102,a99c3328e25c51c7,22061ff217907c78,270b89c00ef0c55c,2015-12-11,0,0,0,900,0,0,51,12,51,0,0,0,0,0,3,3,48,12,0.0,752.4
7103,a99c3328e25c51c7,270b89c00ef0c55c,22061ff217907c78,2015-12-11,0,0,0,900,7,2,45,12,32,13,0,0,13,8,10,8,22,4,137.6,720.0
7104,991680cd8d0b7900,3bad7ef643840f67,e5c9de15bb58b1c6,2015-12-11,0,0,0,900,3,0,113,37,113,0,0,0,0,0,8,5,105,37,0.0,885.0
7105,991680cd8d0b7900,e5c9de15bb58b1c6,3bad7ef643840f67,2015-12-11,0,0,0,900,3,1,291,96,291,0,0,0,0,0,39,31,252,96,0.0,790.0
7106,465707233fa9cf7c,236a37d96d476164,4c7781da8c6cae93,2015-12-11,0,0,0,900,3,0,127,30,127,0,0,0,0,0,18,12,109,30,0.0,751.0
7107,465707233fa9cf7c,4c7781da8c6cae93,236a37d96d476164,2015-12-11,0,0,0,900,2,0,189,37,189,0,0,0,0,0,43,28,146,37,0.0,900.0
7108,18292c8eb20ae045,b5b684eac99ae0a3,f2688492b9a525a3,2015-12-11,0,0,0,148,0,0,17,1,17,0,0,0,0,0,4,4,13,1,0.0,147.0
7109,18292c8eb20ae045,f2688492b9a525a3,b5b684eac99ae0a3,2015-12-11,1,0,0,148,1,0,32,9,30,2,0,0,2,2,7,4,23,7,1.0,147.0
7110,1362ccc16713d404,902ec2cc48c8ae8a,aac6edb0d5e0b7e9,2015-12-11,0,2,0,900,3,2,108,31,104,4,1,1,3,2,36,29,68,29,31.9,559.0
7111,1362ccc16713d404,aac6edb0d5e0b7e9,902ec2cc48c8ae8a,2015-12-11,0,0,0,900,12,3,119,39,113,6,1,1,5,4,19,12,94,35,62.0,589.1
7112,1123fceef316106e,02f2a9702ba3d167,8866c6f509c19089,2015-12-11,0,0,0,900,0,0,11,1,10,1,0,0,1,1,1,1,9,0,305.0,150.0
7113,1123fceef316106e,8866c6f509c19089,02f2a9702ba3d167,2015-12-11,0,1,0,900,3,1,41,15,24,17,0,0,17,14,16,8,8,1,445.0,150.0
7114,f2ac86cd3e863243,64360e618823a8e4,aceffa19749c4dc0,2015-12-10,0,0,0,900,5,0,77,6,77,0,0,0,0,0,27,14,50,6,0.0,864.8
7115,f2ac86cd3e863243,aceffa19749c4dc0,64360e618823a8e4,2015-12-10,0,0,0,900,1,1,83,15,80,3,1,1,2,1,12,5,68,14,14.2,862.0
7116,d8fe965281e2e312,47b63240018d5d86,4d5197f331c47290,2015-12-10,0,4,1,1345,10,8,100,43,66,34,4,4,30,17,14,10,52,26,724.1,344.0
7117,d8fe965281e2e312,4d5197f331c47290,47b63240018d5d86,2015-12-10,0,0,0,1345,2,0,50,2,50,0,0,0,0,0,20,8,30,2,0.0,594.9
7118,cc1993d02d28a3b9,5904b0b38dc6718d,ed9d8ee3a4239b1c,2015-12-10,0,0,0,341,2,2,8,5,3,5,0,0,5,4,0,0,3,1,196.0,29.0
7119,cc1993d02d28a3b9,ed9d8ee3a4239b1c,5904b0b38dc6718d,2015-12-10,0,1,1,341,2,2,9,6,3,6,1,1,5,5,1,1,2,1,116.0,29.0
7120,8bfa9df5341c95c0,05b43e0ead3df345,c1ea9d56cd953586,2015-12-10,0,2,1,553,1,1,49,8,49,0,0,0,0,0,18,13,31,8,0.0,479.0
7121,8bfa9df5341c95c0,c1ea9d56cd953586,05b43e0ead3df345,2015-12-10,0,0,0,553,9,1,80,17,80,0,0,0,0,0,12,5,68,17,0.0,276.0
7122,69aa797cef2e4782,4b47e71384a9522f,fc31f896cde2bc2e,2015-12-10,1,0,0,321,0,0,70,22,69,1,0,0,1,1,21,15,48,21,1.3,317.0
7123,69aa797cef2e4782,fc31f896cde2bc2e,4b47e71384a9522f,2015-12-10,0,0,0,321,3,3,54,10,54,0,0,0,0,0,15,10,39,10,0.0,259.7
7124,633fbb0894c002d2,52e76bb4b3e852f3,8d9586726252dbf7,2015-12-10,0,0,0,11,0,0,4,0,4,0,0,0,0,0,1,1,3,0,0.0,11.0
7125,633fbb0894c002d2,8d9586726252dbf7,52e76bb4b3e852f3,2015-12-10,0,0,0,11,0,0,2,0,2,0,0,0,0,0,1,0,1,0,0.0,11.0
7126,5574c020655b435e,528c24b99fbaab79,cb696ebfb6598724,2015-12-10,0,0,0,558,0,0,24,0,24,0,0,0,0,0,13,4,11,0,0.0,357.5
7127,5574c020655b435e,cb696ebfb6598724,528c24b99fbaab79,2015-12-10,0,1,1,558,2,2,61,14,40,21,3,1,18,11,18,8,22,3,199.5,349.0
7128,3e875e1625bbdfbd,15ec018d144710db,a6cba6bb66c1a8c9,2015-12-10,0,0,0,166,1,1,27,10,25,2,0,0,2,2,3,1,22,8,43.0,123.0
7129,3e875e1625bbdfbd,a6cba6bb66c1a8c9,15ec018d144710db,2015-12-10,0,1,1,166,0,0,19,3,19,0,0,0,0,0,6,3,13,3,0.0,123.0
7130,3e6babcbd7b9d364,34f88592c0ab7a54,dea070ed4a2a8281,2015-12-10,0,0,0,900,13,1,94,3,94,0,0,0,0,0,45,25,49,3,0.0,488.2
7131,3e6babcbd7b9d364,dea070ed4a2a8281,34f88592c0ab7a54,2015-12-10,0,0,0,900,2,1,81,23,79,2,0,0,2,2,37,29,42,21,2.8,847.0
7132,3636ca71c557c5e8,69a400af4420cd6a,6d1bffff14897645,2015-12-10,0,0,0,265,2,2,34,5,34,0,0,0,0,0,11,9,23,5,0.0,242.5
7133,3636ca71c557c5e8,6d1bffff14897645,69a400af4420cd6a,2015-12-10,1,0,0,265,0,0,77,35,75,2,0,0,2,2,14,13,61,33,6.5,252.0
7134,1cc9816d18aa29d0,16690d100f995f8f,1bcaac2d99b90fce,2015-12-10,1,0,0,738,1,1,117,17,111,6,2,1,4,3,28,17,83,14,34.0,686.3
7135,1cc9816d18aa29d0,1bcaac2d99b90fce,16690d100f995f8f,2015-12-10,1,0,0,738,2,0,69,17,68,1,0,0,1,1,12,4,56,16,0.7,702.0
7136,045c298c72fe196a,c58f51dedb310998,d1941565abf50b16,2015-12-10,0,1,1,477,2,2,30,11,15,15,0,0,15,10,2,2,13,1,253.0,224.0
7137,045c298c72fe196a,d1941565abf50b16,c58f51dedb310998,2015-12-10,0,1,0,477,0,0,15,5,15,0,0,0,0,0,3,2,12,5,0.0,77.0
7138,e8d3768f293a699b,6905d45bd71b50a9,9a2d3567abc02e34,2015-11-28,0,1,0,900,12,3,91,25,89,2,0,0,2,2,13,6,76,23,128.0,503.5
7139,e8d3768f293a699b,9a2d3567abc02e34,6905d45bd71b50a9,2015-11-28,1,2,0,900,1,1,109,50,98,11,0,0,11,9,5,4,93,41,12.5,747.0
7140,caef4f8801f39345,4b1d46a1b5c0fd11,b0550072e5f0afa7,2015-11-28,1,0,0,900,15,2,153,46,149,4,0,0,4,3,28,23,121,43,6.4,786.4
7141,caef4f8801f39345,b0550072e5f0afa7,4b1d46a1b5c0fd11,2015-11-28,0,0,0,900,1,0,142,53,130,12,2,2,10,9,30,23,100,44,76.6,810.6
7142,a09bfdaa83d99efb,b8aef0faf4ce9b31,e93b04e308913c2e,2015-11-28,0,0,0,93,1,0,19,6,19,0,0,0,0,0,3,2,16,6,0.0,87.2
7143,a09bfdaa83d99efb,e93b04e308913c2e,b8aef0faf4ce9b31,2015-11-28,1,0,0,93,0,0,26,17,21,5,0,0,5,4,1,1,20,13,5.8,86.0
7144,982f4f96b6d0f346,2676b28836a5a836,47b9e0e7703a4868,2015-11-28,0,0,0,1500,12,3,146,42,144,2,0,0,2,2,59,44,85,40,27.5,1075.3
7145,982f4f96b6d0f346,47b9e0e7703a4868,2676b28836a5a836,2015-11-28,0,1,0,1500,5,1,156,38,154,2,0,0,2,2,44,39,110,36,12.7,1243.5
7146,85168b8d99f7ce42,1971869b7e054261,a00ec21cfbba17b6,2015-11-28,0,0,0,900,2,0,95,37,89,6,1,1,5,5,10,9,79,32,50.8,663.0
7147,85168b8d99f7ce42,a00ec21cfbba17b6,1971869b7e054261,2015-11-28,0,0,0,900,21,1,120,29,120,0,0,0,0,0,36,24,84,29,0.0,542.2
7148,7ac1c2f87b795742,2c1170b825f58e57,ec71a892fada28c7,2015-11-28,0,0,0,900,2,0,61,11,57,4,0,0,4,3,18,12,39,8,83.3,670.8
7149,7ac1c2f87b795742,ec71a892fada28c7,2c1170b825f58e57,2015-11-28,0,0,0,900,1,1,90,13,88,2,0,0,2,1,25,17,63,12,0.2,814.7
7150,6ec62f8822843edf,2de91c2244ad7e89,9bcf8603ceb25680,2015-11-28,0,0,0,191,0,0,0,0,0,0,0,0,0,0,0,0,0,0,0.0,35.099999999999994
7151,6ec62f8822843edf,9bcf8603ceb25680,2de91c2244ad7e89,2015-11-28,1,0,0,191,2,1,8,5,2,6,0,0,6,5,1,1,1,0,102.9,71.0
7152,5a79d4b9a8f8352f,68c11c27d4d56572,98a6b2361045898f,2015-11-28,1,0,0,627,4,4,61,35,31,30,0,0,30,21,3,1,28,14,253.6,255.0
7153,5a79d4b9a8f8352f,98a6b2361045898f,68c11c27d4d56572,2015-11-28,0,0,0,627,3,0,42,8,42,0,0,0,0,0,16,11,26,8,0.0,297.4
7154,3a932a4cacacc939,0ccab7c889ede9ea,5ea918ea81b7dee2,2015-11-28,1,0,0,44,2,1,5,1,5,0,0,0,0,0,3,2,2,1,0.0,40.0
7155,3a932a4cacacc939,5ea918ea81b7dee2,0ccab7c889ede9ea,2015-11-28,0,0,0,44,0,0,6,1,6,0,0,0,0,0,1,0,5,1,0.0,42.0
7156,3266f569a6246d90,92fa1401b7927da3,aed06011bf62237b,2015-11-28,1,0,0,410,1,0,41,8,41,0,0,0,0,0,19,14,22,8,0.0,197.7
7157,3266f569a6246d90,aed06011bf62237b,92fa1401b7927da3,2015-11-28,1,0,0,410,6,1,42,23,24,18,0,0,18,12,6,6,18,11,105.3,293.0
7158,0f641756e99605ad,165c244bcca3ed26,5f179af5fffeb9f6,2015-11-28,0,0,0,900,2,0,174,43,174,0,0,0,0,0,50,28,124,43,0.0,777.0
7159,0f641756e99605ad,5f179af5fffeb9f6,165c244bcca3ed26,2015-11-28,0,0,0,900,0,0,227,51,227,0,0,0,0,0,45,27,182,51,0.0,879.0
7160,f5eae75fc240aaa6,436f970c9ea9169c,8fd808923cffff82,2015-11-21,0,0,0,193,0,0,26,3,26,0,0,0,0,0,10,8,16,3,0.0,193.0
7161,f5eae75fc240aaa6,8fd808923cffff82,436f970c9ea9169c,2015-11-21,1,0,0,193,1,1,42,10,42,0,0,0,0,0,8,6,34,10,0.0,186.0
7162,e8d087f822be7b02,056c493bbd76a918,b102c26727306ab6,2015-11-21,0,0,0,900,3,2,110,11,110,0,0,0,0,0,47,32,63,11,0.0,824.0
7163,e8d087f822be7b02,b102c26727306ab6,056c493bbd76a918,2015-11-21,0,0,0,900,3,0,87,12,87,0,0,0,0,0,21,13,66,12,0.0,900.0
7164,d6482fcb69b04904,777dea713da2441d,e51fcd9cd84c0b93,2015-11-21,0,0,0,900,0,0,102,29,101,1,0,0,1,0,15,12,86,29,209.0,691.0
7165,d6482fcb69b04904,e51fcd9cd84c0b93,777dea713da2441d,2015-11-21,0,0,0,900,14,1,53,12,53,0,0,0,0,0,12,8,41,12,0.0,570.0
7166,d3ccf71e68480007,84b3e7d38f2d2ec5,8c0580d4fff106c1,2015-11-21,0,0,0,1500,14,6,145,41,140,5,0,0,5,4,24,13,116,37,72.6,922.4
7167,d3ccf71e68480007,8c0580d4fff106c1,84b3e7d38f2d2ec5,2015-11-21,2,0,0,1500,3,2,134,34,120,14,0,0,14,7,23,20,97,27,243.6,992.4
7168,84d89d2f36d07dc0,49f78022126bf4a4,edd02825c29028fe,2015-11-21,0,0,0,222,4,3,46,7,44,2,0,0,2,0,13,9,31,7,13.1,149.2
7169,84d89d2f36d07dc0,edd02825c29028fe,49f78022126bf4a4,2015-11-21,1,0,0,222,0,0,31,9,29,2,0,0,2,2,4,1,25,7,0.8,206.9
7170,83b32e9300fec365,8b1ed83b02303075,af62f99eb7606308,2015-11-21,1,1,0,900,1,0,78,12,78,0,0,0,0,0,13,8,65,12,0.0,469.0
7171,83b32e9300fec365,af62f99eb7606308,8b1ed83b02303075,2015-11-21,0,0,0,900,2,1,92,17,77,15,3,2,12,10,20,12,57,7,0.0,900.0
7172,4e3611c9a9e20ff0,159da492e000afbf,83fd97284f4bb4a4,2015-11-21,0,0,0,900,0,0,89,16,89,0,0,0,0,0,33,19,56,16,0.0,485.5
7173,4e3611c9a9e20ff0,83fd97284f4bb4a4,159da492e000afbf,2015-11-21,0,0,0,900,7,2,63,12,47,16,3,2,13,8,19,10,28,4,211.5,596.0
7174,44502b8c5546fb12,30b577b112bef42d,74d35fbc9c6a61bd,2015-11-21,0,0,0,30,0,0,8,0,8,0,0,0,0,0,5,2,3,0,0.0,29.0
7175,44502b8c5546fb12,74d35fbc9c6a61bd,30b577b112bef42d,2015-11-21,1,0,0,30,0,0,9,4,8,1,0,0,1,1,0,0,8,3,1.0,29.0
7176,4339e30a856c1da8,0b64d0fed453ef7f,80daefbed11ce998,2015-11-21,0,0,0,566,6,2,37,7,36,1,0,0,1,1,7,4,29,6,16.0,507.6
7177,4339e30a856c1da8,80daefbed11ce998,0b64d0fed453ef7f,2015-11-21,1,0,0,566,0,0,91,19,82,9,0,0,9,6,32,20,50,13,10.4,535.0
7178,34a39beb93225e2e,3974fa35c917af1d,82e7929bf6c2b689,2015-11-21,0,0,0,900,6,3,109,25,108,1,1,1,0,0,38,31,70,25,17.5,609.4
7179,34a39beb93225e2e,82e7929bf6c2b689,3974fa35c917af1d,2015-11-21,0,0,0,900,2,1,86,22,84,2,0,0,2,2,11,8,73,20,10.6,797.5
7180,2a702055a79d95a7,4b8fb0453a596b8e,e17ac6410c8377f4,2015-11-21,0,3,0,900,0,0,25,9,23,2,0,0,2,1,1,1,22,8,3.5,209.39999999999998
7181,2a702055a79d95a7,e17ac6410c8377f4,4b8fb0453a596b8e,2015-11-21,0,0,0,900,11,6,39,23,20,19,0,0,19,13,2,2,18,10,671.6,83.5
7182,0cbeda449bc94af7,be0b310a12eb80b4,cd85b48dc880fabd,2015-11-21,0,0,0,900,9,5,71,31,14,57,4,3,53,27,4,4,10,4,637.6,240.0
7183,0cbeda449bc94af7,cd85b48dc880fabd,be0b310a12eb80b4,2015-11-21,0,0,0,900,0,0,38,6,38,0,0,0,0,0,8,4,30,6,0.0,262.4
7184,06c124a55f77a7a5,23a6e307077c6ccc,8163cd7de0342652,2015-11-21,0,0,0,900,3,1,94,16,93,1,0,0,1,0,14,11,79,16,41.6,665.0
7185,06c124a55f77a7a5,8163cd7de0342652,23a6e307077c6ccc,2015-11-21,0,0,0,900,3,2,116,28,115,1,0,0,1,1,45,21,70,27,27.0,696.4
7186,f602cc168383432f,54578e5927adea53,8a9c6c4301f6d088,2015-11-14,0,0,0,900,3,3,156,42,151,5,0,0,5,5,26,21,125,37,20.0,466.0
7187,f602cc168383432f,8a9c6c4301f6d088,54578e5927adea53,2015-11-14,0,0,0,900,12,9,171,38,156,15,2,1,13,9,23,15,133,29,390.0,412.0
7188,f281a6775bccb8df,185fb0200a4605e6,303a05a7aa3ff761,2015-11-14,0,0,0,900,8,3,102,31,94,8,1,1,7,4,9,6,85,27,210.4,453.9
7189,f281a6775bccb8df,303a05a7aa3ff761,185fb0200a4605e6,2015-11-14,0,0,0,900,0,0,170,58,129,41,4,4,37,29,39,31,90,29,183.1,421.6
7190,d5149f02b1ee7dc6,6e92eb1242b46636,bdcbb976816fd256,2015-11-14,0,0,0,900,0,0,191,50,188,3,1,1,2,1,31,26,157,49,0.2,554.0
7191,d5149f02b1ee7dc6,bdcbb976816fd256,6e92eb1242b46636,2015-11-14,0,0,0,900,13,5,121,56,89,32,0,0,32,23,7,7,82,33,344.0,426.8
7192,d20dc2d68305fc31,8c822811eedc11ad,c06a9b48d4132c8e,2015-11-14,0,0,0,276,3,1,25,8,18,7,3,3,4,4,8,6,10,4,85.0,103.6
7193,d20dc2d68305fc31,c06a9b48d4132c8e,8c822811eedc11ad,2015-11-14,1,0,0,276,0,0,21,5,13,8,0,0,8,2,7,6,6,3,2.4,188.0
7194,98301c092f00cb01,91ea901c458e95dd,ebc1f40e00e0c481,2015-11-14,0,0,0,900,7,4,37,6,28,9,3,2,6,3,11,8,17,3,362.7,480.4
7195,98301c092f00cb01,ebc1f40e00e0c481,91ea901c458e95dd,2015-11-14,0,0,0,900,1,1,58,23,44,14,0,0,14,11,17,10,27,12,16.6,518.3
7196,77185ff8b4dade6a,1fcfc3709fe58151,7339d340aa2889cb,2015-11-14,0,0,0,121,0,0,6,2,6,0,0,0,0,0,1,0,5,2,0.0,107.0
7197,77185ff8b4dade6a,7339d340aa2889cb,1fcfc3709fe58151,2015-11-14,1,0,0,121,0,0,43,13,21,22,0,0,22,12,13,10,8,1,0.0,121.0
7198,766dc3c5592b4d0d,65578a75fa7900e3,e1147d3d2dabe1ce,2015-11-14,0,0,0,900,1,0,94,17,92,2,0,0,2,1,36,28,56,16,14.3,708.5
7199,766dc3c5592b4d0d,e1147d3d2dabe1ce,65578a75fa7900e3,2015-11-14,0,0,0,900,2,1,144,39,127,17,2,2,15,10,35,26,92,29,141.5,602.7
7200,391d458db6dae33b,3d6749c4267da18f,46a2f24feb258ae0,2015-11-14,0,0,0,1500,0,0,441,97,441,0,0,0,0,0,152,123,289,97,0.0,1304.0
7201,391d458db6dae33b,46a2f24feb258ae0,3d6749c4267da18f,2015-11-14,0,0,0,1500,5,1,321,72,316,5,1,1,4,4,45,30,271,68,10.0,1464.0
7202,27a6a6d4e3f8be75,8349d55cdecd393a,eef9b891edbd4604,2015-11-14,0,0,0,221,0,0,17,2,17,0,0,0,0,0,11,7,6,2,0.0,219.7
7203,27a6a6d4e3f8be75,eef9b891edbd4604,8349d55cdecd393a,2015-11-14,1,0,0,221,0,0,18,7,16,2,0,0,2,2,5,5,11,5,1.3,219.0
7204,1dfbdd569585812f,4b4753d19489297f,fcd448a2fe1a23cc,2015-11-14,0,0,0,176,0,0,32,6,32,0,0,0,0,0,2,0,30,6,0.0,176.0
7205,1dfbdd569585812f,fcd448a2fe1a23cc,4b4753d19489297f,2015-11-14,1,0,0,176,0,0,34,12,34,0,0,0,0,0,8,7,26,12,0.0,175.0
7206,15aced6a6a61df90,20999e27ddd94bda,840d2c82ea68b9aa,2015-11-14,0,0,0,155,1,0,6,1,6,0,0,0,0,0,0,0,6,1,0.0,32.3
7207,15aced6a6a61df90,840d2c82ea68b9aa,20999e27ddd94bda,2015-11-14,0,2,1,155,0,0,18,8,10,8,0,0,8,5,3,3,7,3,122.7,17.0
7208,0f85a1d9ce42d13e,a845f0735bc67405,c136b2a8852da5bd,2015-11-14,1,0,0,600,3,1,98,54,23,75,0,0,75,51,10,8,13,3,321.8,148.0
7209,0f85a1d9ce42d13e,c136b2a8852da5bd,a845f0735bc67405,2015-11-14,1,0,0,600,0,0,41,17,22,19,1,1,18,11,7,3,15,6,113.0,159.2
7210,08af25ef4252b138,634e2fb70bde3fd5,8bdac25ce0bb874d,2015-11-14,1,0,0,359,1,1,53,29,49,4,0,0,4,3,9,9,40,26,7.5,344.0
7211,08af25ef4252b138,8bdac25ce0bb874d,634e2fb70bde3fd5,2015-11-14,0,0,0,359,1,0,65,13,65,0,0,0,0,0,6,4,59,13,0.0,347.5
7212,f0b151cc6c91b259,23024fdfc966410a,7ea1f74cef32f906,2015-11-07,0,0,0,900,5,2,77,14,75,2,0,0,2,0,22,14,53,14,35.7,736.2
7213,f0b151cc6c91b259,7ea1f74cef32f906,23024fdfc966410a,2015-11-07,2,0,0,900,2,2,145,59,136,9,1,1,8,5,32,20,104,54,38.8,795.3
7214,e5461559114e30ff,1a31ef98efce7a79,6c011be66326ad97,2015-11-07,2,3,1,807,4,3,77,31,57,20,0,0,20,12,18,15,39,19,378.1,410.0
7215,e5461559114e30ff,6c011be66326ad97,1a31ef98efce7a79,2015-11-07,1,0,0,807,0,0,79,16,64,15,1,1,14,8,13,10,51,8,0.0,428.9
7216,dc4f7eaaa2c9d450,1f4b04a926ef1287,7cdd3e5d3aa9cb39,2015-11-07,1,0,0,900,0,0,159,46,141,18,1,1,17,13,41,27,100,33,90.0,760.0
7217,dc4f7eaaa2c9d450,7cdd3e5d3aa9cb39,1f4b04a926ef1287,2015-11-07,0,0,0,900,6,3,65,21,65,0,0,0,0,0,12,10,53,21,0.0,498.0
7218,d2198a7ae05b24c1,6bd02119599741a4,9c907996820d2d69,2015-11-07,0,0,0,900,7,0,183,31,183,0,0,0,0,0,63,35,120,31,0.0,891.0
7219,d2198a7ae05b24c1,9c907996820d2d69,6bd02119599741a4,2015-11-07,0,0,0,900,3,0,233,69,233,0,0,0,0,0,44,27,189,69,0.0,891.0
7220,b21e4b6c4126c782,8a59d346dc976a10,c47df9303d318c67,2015-11-07,0,1,1,39,0,0,7,2,7,0,0,0,0,0,0,0,7,2,0.0,38.0
7221,b21e4b6c4126c782,c47df9303d318c67,8a59d346dc976a10,2015-11-07,0,0,0,39,1,1,11,2,11,0,0,0,0,0,1,1,10,2,0.0,21.0
7222,a637cd1012af870f,57b10fca4f9c9a7a,a3be148af5c7b088,2015-11-07,1,0,0,651,4,0,109,32,105,4,0,0,4,2,14,10,91,30,17.6,438.7
7223,a637cd1012af870f,a3be148af5c7b088,57b10fca4f9c9a7a,2015-11-07,0,0,0,651,2,1,71,26,67,4,0,0,4,4,18,10,49,22,32.3,423.4
7224,93c4b798134c71d4,0ee783aa00e468f0,1ccf4e7caff270df,2015-11-07,1,0,0,127,0,0,11,5,4,7,0,0,7,3,1,1,3,2,4.9,120.0
7225,93c4b798134c71d4,1ccf4e7caff270df,0ee783aa00e468f0,2015-11-07,0,0,0,127,0,0,3,0,3,0,0,0,0,0,3,3,0,0,0.0,122.1
7226,6d9f6f7004c791d5,4bd6b4800070b069,6c7020b859c7a3ce,2015-11-07,0,2,1,416,3,2,18,7,12,6,0,0,6,6,3,0,9,1,143.1,121.0
7227,6d9f6f7004c791d5,6c7020b859c7a3ce,4bd6b4800070b069,2015-11-07,1,0,0,416,0,0,35,17,14,21,0,0,21,13,2,2,12,4,128.0,144.9
7228,4ff0075d932d5b14,7a39bbac8cc0fa70,d221ee27afc7a60e,2015-11-07,0,0,0,900,1,0,102,28,101,1,0,0,1,0,15,10,86,28,3.7,859.0
7229,4ff0075d932d5b14,d221ee27afc7a60e,7a39bbac8cc0fa70,2015-11-07,0,0,0,900,2,0,183,38,183,0,0,0,0,0,55,40,128,38,0.0,894.3
7230,3c6659f1b09760ba,2b074403b7c6cdb4,c5a126ace82a6025,2015-11-07,1,0,0,264,0,0,50,19,50,0,0,0,0,0,6,5,44,19,0.0,259.0
7231,3c6659f1b09760ba,c5a126ace82a6025,2b074403b7c6cdb4,2015-11-07,0,0,0,264,5,0,91,16,91,0,0,0,0,0,20,11,71,16,0.0,242.0
7232,37c732554828dcc3,75e5fec9f72910ef,e14b5aa06eea9653,2015-11-07,0,1,0,105,3,2,5,3,2,3,0,0,3,3,0,0,2,0,87.0,18.0
7233,37c732554828dcc3,e14b5aa06eea9653,75e5fec9f72910ef,2015-11-07,0,0,0,105,0,0,0,0,0,0,0,0,0,0,0,0,0,0,0.0,16.0
7234,2be2c9ddfbee0cd4,7ff97850e8c32bda,e51e5cb722bd47a8,2015-11-07,1,0,0,372,1,0,102,51,102,0,0,0,0,0,4,3,98,51,0.0,358.0
7235,2be2c9ddfbee0cd4,e51e5cb722bd47a8,7ff97850e8c32bda,2015-11-07,0,0,0,372,6,4,90,23,90,0,0,0,0,0,10,10,80,23,0.0,288.0
7236,0339f66f18a3e0bf,1fb80f46d3c105d9,5e4eec08896c9423,2015-11-07,0,0,0,900,0,0,54,16,54,0,0,0,0,0,17,10,37,16,0.0,733.3
7237,0339f66f18a3e0bf,5e4eec08896c9423,1fb80f46d3c105d9,2015-11-07,0,0,0,900,15,6,134,40,120,14,2,1,12,9,25,19,95,31,166.7,388.0
7238,cf3a93dd5460593c,1dafccb62a0f98ec,92a9aa9c93192871,2015-10-24,0,0,0,900,1,1,63,20,61,2,0,0,2,2,4,3,57,18,14.6,372.8
7239,cf3a93dd5460593c,92a9aa9c93192871,1dafccb62a0f98ec,2015-10-24,0,2,0,900,11,7,130,36,89,41,3,2,38,26,2,2,87,10,476.2,374.4
7240,a1569926652ebc36,0d0351c20169a499,49a74b9fb2e45fdf,2015-10-24,0,0,0,552,4,3,74,16,72,2,0,0,2,1,10,9,62,15,28.0,359.0
7241,a1569926652ebc36,49a74b9fb2e45fdf,0d0351c20169a499,2015-10-24,0,2,1,552,5,2,95,32,92,3,0,0,3,1,7,6,85,31,39.0,381.0
7242,8d1559bbcea7e92a,6e7c758f5cdec01a,d2bc285ead803db0,2015-10-24,0,0,0,549,9,4,40,6,27,13,7,7,6,2,6,3,21,4,208.0,119.1
7243,8d1559bbcea7e92a,d2bc285ead803db0,6e7c758f5cdec01a,2015-10-24,0,2,1,549,2,0,89,51,33,56,4,3,52,37,5,5,28,14,173.9,164.0
7244,665a35fcac41d277,31a13532e724ca2b,c575ab451e3c5b1d,2015-10-24,0,0,0,900,1,1,150,26,149,1,0,0,1,1,34,22,115,25,23.0,854.0
7245,665a35fcac41d277,c575ab451e3c5b1d,31a13532e724ca2b,2015-10-24,0,0,0,900,3,0,139,20,139,0,0,0,0,0,15,7,124,20,0.0,830.0
7246,5ae114b3fdef6d2f,14ff46596ad80609,e25bcbcdaf6537a1,2015-10-24,0,0,0,900,6,1,145,31,145,0,0,0,0,0,26,16,119,31,0.0,633.0
7247,5ae114b3fdef6d2f,e25bcbcdaf6537a1,14ff46596ad80609,2015-10-24,0,0,0,900,12,1,95,27,95,0,0,0,0,0,8,6,87,27,0.0,763.0
7248,475a41d83edd47dd,67a992d4cff22466,e50cd77732d39967,2015-10-24,0,0,0,900,1,1,44,12,30,14,1,1,13,2,11,6,19,10,68.1,205.10000000000002
7249,475a41d83edd47dd,e50cd77732d39967,67a992d4cff22466,2015-10-24,0,0,0,900,5,2,105,43,31,74,16,13,58,30,7,3,24,13,514.9,163.9
7250,43313a340ff0d2b5,132505067f08c54d,f215cfbd4ba3c270,2015-10-24,0,0,0,898,6,3,14,3,6,8,2,2,6,2,4,3,2,1,318.2,73.0
7251,43313a340ff0d2b5,f215cfbd4ba3c270,132505067f08c54d,2015-10-24,1,1,0,898,5,2,133,87,14,119,8,8,111,86,3,2,11,1,467.0,112.80000000000001
7252,3e39829aedc9346f,06827d70c53ff0d9,4e06913c91da5200,2015-10-24,0,1,0,900,1,0,67,7,64,3,1,1,2,2,17,14,47,5,42.6,572.1
7253,3e39829aedc9346f,4e06913c91da5200,06827d70c53ff0d9,2015-10-24,0,0,0,900,3,2,101,24,79,22,4,3,18,13,14,11,65,11,185.9,612.4
7254,2e0ae17a22a6f824,9ce6d5a03af801b7,9d19d9e4aa2662e8,2015-10-24,1,0,0,900,3,0,88,28,77,11,3,3,8,4,23,18,54,24,17.5,775.2
7255,2e0ae17a22a6f824,9d19d9e4aa2662e8,9ce6d5a03af801b7,2015-10-24,0,0,0,900,4,2,170,68,142,28,0,0,28,21,32,16,110,47,81.8,660.5
7256,2ad291d61792fd7d,1588b787bda7b540,99c7610aa74995d3,2015-10-24,1,0,0,277,0,0,35,20,35,0,0,0,0,0,3,3,32,20,0.0,274.0
7257,2ad291d61792fd7d,99c7610aa74995d3,1588b787bda7b540,2015-10-24,0,0,0,277,1,0,24,2,24,0,0,0,0,0,7,3,17,2,0.0,248.0
7258,fee873593f588437,97a6bbe6e6566a94,ed9d8ee3a4239b1c,2015-10-03,0,0,0,57,0,0,3,0,3,0,0,0,0,0,2,1,1,0,0.0,48.0
7259,fee873593f588437,ed9d8ee3a4239b1c,97a6bbe6e6566a94,2015-10-03,1,0,0,57,1,1,31,19,15,16,0,0,16,10,2,2,13,9,0.0,57.0
7260,f5de8b2c81e91129,3c6976f8182d9527,d967f0128c323de6,2015-10-03,1,0,0,1500,7,1,254,88,251,3,0,0,3,3,48,32,203,85,5.3,1421.3
7261,f5de8b2c81e91129,d967f0128c323de6,3c6976f8182d9527,2015-10-03,0,0,0,1500,5,1,283,111,276,7,0,0,7,6,43,29,233,105,20.7,1284.7
7262,e2e23aee91e27847,c0ab242c40decc55,ee779c43a8926d52,2015-10-03,0,0,0,900,6,1,133,45,133,0,0,0,0,0,13,7,120,45,0.0,836.0
7263,e2e23aee91e27847,ee779c43a8926d52,c0ab242c40decc55,2015-10-03,0,0,0,900,3,0,111,17,111,0,0,0,0,0,15,8,96,17,0.0,844.0
7264,c43e99000f3c77b5,3dd92ff9fb0412b3,80eacd4da0617c57,2015-10-03,0,0,0,900,5,0,121,22,121,0,0,0,0,0,18,9,103,22,0.0,881.0
7265,c43e99000f3c77b5,80eacd4da0617c57,3dd92ff9fb0412b3,2015-10-03,0,0,0,900,1,0,146,32,146,0,0,0,0,0,35,16,111,32,0.0,900.0
7266,bdc1561ed4c6e22f,3253b16d38ae087d,f72465a784c1b084,2015-10-03,0,3,0,900,6,3,68,22,53,15,3,3,12,10,13,9,40,12,243.3,393.2
7267,bdc1561ed4c6e22f,f72465a784c1b084,3253b16d38ae087d,2015-10-03,0,1,0,900,1,1,54,17,50,4,1,1,3,3,18,12,32,14,68.8,312.7
7268,7ab1cdfe3e540856,193b9d1858bc4df3,cbf5e6f231b55443,2015-10-03,0,0,0,900,3,1,79,14,71,8,0,0,8,4,17,5,54,10,125.6,526.5
7269,7ab1cdfe3e540856,cbf5e6f231b55443,193b9d1858bc4df3,2015-10-03,0,0,0,900,9,2,104,27,94,10,0,0,10,8,32,25,62,19,12.5,744.4
7270,678db400f85ae15c,275aca31f61ba28c,7dcf06c1967801c1,2015-10-03,0,0,0,106,0,0,15,2,15,0,0,0,0,0,2,2,13,2,0.0,104.0
7271,678db400f85ae15c,7dcf06c1967801c1,275aca31f61ba28c,2015-10-03,1,0,0,106,0,0,7,2,6,1,0,0,1,1,1,1,5,1,0.0,106.0
7272,4b790d75c4bc694c,369e1ce458ef50a6,ca2efc9d7d523c43,2015-10-03,0,0,0,900,0,0,116,56,116,0,0,0,0,0,15,15,101,56,0.0,823.0
7273,4b790d75c4bc694c,ca2efc9d7d523c43,369e1ce458ef50a6,2015-10-03,0,0,0,900,9,1,56,7,56,0,0,0,0,0,18,13,38,7,0.0,605.0
7274,32b030138bfd4f88,47b63240018d5d86,f0feeb2192937424,2015-10-03,0,1,1,167,1,1,33,12,33,0,0,0,0,0,1,1,32,12,0.0,96.0
7275,32b030138bfd4f88,f0feeb2192937424,47b63240018d5d86,2015-10-03,0,0,0,167,0,0,22,8,22,0,0,0,0,0,4,4,18,8,0.0,156.0
7276,2b3b6e96cea0f757,202b0467521c9d6f,d3df1add9d9a7efb,2015-10-03,0,0,0,675,13,5,13,4,5,8,3,3,5,3,1,1,4,1,381.3,174.8
7277,2b3b6e96cea0f757,d3df1add9d9a7efb,202b0467521c9d6f,2015-10-03,1,0,0,675,3,0,63,36,23,40,0,0,40,28,5,5,18,8,71.2,204.7
7278,278cd1803ccc004f,b2e3aca4cd363477,de75d1c45a39e221,2015-10-03,0,1,0,900,1,0,79,11,72,7,0,0,7,3,31,26,41,8,145.8,305.5
7279,278cd1803ccc004f,de75d1c45a39e221,b2e3aca4cd363477,2015-10-03,1,0,0,900,4,3,122,32,76,46,4,2,42,20,3,3,73,12,344.5,402.2
7280,2615d94ab16380f9,cf65d56b0755ed3b,ff6a1f63c254127e,2015-10-03,0,0,0,175,0,0,34,12,34,0,0,0,0,0,7,5,27,12,0.0,175.0
7281,2615d94ab16380f9,ff6a1f63c254127e,cf65d56b0755ed3b,2015-10-03,1,0,0,175,1,0,41,16,41,0,0,0,0,0,5,3,36,16,0.0,173.0
7282,e7e244a0bf244e61,3c0437fbeda06962,48e093ea1f43a053,2015-09-26,0,0,0,900,2,0,112,23,112,0,0,0,0,0,32,24,80,23,0.0,548.0
7283,e7e244a0bf244e61,48e093ea1f43a053,3c0437fbeda06962,2015-09-26,0,0,0,900,1,0,160,47,160,0,0,0,0,0,25,23,135,47,0.0,720.0
7284,b82b243982fcb2ac,633a45d131192ffe,bc8f6b42767e28df,2015-09-26,1,0,0,900,0,0,104,50,61,43,0,0,43,30,9,7,52,20,62.6,671.0
7285,b82b243982fcb2ac,bc8f6b42767e28df,633a45d131192ffe,2015-09-26,0,0,0,900,8,1,55,15,46,9,1,1,8,7,14,5,32,8,162.0,675.4
7286,85e1b21ea88fe7e3,65ddc8a9ac4e8531,e64b96c07d7ce999,2015-09-26,1,1,1,737,2,0,87,36,78,9,0,0,9,8,6,4,72,28,180.7,391.6
7287,85e1b21ea88fe7e3,e64b96c07d7ce999,65ddc8a9ac4e8531,2015-09-26,1,0,0,737,1,1,142,61,126,16,2,2,14,10,23,16,103,51,84.4,461.3
7288,74e86c7782cafe27,4665f9f909cd7214,fe5ca7ef93c3f6a7,2015-09-26,1,0,0,647,11,2,36,9,35,1,0,0,1,1,16,14,19,8,27.7,224.8
7289,74e86c7782cafe27,fe5ca7ef93c3f6a7,4665f9f909cd7214,2015-09-26,0,1,0,647,1,0,54,22,48,6,2,1,4,3,5,5,43,19,7.2,595.3
7290,6712440cd01dffdb,232c582f29f8f65e,65578a75fa7900e3,2015-09-26,0,1,0,325,1,1,24,14,4,20,1,1,19,14,2,2,2,0,286.0,27.0
7291,6712440cd01dffdb,65578a75fa7900e3,232c582f29f8f65e,2015-09-26,1,1,0,325,0,0,24,17,4,20,0,0,20,14,1,1,3,3,12.0,27.0
7292,374508c76108d7fe,2816ced060a21be3,3058888c33149a53,2015-09-26,0,0,0,900,0,0,112,33,112,0,0,0,0,0,17,13,95,33,0.0,898.0
7293,374508c76108d7fe,3058888c33149a53,2816ced060a21be3,2015-09-26,0,0,0,900,4,1,99,20,99,0,0,0,0,0,29,24,70,20,0.0,897.0
7294,34fd6ac116645ae6,3f7c14c7eca7195d,ad3f53c454cbbead,2015-09-26,0,0,0,1500,10,4,114,38,111,3,0,0,3,3,29,22,82,35,27.2,1028.0
7295,34fd6ac116645ae6,ad3f53c454cbbead,3f7c14c7eca7195d,2015-09-26,0,0,0,1500,0,0,205,92,205,0,0,0,0,0,58,54,147,92,0.0,970.8
7296,2ab47d509ee7dc6d,35faad160d346839,88cd34d836b4ebcd,2015-09-26,0,0,0,900,5,2,183,55,183,0,0,0,0,0,18,7,165,55,0.0,694.3
7297,2ab47d509ee7dc6d,88cd34d836b4ebcd,35faad160d346839,2015-09-26,2,0,0,900,1,0,168,62,167,1,0,0,1,1,34,26,133,61,0.7,890.0
7298,26ac85fc4bee63a6,32be4b7f7de1c905,98aa60cf58071fd6,2015-09-26,0,0,0,900,3,0,191,53,191,0,0,0,0,0,16,10,175,53,0.0,876.0
7299,26ac85fc4bee63a6,98aa60cf58071fd6,32be4b7f7de1c905,2015-09-26,0,0,0,900,5,0,224,59,224,0,0,0,0,0,29,19,195,59,0.0,880.0
7300,1c5bed46920ab3e1,44470bfd9483c7ad,c2e3e67b5911bfb7,2015-09-26,0,0,0,28,0,0,1,0,1,0,0,0,0,0,1,1,0,0,0.0,24.0
7301,1c5bed46920ab3e1,c2e3e67b5911bfb7,44470bfd9483c7ad,2015-09-26,1,0,0,28,0,0,17,11,14,3,0,0,3,2,3,3,11,9,2.0,20.0
7302,e0f8e1e8cbdd63da,1e1dbd1cc5a7469e,365fee2da473b177,2015-09-05,0,0,0,328,0,0,20,1,20,0,0,0,0,0,9,7,11,1,0.0,217.6
7303,e0f8e1e8cbdd63da,365fee2da473b177,1e1dbd1cc5a7469e,2015-09-05,1,0,0,328,2,2,42,16,37,5,0,0,5,3,11,9,26,13,59.4,126.0
7304,c43805df4f45b6e2,ae7fe94f117f98cf,d38e8c6ae2dfc051,2015-09-05,0,0,0,900,0,0,162,35,162,0,0,0,0,0,18,14,144,35,0.0,891.0
7305,c43805df4f45b6e2,d38e8c6ae2dfc051,ae7fe94f117f98cf,2015-09-05,0,0,0,900,3,1,166,49,166,0,0,0,0,0,22,9,144,49,0.0,852.0
7306,86afc59ec117c1ba,6dd758d34da8d254,d512d9f204059f57,2015-09-05,0,0,0,448,0,0,36,18,33,3,0,0,3,3,7,6,26,15,9.8,197.9
7307,86afc59ec117c1ba,d512d9f204059f57,6dd758d34da8d254,2015-09-05,1,0,0,448,2,2,61,31,31,30,1,1,29,19,5,3,26,12,224.1,199.2
7308,7e1ae27779ac6ba5,5e4eec08896c9423,99df7d0a2a08a8a8,2015-09-05,0,0,0,900,4,4,150,72,77,73,6,5,67,53,12,7,65,19,562.9,254.2
7309,7e1ae27779ac6ba5,99df7d0a2a08a8a8,5e4eec08896c9423,2015-09-05,0,1,0,900,1,1,43,13,42,1,0,0,1,1,8,7,34,12,5.8,314.1
7310,777df8b5e28f42ff,8ce87f7e3a9baed2,cc900c6a71ed23f3,2015-09-05,0,1,0,900,4,1,122,25,121,1,0,0,1,1,37,27,84,24,16.7,592.3
7311,777df8b5e28f42ff,cc900c6a71ed23f3,8ce87f7e3a9baed2,2015-09-05,1,0,0,900,2,1,210,60,186,24,3,2,21,13,29,22,157,47,90.7,747.3
7312,6f5f4b256f643ffb,1ff9589f9065a9ed,3738e68d2261e60f,2015-09-05,0,0,0,900,5,1,52,16,43,9,1,1,8,5,7,7,36,11,119.5,661.0
7313,6f5f4b256f643ffb,3738e68d2261e60f,1ff9589f9065a9ed,2015-09-05,0,0,0,900,0,0,74,22,74,0,0,0,0,0,18,17,56,22,0.0,568.5
7314,52f0398eb74c139d,7ea4a9f07df33a45,c268b2cfebccf652,2015-09-05,0,0,0,128,1,0,36,13,35,1,0,0,1,1,3,3,32,12,0.8,104.5
7315,52f0398eb74c139d,c268b2cfebccf652,7ea4a9f07df33a45,2015-09-05,1,1,1,128,0,0,60,21,39,21,2,1,19,10,11,6,28,11,10.5,108.2
7316,4496c2fa6aaccba6,8a304bfd6bf04a57,99506df1af6c8b3b,2015-09-05,0,0,0,1500,13,4,171,57,171,0,0,0,0,0,46,31,125,57,0.0,1201.0
7317,4496c2fa6aaccba6,99506df1af6c8b3b,8a304bfd6bf04a57,2015-09-05,0,0,0,1500,3,1,121,16,121,0,0,0,0,0,52,42,69,16,0.0,1325.0
7318,1b52b08f195581ad,6a1901c62ab3870f,fc169c387b4b465d,2015-09-05,0,1,0,598,5,4,66,19,66,0,0,0,0,0,26,22,40,19,0.0,368.4
7319,1b52b08f195581ad,fc169c387b4b465d,6a1901c62ab3870f,2015-09-05,0,1,1,598,2,2,68,26,64,4,0,0,4,2,16,15,48,24,21.6,414.0
7320,05d2534e0f2d5042,26b63bc5c0c1f65d,4d5197f331c47290,2015-09-05,0,1,0,661,4,0,47,23,47,0,0,0,0,0,11,7,36,23,0.0,594.1
7321,05d2534e0f2d5042,4d5197f331c47290,26b63bc5c0c1f65d,2015-09-05,0,1,1,661,7,3,130,37,123,7,1,1,6,6,51,35,72,31,38.9,227.0
7322,0449c55a8c24a59e,4f732e58ed907eff,e5010b1b94ca5755,2015-09-05,0,0,0,900,1,1,116,28,111,5,0,0,5,0,43,34,68,28,57.2,693.6
7323,0449c55a8c24a59e,e5010b1b94ca5755,4f732e58ed907eff,2015-09-05,0,0,0,900,0,0,151,35,145,6,1,0,5,5,28,25,117,30,23.4,725.8
7324,961246a6d621ef40,55ee431411ccf07a,57bad6a84230f0c9,2015-08-23,0,0,0,900,10,6,8,0,8,0,0,0,0,0,4,3,4,0,0.0,119.0
7325,961246a6d621ef40,57bad6a84230f0c9,55ee431411ccf07a,2015-08-23,0,1,0,900,0,0,29,22,8,21,0,0,21,20,1,1,7,2,55.0,845.0
7326,870a98d6f943d9b7,a8283a4f415e1eb9,c03a5022f8439f2a,2015-08-23,1,0,0,163,0,0,36,15,17,19,0,0,19,11,2,2,15,4,34.4,125.0
7327,870a98d6f943d9b7,c03a5022f8439f2a,a8283a4f415e1eb9,2015-08-23,0,0,0,163,0,0,17,3,17,0,0,0,0,0,5,5,12,3,0.0,128.6
7328,785dd27b03946f95,55f446032177b119,56c9acc4e86046a2,2015-08-23,0,0,0,900,4,2,113,42,93,20,1,1,19,13,6,4,87,29,210.3,468.8
7329,785dd27b03946f95,56c9acc4e86046a2,55f446032177b119,2015-08-23,0,0,0,900,9,1,109,33,99,10,0,0,10,6,23,17,76,27,84.2,529.7
7330,499557c33e67deaf,6da99156486ed6c2,9fa3bd637edd9aa2,2015-08-23,0,0,0,686,1,1,91,26,91,0,0,0,0,0,25,19,66,26,0.0,519.3
7331,499557c33e67deaf,9fa3bd637edd9aa2,6da99156486ed6c2,2015-08-23,1,0,0,686,4,0,93,48,73,20,0,0,20,20,23,12,50,28,106.7,526.0
7332,3945b08be8d62861,501b07aec9b8fc2d,96c336b463e0662c,2015-08-23,0,0,0,54,0,0,16,1,16,0,0,0,0,0,2,1,14,1,0.0,50.0
7333,3945b08be8d62861,96c336b463e0662c,501b07aec9b8fc2d,2015-08-23,1,0,0,54,0,0,15,8,8,7,0,0,7,6,4,4,4,2,4.0,50.0
7334,2d23ca9d8abc0c97,52ba464d9068d871,784285b7ae7dd85f,2015-08-23,0,0,0,900,14,2,40,9,36,4,1,1,3,2,15,12,21,7,278.0,298.7
7335,2d23ca9d8abc0c97,784285b7ae7dd85f,52ba464d9068d871,2015-08-23,0,0,0,900,5,2,69,26,52,17,2,2,15,12,20,16,32,14,184.3,351.0
7336,2c01f4df404ff6ee,5866fc86183a9fb8,84b3e7d38f2d2ec5,2015-08-23,0,0,0,900,4,3,59,10,58,1,0,0,1,0,23,19,35,10,41.5,578.8
7337,2c01f4df404ff6ee,84b3e7d38f2d2ec5,5866fc86183a9fb8,2015-08-23,0,0,0,900,9,4,131,59,112,19,0,0,19,15,10,9,102,44,155.2,613.5
7338,22e5596f75d9d8e7,67f272324a030d00,eeabcd4dc6619129,2015-08-23,1,0,0,285,4,3,29,20,12,17,1,1,16,16,3,3,9,4,165.3,110.0
7339,22e5596f75d9d8e7,eeabcd4dc6619129,67f272324a030d00,2015-08-23,0,0,0,285,0,0,14,1,14,0,0,0,0,0,9,5,5,1,0.0,90.69999999999999
7340,21d6db22c6089308,1091d4d957141094,ab943cd2c3c17825,2015-08-23,0,1,1,149,1,0,29,16,24,5,0,0,5,4,6,5,18,12,36.9,31.0
7341,21d6db22c6089308,ab943cd2c3c17825,1091d4d957141094,2015-08-23,0,2,0,149,0,0,10,3,10,0,0,0,0,0,2,2,8,3,0.0,112.1
7342,20b70a226f1c13fb,46a2f24feb258ae0,b4192a975027aab6,2015-08-23,1,0,0,900,1,1,145,51,138,7,0,0,7,3,23,18,115,48,214.3,502.0
7343,20b70a226f1c13fb,b4192a975027aab6,46a2f24feb258ae0,2015-08-23,0,0,0,900,0,0,161,34,161,0,0,0,0,0,27,21,134,34,0.0,685.7
7344,1bf7f647f309464e,71002dbc1743b9a7,b4eeac608fc82f88,2015-08-23,0,1,1,261,1,0,6,2,3,3,1,1,2,2,2,1,1,0,11.2,28.0
7345,1bf7f647f309464e,b4eeac608fc82f88,71002dbc1743b9a7,2015-08-23,0,0,0,261,2,2,10,5,6,4,0,0,4,3,1,0,5,2,218.0,31.8
7346,05e2832cd5ffb7a6,07225ba28ae309b6,150ff4cc642270b9,2015-08-23,0,0,0,99,1,0,17,3,17,0,0,0,0,0,2,2,15,3,0.0,99.0
7347,05e2832cd5ffb7a6,150ff4cc642270b9,07225ba28ae309b6,2015-08-23,1,0,0,99,0,0,29,6,29,0,0,0,0,0,9,8,20,6,0.0,93.0
7348,e2535e0753954514,a4de54ea806fb525,c169545ab0825f44,2015-08-08,0,2,0,900,3,3,53,22,7,46,5,4,41,22,0,0,7,0,835.0,50.0
7349,e2535e0753954514,c169545ab0825f44,a4de54ea806fb525,2015-08-08,0,0,0,900,0,0,13,6,7,6,0,0,6,5,1,1,6,1,15.0,50.0
7350,d757f19f3d34934b,2525a853486ee670,9ba2226646046b63,2015-08-08,0,0,0,900,9,3,113,29,113,0,0,0,0,0,31,26,82,29,0.0,767.4
7351,d757f19f3d34934b,9ba2226646046b63,2525a853486ee670,2015-08-08,0,1,0,900,6,1,183,48,177,6,0,0,6,4,41,32,136,44,17.6,739.0
7352,d4e98b827e3d6918,08af939f41b5a57b,511e82663651438d,2015-08-08,0,0,0,900,7,0,201,52,201,0,0,0,0,0,32,23,169,52,0.0,900.0
7353,d4e98b827e3d6918,511e82663651438d,08af939f41b5a57b,2015-08-08,0,0,0,900,0,0,222,32,222,0,0,0,0,0,89,52,133,32,0.0,900.0
7354,bd6d144f5c0b6cab,7be74a12d7352df2,80fa8218c99f9c58,2015-08-08,0,0,0,173,2,0,16,1,16,0,0,0,0,0,3,1,13,1,0.0,128.1
7355,bd6d144f5c0b6cab,80fa8218c99f9c58,7be74a12d7352df2,2015-08-08,1,1,1,173,0,0,39,24,20,19,0,0,19,15,6,3,14,9,38.9,130.0
7356,b0c2442c5a7c509a,cd01f0b768a32475,dfae5da5676e4194,2015-08-08,1,0,0,50,0,0,8,4,6,2,0,0,2,2,0,0,6,2,13.0,37.0
7357,b0c2442c5a7c509a,dfae5da5676e4194,cd01f0b768a32475,2015-08-08,0,0,0,50,1,0,4,0,4,0,0,0,0,0,1,0,3,0,0.0,37.0
7358,9d72aaaf34e5b512,91ea901c458e95dd,cc900af167fbedfd,2015-08-08,0,1,0,900,5,2,34,16,25,9,0,0,9,8,3,3,22,8,65.2,696.8
7359,9d72aaaf34e5b512,cc900af167fbedfd,91ea901c458e95dd,2015-08-08,0,0,0,900,4,3,57,20,54,3,0,0,3,2,7,6,47,18,58.2,310.8
7360,9900550cc697eef2,b1a3e0aca758b322,d156513a19acf856,2015-08-08,1,0,0,139,1,0,45,26,43,2,0,0,2,1,1,1,42,25,5.9,47.0
7361,9900550cc697eef2,d156513a19acf856,b1a3e0aca758b322,2015-08-08,0,0,0,139,0,0,11,2,11,0,0,0,0,0,2,2,9,2,0.0,133.1
7362,92f27d13fc502d33,6ded9184b2284645,f53c1f4ceeed8c08,2015-08-08,0,0,0,778,0,0,32,5,32,0,0,0,0,0,13,8,19,5,0.0,232.5
7363,92f27d13fc502d33,f53c1f4ceeed8c08,6ded9184b2284645,2015-08-08,1,1,0,778,13,4,129,75,43,86,7,6,79,67,13,11,30,8,545.5,131.0
7364,664e56d8a98e2b49,04b39f4e8eb59d7c,65578a75fa7900e3,2015-08-08,0,0,0,152,0,0,12,1,11,1,0,0,1,0,6,6,5,1,0.0,56.0
7365,664e56d8a98e2b49,65578a75fa7900e3,04b39f4e8eb59d7c,2015-08-08,1,0,0,152,1,1,18,11,3,15,0,0,15,11,0,0,3,0,96.0,56.0
7366,50d5a170516de2ad,72c4b253d2f5ebf2,7c7332319c14094c,2015-08-08,0,0,0,435,7,1,29,11,21,8,0,0,8,6,4,3,17,5,188.9,122.9
7367,50d5a170516de2ad,7c7332319c14094c,72c4b253d2f5ebf2,2015-08-08,0,2,1,435,0,0,48,17,30,18,0,0,18,12,10,8,20,5,5.1,240.1
7368,503a9ac5679c9cf7,4f11e9ce318ffbcb,df1eb4354d18a906,2015-08-08,0,0,0,760,0,0,112,23,112,0,0,0,0,0,8,8,104,23,0.0,714.0
7369,503a9ac5679c9cf7,df1eb4354d18a906,4f11e9ce318ffbcb,2015-08-08,0,1,1,760,3,1,138,43,138,0,0,0,0,0,38,28,100,43,0.0,506.0
7370,2ef16a5ff3710c92,50db8711c70196cd,7ff97850e8c32bda,2015-08-08,0,0,0,790,3,0,54,18,51,3,0,0,3,2,14,12,37,16,13.6,231.60000000000002
7371,2ef16a5ff3710c92,7ff97850e8c32bda,50db8711c70196cd,2015-08-08,0,1,1,790,9,5,79,48,28,51,1,1,50,37,6,4,22,11,472.4,248.4
7372,00dcad4611fc63fe,6809c31286b08d97,6c2030e0a143a94b,2015-08-08,0,0,0,900,8,1,140,31,140,0,0,0,0,0,61,51,79,31,0.0,792.0
7373,00dcad4611fc63fe,6c2030e0a143a94b,6809c31286b08d97,2015-08-08,0,2,0,900,4,3,146,65,146,0,0,0,0,0,29,22,117,65,0.0,636.0
7374,f7ffa11d592f4092,d05412b513b19621,f95381efb3051d81,2015-08-01,0,0,0,900,7,4,51,13,43,8,0,0,8,4,23,19,20,9,79.0,407.5
7375,f7ffa11d592f4092,f95381efb3051d81,d05412b513b19621,2015-08-01,0,0,0,900,15,1,38,9,26,12,0,0,12,7,11,4,15,2,255.5,459.0
7376,b0367c907cc549c0,ebc1f40e00e0c481,ee9d73f4fee9cbdd,2015-08-01,0,0,0,900,0,0,156,43,156,0,0,0,0,0,54,50,102,43,0.0,862.0
7377,b0367c907cc549c0,ee9d73f4fee9cbdd,ebc1f40e00e0c481,2015-08-01,0,0,0,900,14,1,113,43,113,0,0,0,0,0,18,16,95,43,0.0,578.0
7378,aa62b8f58fc09790,140745cbbcb023ac,73e09f837f3b5ecc,2015-08-01,0,0,0,900,5,2,98,30,92,6,0,0,6,4,24,23,68,26,111.0,641.0
7379,aa62b8f58fc09790,73e09f837f3b5ecc,140745cbbcb023ac,2015-08-01,0,1,0,900,0,0,166,55,166,0,0,0,0,0,10,8,156,55,0.0,776.0
7380,959de17703476f44,4bcb6eb12b4ad4aa,92b62174c175ce19,2015-08-01,1,0,0,458,1,1,75,52,16,59,0,0,59,49,9,5,7,3,198.3,93.0
7381,959de17703476f44,92b62174c175ce19,4bcb6eb12b4ad4aa,2015-08-01,0,0,0,458,5,1,34,11,26,8,3,3,5,3,1,1,25,8,160.0,79.69999999999999
7382,8baa6b8850262595,60029bcf496bd707,8349d55cdecd393a,2015-08-01,0,0,0,341,3,1,35,15,11,24,1,1,23,13,4,3,7,2,159.0,170.0
7383,8baa6b8850262595,8349d55cdecd393a,60029bcf496bd707,2015-08-01,1,0,0,341,1,0,28,10,26,2,0,0,2,1,6,6,20,9,12.0,92.0
7384,7c9830ee4835f757,2f95a3c6d58b2aad,d1e1fdcea7c8a90a,2015-08-01,0,0,0,900,0,0,101,42,81,20,3,2,17,12,12,9,69,30,72.8,443.0
7385,7c9830ee4835f757,d1e1fdcea7c8a90a,2f95a3c6d58b2aad,2015-08-01,0,0,0,900,10,1,55,21,32,23,2,1,21,12,13,4,19,9,326.0,501.2
7386,72330020a732c635,49858bf46dabf6fb,d317a5e2b3f88c5f,2015-08-01,0,0,0,551,2,0,34,8,34,0,0,0,0,0,11,9,23,8,0.0,338.6
7387,72330020a732c635,d317a5e2b3f88c5f,49858bf46dabf6fb,2015-08-01,0,1,1,551,3,2,38,9,34,4,0,0,4,2,9,8,25,7,147.4,293.0
7388,60c62fb7bd17a8b3,673ea7dcc786b1b3,8bdac25ce0bb874d,2015-08-01,0,0,0,34,0,0,14,9,14,0,0,0,0,0,0,0,14,9,0.0,34.0
7389,60c62fb7bd17a8b3,8bdac25ce0bb874d,673ea7dcc786b1b3,2015-08-01,1,0,0,34,0,0,32,17,32,0,0,0,0,0,2,2,30,17,0.0,30.0
7390,480aca1906276700,8270c00fae24c922,f9081770e28ea2e1,2015-08-01,0,3,0,900,4,3,109,24,103,6,1,1,5,2,31,21,72,22,39.1,606.3
7391,480aca1906276700,f9081770e28ea2e1,8270c00fae24c922,2015-08-01,0,2,0,900,1,0,105,39,81,24,4,3,20,16,21,17,60,23,130.7,653.9
7392,431e7931d8be8b5d,00a3ff40c4b2cf21,b8c0f30ee9a98b69,2015-08-01,0,1,1,886,9,4,31,6,24,7,3,2,4,3,16,15,8,3,233.3,486.0
7393,431e7931d8be8b5d,b8c0f30ee9a98b69,00a3ff40c4b2cf21,2015-08-01,0,0,0,886,11,2,32,14,32,0,0,0,0,0,7,6,25,14,0.0,316.7
7394,2116affb9c8f193b,5c1ca0c72b599a3c,e51e5cb722bd47a8,2015-08-01,0,0,0,645,0,0,45,20,37,8,0,0,8,7,3,3,34,13,2.2,312.0
7395,2116affb9c8f193b,e51e5cb722bd47a8,5c1ca0c72b599a3c,2015-08-01,1,0,0,645,14,8,92,37,59,33,4,4,29,20,11,8,48,17,330.0,212.8
7396,17daeb7e36e60cdf,427b5953ac8e3a27,84b3e7d38f2d2ec5,2015-08-01,0,1,1,472,2,2,17,13,0,17,0,0,17,13,0,0,0,0,447.0,25.0
7397,17daeb7e36e60cdf,84b3e7d38f2d2ec5,427b5953ac8e3a27,2015-08-01,0,0,0,472,0,0,4,0,4,0,0,0,0,0,0,0,4,0,0.0,23.0
7398,0bf405dabb25251a,8f382b3baa954d2a,ec34349e7dffcde7,2015-08-01,0,0,0,900,3,0,189,35,189,0,0,0,0,0,37,35,152,35,0.0,842.6
7399,0bf405dabb25251a,ec34349e7dffcde7,8f382b3baa954d2a,2015-08-01,0,0,0,900,4,4,248,95,247,1,0,0,1,1,19,16,228,94,10.4,744.0
7400,f963d716384153ff,2c99576fefe53c7c,c849740a3ff51931,2015-07-25,0,0,0,935,5,0,181,31,181,0,0,0,0,0,52,31,129,31,0.0,915.8
7401,f963d716384153ff,c849740a3ff51931,2c99576fefe53c7c,2015-07-25,1,0,0,935,5,0,212,84,211,1,1,1,0,0,39,32,172,84,10.2,598.0
7402,e8f499827178a321,484acc7b0f856ce9,6e0273f9478be71e,2015-07-25,0,0,0,900,0,0,204,61,192,12,1,1,11,8,56,36,136,53,0.0,811.6
7403,e8f499827178a321,6e0273f9478be71e,484acc7b0f856ce9,2015-07-25,1,0,0,900,3,2,186,65,179,7,1,0,6,2,29,26,150,63,88.4,521.0
7404,da7d7b4f20cd2af5,5f99b2bafb10305f,8f6a18831a120817,2015-07-25,0,0,0,87,0,0,19,3,19,0,0,0,0,0,4,3,15,3,0.0,84.0
7405,da7d7b4f20cd2af5,8f6a18831a120817,5f99b2bafb10305f,2015-07-25,0,1,1,87,1,1,15,5,15,0,0,0,0,0,5,5,10,5,0.0,77.0
7406,cd55220a7b1378c4,4d44f37107f01b9b,fcd448a2fe1a23cc,2015-07-25,1,0,0,327,1,0,52,17,52,0,0,0,0,0,5,5,47,17,0.0,324.0
7407,cd55220a7b1378c4,fcd448a2fe1a23cc,4d44f37107f01b9b,2015-07-25,0,0,0,327,1,1,64,18,64,0,0,0,0,0,16,13,48,18,0.0,324.0
7408,c97e99ca5422f03b,64a50dad704d1d49,e5010b1b94ca5755,2015-07-25,0,0,0,900,1,0,135,19,135,0,0,0,0,0,57,45,78,19,0.0,900.0
7409,c97e99ca5422f03b,e5010b1b94ca5755,64a50dad704d1d49,2015-07-25,0,0,0,900,1,0,150,22,150,0,0,0,0,0,36,25,114,22,0.0,882.0
7410,c1bfbf5447f21f37,4ba8d454f762005d,68c11c27d4d56572,2015-07-25,1,0,0,43,0,0,30,14,30,0,0,0,0,0,0,0,30,14,0.0,42.0
7411,c1bfbf5447f21f37,68c11c27d4d56572,4ba8d454f762005d,2015-07-25,0,0,0,43,0,0,2,1,2,0,0,0,0,0,1,1,1,1,0.0,43.0
7412,bb56f4e502512ad0,3bad7ef643840f67,3be081c29bf734d9,2015-07-25,1,0,0,157,1,1,26,15,15,11,0,0,11,11,0,0,15,4,67.0,90.0
7413,bb56f4e502512ad0,3be081c29bf734d9,3bad7ef643840f67,2015-07-25,0,0,0,157,0,0,24,2,24,0,0,0,0,0,8,5,16,2,0.0,90.0
7414,6275b448b6c35f1f,d1941565abf50b16,d1e7fc58d4225cdf,2015-07-25,0,0,0,900,3,2,110,21,108,2,0,0,2,2,32,24,76,19,37.1,686.0
7415,6275b448b6c35f1f,d1e7fc58d4225cdf,d1941565abf50b16,2015-07-25,0,0,0,900,6,0,103,22,100,3,0,0,3,2,21,13,79,20,84.0,722.9
7416,53efc226c8eaf768,a7ddae0be8b78147,dcbf01d605681ad1,2015-07-25,0,3,0,900,3,2,80,27,78,2,0,0,2,1,12,9,66,26,24.9,350.1
7417,53efc226c8eaf768,dcbf01d605681ad1,a7ddae0be8b78147,2015-07-25,0,1,0,900,4,2,101,43,80,21,1,1,20,13,7,5,73,30,350.9,474.1
7418,23fd9d50a99665fe,5ef0088c1b19beeb,fc9a9559a05f2704,2015-07-25,0,0,0,900,12,0,190,51,190,0,0,0,0,0,14,10,176,51,0.0,827.0
7419,23fd9d50a99665fe,fc9a9559a05f2704,5ef0088c1b19beeb,2015-07-25,0,0,0,900,1,0,180,38,180,0,0,0,0,0,23,14,157,38,0.0,897.0
7420,23a75c0338d25abc,22aa91e402d0fe1f,66ab58d0b3783607,2015-07-25,0,0,0,900,6,6,63,24,47,16,2,1,14,7,5,4,42,17,218.1,288.3
7421,23a75c0338d25abc,66ab58d0b3783607,22aa91e402d0fe1f,2015-07-25,0,2,0,900,3,0,39,13,27,12,0,0,12,10,9,7,18,3,93.7,478.9
7422,05065fa2bc3693b4,b96619b3acd7d9da,f72465a784c1b084,2015-07-25,1,2,0,900,4,1,122,38,99,23,7,7,16,13,15,13,84,25,325.5,532.0
7423,05065fa2bc3693b4,f72465a784c1b084,b96619b3acd7d9da,2015-07-25,0,0,0,900,0,0,143,38,143,0,0,0,0,0,22,18,121,38,0.0,568.5
7424,d45474993a750878,12f91bfa8f1f723b,5f179af5fffeb9f6,2015-07-18,1,0,0,900,4,3,140,57,113,27,0,0,27,14,41,33,72,43,306.5,253.0
7425,d45474993a750878,5f179af5fffeb9f6,12f91bfa8f1f723b,2015-07-18,0,0,0,900,0,0,92,49,80,12,0,0,12,9,9,8,71,40,0.0,593.5
7426,c7780ac294530c0d,19db7ac26308178f,654ae722109a0d31,2015-07-18,0,0,0,185,2,0,15,4,15,0,0,0,0,0,5,3,10,4,0.0,116.0
7427,c7780ac294530c0d,654ae722109a0d31,19db7ac26308178f,2015-07-18,0,1,1,185,0,0,29,5,29,0,0,0,0,0,3,3,26,5,0.0,185.0
7428,b0cb6a1da8e0da81,523f6ad11dbe9b53,e9a3aeb207578eea,2015-07-18,0,0,0,56,0,0,5,1,5,0,0,0,0,0,1,1,4,1,0.0,54.0
7429,b0cb6a1da8e0da81,e9a3aeb207578eea,523f6ad11dbe9b53,2015-07-18,1,0,0,56,0,0,9,4,7,2,0,0,2,2,4,3,3,2,2.0,54.0
7430,9cbdbbc414d6dd83,81801f57bd0a7c41,9c907996820d2d69,2015-07-18,0,0,0,89,0,0,17,4,17,0,0,0,0,0,5,5,12,4,0.0,88.0
7431,9cbdbbc414d6dd83,9c907996820d2d69,81801f57bd0a7c41,2015-07-18,1,0,0,89,0,0,27,10,26,1,0,0,1,1,7,5,19,9,1.0,88.0
7432,979538ff8ae1ccd5,9310418684bc896f,f1fac969a1d70b08,2015-07-18,0,0,0,900,4,0,78,10,77,1,0,0,1,0,20,14,57,10,2.2,581.4
7433,979538ff8ae1ccd5,f1fac969a1d70b08,9310418684bc896f,2015-07-18,1,0,0,900,4,0,71,28,59,12,0,0,12,10,11,8,48,18,298.6,474.8
7434,976d2cc3d08ca814,31a13532e724ca2b,8bbc0cfc01bc1ba1,2015-07-18,1,0,0,150,0,0,41,16,37,4,0,0,4,3,6,3,31,13,1.3,148.0
7435,976d2cc3d08ca814,8bbc0cfc01bc1ba1,31a13532e724ca2b,2015-07-18,0,0,0,150,0,0,40,8,40,0,0,0,0,0,21,15,19,8,0.0,148.7
7436,7e9cb0c322773157,8f4eeaf7a0df7c1a,c575ab451e3c5b1d,2015-07-18,0,1,0,900,11,3,61,28,50,11,1,1,10,6,6,6,44,22,177.8,293.0
7437,7e9cb0c322773157,c575ab451e3c5b1d,8f4eeaf7a0df7c1a,2015-07-18,0,0,0,900,1,0,85,24,69,16,3,2,13,9,21,17,48,15,413.0,309.2
7438,486fbba33876da4b,6e7c758f5cdec01a,8bb6f4479685bbcc,2015-07-18,0,2,0,900,3,1,75,18,69,6,0,0,6,6,27,10,42,12,472.0,360.2
7439,486fbba33876da4b,8bb6f4479685bbcc,6e7c758f5cdec01a,2015-07-18,0,1,0,900,0,0,51,19,35,16,2,1,14,9,8,7,27,10,67.8,356.0
7440,3bb7210200d90d90,1dafccb62a0f98ec,3f56b99447f00607,2015-07-18,1,0,0,184,1,0,37,14,30,7,0,0,7,5,8,6,22,9,3.5,180.0
7441,3bb7210200d90d90,3f56b99447f00607,1dafccb62a0f98ec,2015-07-18,0,0,0,184,0,0,31,10,31,0,0,0,0,0,3,1,28,10,0.0,180.5
7442,2e47823d38a5649b,2b93ebd9f5417ad2,cfb65863d5099327,2015-07-18,0,0,0,1500,0,0,277,73,275,2,0,0,2,2,48,42,227,71,10.0,1465.0
7443,2e47823d38a5649b,cfb65863d5099327,2b93ebd9f5417ad2,2015-07-18,0,0,0,1500,4,1,194,49,194,0,0,0,0,0,38,30,156,49,0.0,1432.0
7444,2e12db181792090f,470fedbc8563ac47,e51ee8ded927fc51,2015-07-18,1,0,0,48,0,0,20,14,18,2,0,0,2,1,1,1,17,13,0.0,48.0
7445,2e12db181792090f,e51ee8ded927fc51,470fedbc8563ac47,2015-07-18,0,0,0,48,0,0,12,1,12,0,0,0,0,0,1,0,11,1,0.0,46.0
7446,0b8fdeeb626b4396,4f732e58ed907eff,e5c9de15bb58b1c6,2015-07-18,0,0,0,900,0,0,28,10,26,2,0,0,2,2,8,6,18,8,1.7,573.2
7447,0b8fdeeb626b4396,e5c9de15bb58b1c6,4f732e58ed907eff,2015-07-18,0,1,0,900,13,5,48,19,36,12,0,0,12,10,9,7,27,9,316.8,238.3
7448,fd984e8a9e25c927,634e2fb70bde3fd5,c7d297714d9ab1a4,2015-07-15,0,0,0,900,1,1,178,27,176,2,1,0,1,0,74,38,102,27,25.0,850.0
7449,fd984e8a9e25c927,c7d297714d9ab1a4,634e2fb70bde3fd5,2015-07-15,0,0,0,900,0,0,75,5,75,0,0,0,0,0,40,21,35,5,0.0,875.0
7450,ea967877dd4d6efb,0b64d0fed453ef7f,cc6f9d1e89f3449a,2015-07-15,0,0,0,900,2,1,74,24,71,3,0,0,3,2,12,12,59,22,18.2,644.4
7451,ea967877dd4d6efb,cc6f9d1e89f3449a,0b64d0fed453ef7f,2015-07-15,1,2,0,900,13,5,95,26,83,12,1,1,11,4,22,15,61,22,164.6,593.8
7452,d447919ec1a9f34c,539ed332b3078821,6a1901c62ab3870f,2015-07-15,0,1,0,900,8,0,56,16,56,0,0,0,0,0,4,2,52,16,0.0,314.0
7453,d447919ec1a9f34c,6a1901c62ab3870f,539ed332b3078821,2015-07-15,0,0,0,900,4,3,90,36,46,44,4,4,40,29,12,10,34,7,547.0,353.0
7454,c3b733bf084c2cd0,4e0692ad070976e4,8a70ceb3edbe757b,2015-07-15,1,0,0,517,0,0,106,41,93,13,0,0,13,9,18,14,75,32,19.9,491.0
7455,c3b733bf084c2cd0,8a70ceb3edbe757b,4e0692ad070976e4,2015-07-15,0,0,0,517,0,0,97,12,97,0,0,0,0,0,13,8,84,12,0.0,468.1
7456,c0e8095c91c39b06,22a92d7f62195791,a566371ba2ad7152,2015-07-15,1,2,0,900,1,0,149,51,125,24,0,0,24,21,58,32,67,30,90.0,752.8
7457,c0e8095c91c39b06,a566371ba2ad7152,22a92d7f62195791,2015-07-15,0,0,0,900,6,1,100,17,95,5,0,0,5,3,23,16,72,14,42.2,658.0
7458,b8019af428c064ef,c06a9b48d4132c8e,ee9ebceabfd16fa7,2015-07-15,0,0,0,176,0,0,18,1,18,0,0,0,0,0,6,5,12,1,0.0,170.0
7459,b8019af428c064ef,ee9ebceabfd16fa7,c06a9b48d4132c8e,2015-07-15,0,1,1,176,2,1,28,4,28,0,0,0,0,0,8,5,20,4,0.0,108.0
7460,a16d8d0cc93372c4,7c6e87729e824ef4,8d9586726252dbf7,2015-07-15,0,0,0,900,0,0,66,11,65,1,0,0,1,1,11,9,54,10,6.7,654.5
7461,a16d8d0cc93372c4,8d9586726252dbf7,7c6e87729e824ef4,2015-07-15,0,0,0,900,3,1,86,26,68,18,2,2,16,13,24,13,44,13,225.5,655.3
7462,541e5c7a87712fc2,3623bd267a2eef2e,b8aef0faf4ce9b31,2015-07-15,0,1,0,900,9,1,37,10,37,0,0,0,0,0,12,8,25,10,0.0,557.0
7463,541e5c7a87712fc2,b8aef0faf4ce9b31,3623bd267a2eef2e,2015-07-15,0,4,0,900,2,2,41,10,34,7,0,0,7,6,6,2,28,4,253.0,394.0
7464,5301d765d64f863e,0d8011111be000b2,dbea8c1cb327ab3d,2015-07-15,1,2,0,900,3,3,169,61,130,39,5,5,34,17,8,5,122,44,186.0,571.0
7465,5301d765d64f863e,dbea8c1cb327ab3d,0d8011111be000b2,2015-07-15,0,0,0,900,3,0,82,11,82,0,0,0,0,0,45,28,37,11,0.0,696.0
7466,464133df9ca19865,8f0d576beba1cfcd,cf65d56b0755ed3b,2015-07-15,1,0,0,900,1,0,117,23,112,5,0,0,5,1,19,6,93,22,4.4,799.5
7467,464133df9ca19865,cf65d56b0755ed3b,8f0d576beba1cfcd,2015-07-15,1,0,0,900,1,1,104,31,89,15,2,2,13,6,29,18,60,25,86.5,722.6
7468,3b83ec99accfd271,1ff9589f9065a9ed,bda04c573563cc2e,2015-07-15,1,0,0,73,0,0,37,15,35,2,0,0,2,1,1,1,34,14,0.1,72.0
7469,3b83ec99accfd271,bda04c573563cc2e,1ff9589f9065a9ed,2015-07-15,0,0,0,73,0,0,24,8,24,0,0,0,0,0,2,1,22,8,0.0,67.9
7470,3100a4e29da974ad,94527830000ab715,f3a078277b3b8ff4,2015-07-15,0,2,0,900,11,4,68,14,68,0,0,0,0,0,15,10,53,14,0.0,510.5
7471,3100a4e29da974ad,f3a078277b3b8ff4,94527830000ab715,2015-07-15,0,0,0,900,0,0,44,12,43,1,0,0,1,0,15,12,28,12,70.5,618.0
7472,d4e3baff532df842,cf615eb4b7862c76,f1b2aa7853d1ed6e,2015-07-12,0,0,0,379,0,0,11,3,11,0,0,0,0,0,1,0,10,3,0.0,141.2
7473,d4e3baff532df842,f1b2aa7853d1ed6e,cf615eb4b7862c76,2015-07-12,0,1,1,379,8,6,26,10,13,13,0,0,13,7,5,5,8,3,237.8,68.0
7474,c8ec30a470f08748,12f1b140e248bdb9,f50d95223751e6ca,2015-07-12,0,3,0,900,8,3,22,10,16,6,1,1,5,5,5,4,11,5,219.3,379.5
7475,c8ec30a470f08748,f50d95223751e6ca,12f1b140e248bdb9,2015-07-12,1,3,0,900,2,1,26,10,22,4,0,0,4,4,5,3,17,6,118.5,295.7
7476,b823aa523c9618b5,0c5c66ddd1886b83,9deff9e3e8d94d47,2015-07-12,0,0,0,172,0,0,8,3,8,0,0,0,0,0,1,0,7,3,0.0,172.0
7477,b823aa523c9618b5,9deff9e3e8d94d47,0c5c66ddd1886b83,2015-07-12,0,1,1,172,0,0,19,3,19,0,0,0,0,0,13,9,6,3,0.0,102.0
7478,b2eccc1b75633d3d,2de91c2244ad7e89,6c7e25571490aa3b,2015-07-12,0,0,0,900,5,5,53,12,51,2,0,0,2,2,2,1,49,10,162.5,292.7
7479,b2eccc1b75633d3d,6c7e25571490aa3b,2de91c2244ad7e89,2015-07-12,0,3,0,900,2,2,96,29,61,35,11,7,24,16,20,18,41,13,282.3,374.5
7480,96740aa476055413,6ded9184b2284645,bffeb123b21c9aad,2015-07-12,1,0,0,96,0,0,33,15,22,11,0,0,11,10,5,4,17,5,13.0,83.0
7481,96740aa476055413,bffeb123b21c9aad,6ded9184b2284645,2015-07-12,0,0,0,96,1,0,13,0,13,0,0,0,0,0,4,4,9,0,0.0,83.0
7482,95233ca23cdb02e6,bd878a638e0e3be3,eb04b9d31e938edb,2015-07-12,0,1,0,758,1,1,24,3,24,0,0,0,0,0,7,5,17,3,0.0,205.0
7483,95233ca23cdb02e6,eb04b9d31e938edb,bd878a638e0e3be3,2015-07-12,0,4,1,758,3,3,60,25,42,18,0,0,18,13,23,22,19,12,78.0,641.0
7484,8410fb6d495a2cc2,1971869b7e054261,4a1329cc8eb0928a,2015-07-12,0,0,0,16,0,0,5,0,5,0,0,0,0,0,2,1,3,0,0.0,16.0
7485,8410fb6d495a2cc2,4a1329cc8eb0928a,1971869b7e054261,2015-07-12,1,0,0,16,0,0,7,3,7,0,0,0,0,0,1,1,6,3,0.0,15.0
7486,54a15700ab185420,4a28cb716c19157a,d81ac739417d7f53,2015-07-12,2,0,0,269,3,1,35,17,25,10,0,0,10,7,6,3,19,10,89.2,153.0
7487,54a15700ab185420,d81ac739417d7f53,4a28cb716c19157a,2015-07-12,1,0,0,269,1,0,14,4,14,0,0,0,0,0,2,1,12,4,0.0,178.8
7488,44e3a7b4f4c7d95d,d0c29452d3272603,f797f0c57a83353e,2015-07-12,0,1,0,900,1,0,59,10,59,0,0,0,0,0,16,15,43,10,0.0,362.20000000000005
7489,44e3a7b4f4c7d95d,f797f0c57a83353e,d0c29452d3272603,2015-07-12,0,0,0,900,3,1,76,41,44,32,3,3,29,24,7,7,37,17,532.8,184.0
7490,43b9e58ebf4a75ea,3f1d23b01c552a13,6d4b63c767106d3a,2015-07-12,0,0,0,900,10,7,45,22,35,10,1,1,9,7,9,4,26,15,233.5,203.9
7491,43b9e58ebf4a75ea,6d4b63c767106d3a,3f1d23b01c552a13,2015-07-12,0,1,0,900,0,0,57,13,44,13,13,9,0,0,9,6,35,13,159.1,458.5
7492,11aac355349ecc94,47b9e0e7703a4868,dbc17725b887860a,2015-07-12,1,0,0,262,0,0,23,8,19,4,0,0,4,4,6,4,13,4,1.0,260.0
7493,11aac355349ecc94,dbc17725b887860a,47b9e0e7703a4868,2015-07-12,0,0,0,262,3,1,18,5,18,0,0,0,0,0,8,2,10,5,0.0,170.0
7494,ecb4534c0066c5f3,cbd5d3cdd862e90e,f2925e6db404bf1d,2015-07-11,0,0,0,1260,4,0,222,70,222,0,0,0,0,0,33,16,189,70,0.0,1255.2
7495,ecb4534c0066c5f3,f2925e6db404bf1d,cbd5d3cdd862e90e,2015-07-11,1,0,0,1260,0,0,156,68,153,3,0,0,3,2,7,2,146,66,2.8,1249.0
7496,c4a7f7d8eb8fe484,31123249b0bbf52e,4b47e71384a9522f,2015-07-11,0,1,1,284,1,1,37,18,36,1,1,1,0,0,6,6,30,18,11.8,178.0
7497,c4a7f7d8eb8fe484,4b47e71384a9522f,31123249b0bbf52e,2015-07-11,0,0,0,284,2,0,40,13,40,0,0,0,0,0,8,3,32,13,0.0,255.2
7498,b90eded8d6b65e8f,3e61082025db8137,5904b0b38dc6718d,2015-07-11,0,1,0,900,0,0,76,6,74,2,0,0,2,0,29,20,45,6,72.0,828.0
7499,b90eded8d6b65e8f,5904b0b38dc6718d,3e61082025db8137,2015-07-11,0,0,0,900,7,5,98,13,98,0,0,0,0,0,7,2,91,13,0.0,401.0
7500,a9d8ddb49dbe414b,2b074403b7c6cdb4,c945adc22c2bfe8f,2015-07-11,1,0,0,329,0,0,55,17,55,0,0,0,0,0,10,7,45,17,0.0,316.8
7501,a9d8ddb49dbe414b,c945adc22c2bfe8f,2b074403b7c6cdb4,2015-07-11,1,0,0,329,1,0,55,17,53,2,0,0,2,1,7,3,46,16,11.2,301.0
7502,9f56b3c053c44060,49a74b9fb2e45fdf,d2bc285ead803db0,2015-07-11,1,3,0,900,0,0,43,19,35,8,0,0,8,7,2,2,33,12,17.0,484.9
7503,9f56b3c053c44060,d2bc285ead803db0,49a74b9fb2e45fdf,2015-07-11,0,5,0,900,10,6,45,12,35,10,0,0,10,6,12,11,23,6,381.1,159.0
7504,8c8c2499d89da07c,01fcef7e3d051722,d8c7c61b176e3994,2015-07-11,0,0,0,900,0,0,106,22,106,0,0,0,0,0,29,13,77,22,0.0,860.2
7505,8c8c2499d89da07c,d8c7c61b176e3994,01fcef7e3d051722,2015-07-11,1,0,0,900,6,3,158,57,146,12,0,0,12,6,11,7,135,51,39.8,847.0
7506,824368db1ed8191f,9fe85152f351e737,a2b12c3f3d60ff69,2015-07-11,0,0,0,900,0,0,94,14,94,0,0,0,0,0,9,5,85,14,0.0,589.3
7507,824368db1ed8191f,a2b12c3f3d60ff69,9fe85152f351e737,2015-07-11,0,0,0,900,5,5,102,22,92,10,0,0,10,5,5,2,87,17,301.7,538.0
7508,70290140b6a8e038,b5b684eac99ae0a3,f4c49976c75c5ab2,2015-07-11,0,0,0,597,7,4,48,28,28,20,0,0,20,16,3,3,25,12,275.7,276.0
7509,70290140b6a8e038,f4c49976c75c5ab2,b5b684eac99ae0a3,2015-07-11,1,0,0,597,0,0,92,31,84,8,0,0,8,7,30,15,54,24,4.0,317.3
7510,4d3cbc7608c8958e,18968f97ad34f15c,6f242453c91a5af0,2015-07-11,2,0,0,632,2,0,73,26,65,8,1,1,7,6,16,11,49,20,8.0,532.8
7511,4d3cbc7608c8958e,6f242453c91a5af0,18968f97ad34f15c,2015-07-11,0,0,0,632,6,1,82,23,78,4,0,0,4,4,18,12,60,19,79.2,327.0
7512,4b997af9fb321123,638cfec7ec559d6e,fd55393021a8c255,2015-07-11,0,0,0,174,0,0,14,0,14,0,0,0,0,0,9,8,5,0,0.0,117.3
7513,4b997af9fb321123,fd55393021a8c255,638cfec7ec559d6e,2015-07-11,1,1,1,174,0,0,8,6,6,2,0,0,2,2,1,0,5,4,56.7,89.0
7514,2c5d329bdf182468,99c7610aa74995d3,fc31f896cde2bc2e,2015-07-11,0,1,0,900,2,0,87,11,87,0,0,0,0,0,43,34,44,11,0.0,851.6
7515,2c5d329bdf182468,fc31f896cde2bc2e,99c7610aa74995d3,2015-07-11,0,0,0,900,1,0,88,35,87,1,0,0,1,1,17,13,70,34,3.4,805.0
7516,fd80d6d9f4e54387,57b10fca4f9c9a7a,e82d5f54daa85a7e,2015-06-27,0,2,0,900,16,5,33,7,29,4,0,0,4,2,8,4,21,5,207.7,184.1
7517,fd80d6d9f4e54387,e82d5f54daa85a7e,57b10fca4f9c9a7a,2015-06-27,0,0,0,900,2,0,39,16,26,13,0,0,13,11,9,7,17,5,92.9,542.3
7518,babfd62f1d4a43a8,159da492e000afbf,2ff2e6e5abea3e53,2015-06-27,0,0,0,900,8,3,48,15,48,0,0,0,0,0,19,13,29,15,0.0,568.3
7519,babfd62f1d4a43a8,2ff2e6e5abea3e53,159da492e000afbf,2015-06-27,0,0,0,900,6,2,56,10,48,8,2,1,6,4,14,10,34,6,106.7,620.0
7520,913d6763b570d060,2525a853486ee670,8a9c6c4301f6d088,2015-06-27,1,0,0,900,10,5,146,48,143,3,0,0,3,3,7,4,136,45,34.1,582.0
7521,913d6763b570d060,8a9c6c4301f6d088,2525a853486ee670,2015-06-27,0,0,0,900,0,0,184,35,184,0,0,0,0,0,35,24,149,35,0.0,858.9
7522,87b0475688168a42,6d1bffff14897645,9450848a71d53776,2015-06-27,0,0,0,487,3,0,101,19,101,0,0,0,0,0,19,14,82,19,0.0,410.3
7523,87b0475688168a42,9450848a71d53776,6d1bffff14897645,2015-06-27,1,0,0,487,0,0,115,41,101,14,0,0,14,11,27,23,74,30,21.7,456.0
7524,7ad6511fb5fb28a4,dea070ed4a2a8281,e023fa2e648ea0f1,2015-06-27,1,0,0,29,0,0,4,1,4,0,0,0,0,0,2,2,2,1,0.0,28.0
7525,7ad6511fb5fb28a4,e023fa2e648ea0f1,dea070ed4a2a8281,2015-06-27,0,0,0,29,0,0,1,0,1,0,0,0,0,0,0,0,1,0,0.0,29.0
7526,72d6996a60856b5f,938ad489fb7a1f31,ed209f6618c82e41,2015-06-27,0,0,0,900,8,2,65,16,55,10,3,2,7,5,22,19,33,11,182.1,554.0
7527,72d6996a60856b5f,ed209f6618c82e41,938ad489fb7a1f31,2015-06-27,0,1,0,900,10,3,33,4,33,0,0,0,0,0,13,13,20,4,0.0,515.9
7528,665e9a25c5d8c17f,57bad6a84230f0c9,6e92eb1242b46636,2015-06-27,1,0,0,163,1,0,19,8,16,3,0,0,3,3,2,2,14,5,16.5,130.0
7529,665e9a25c5d8c17f,6e92eb1242b46636,57bad6a84230f0c9,2015-06-27,0,0,0,163,0,0,28,7,28,0,0,0,0,0,2,2,26,7,0.0,146.5
7530,5b51610a9c8c88ef,52e76bb4b3e852f3,8cad40a75e5c97f5,2015-06-27,0,1,1,877,8,4,78,27,67,11,1,1,10,9,15,12,52,18,285.4,287.0
7531,5b51610a9c8c88ef,8cad40a75e5c97f5,52e76bb4b3e852f3,2015-06-27,0,0,0,877,1,0,45,10,44,1,0,0,1,1,3,2,41,9,149.0,442.6
7532,42d09ca167ecae07,f77c68bb4be8516d,f7a7f7118d4b01b6,2015-06-27,1,0,0,698,2,1,70,16,64,6,1,1,5,5,38,25,26,11,4.3,693.0
7533,42d09ca167ecae07,f7a7f7118d4b01b6,f77c68bb4be8516d,2015-06-27,0,0,0,698,0,0,64,6,64,0,0,0,0,0,37,25,27,6,0.0,693.7
7534,e00da416750f75a9,06827d70c53ff0d9,81b8b3fb019dc69d,2015-06-20,2,0,0,172,1,0,16,7,15,1,0,0,1,1,5,4,10,6,0.6,167.0
7535,e00da416750f75a9,81b8b3fb019dc69d,06827d70c53ff0d9,2015-06-20,0,0,0,172,1,0,21,9,21,0,0,0,0,0,3,2,18,9,0.0,95.4
7536,cd7fd3f034717d3c,040a74bb0a465c54,f2ad06f1007c481a,2015-06-20,0,1,1,701,4,1,75,20,71,4,0,0,4,4,8,3,63,16,53.2,508.9
7537,cd7fd3f034717d3c,f2ad06f1007c481a,040a74bb0a465c54,2015-06-20,0,0,0,701,4,2,66,27,60,6,0,0,6,6,12,8,48,21,59.1,440.8
7538,c1322d09e8b6efca,5f87a5c00b3d17ed,80d918336163b80c,2015-06-20,0,1,0,900,0,0,60,10,60,0,0,0,0,0,15,12,45,10,0.0,391.0
7539,c1322d09e8b6efca,80d918336163b80c,5f87a5c00b3d17ed,2015-06-20,0,0,0,900,14,4,39,15,34,5,1,1,4,4,7,6,27,11,509.0,391.0
7540,951ccd0041bd1700,2816ced060a21be3,fb41432b622992a9,2015-06-20,0,0,0,900,3,1,126,37,126,0,0,0,0,0,22,17,104,37,0.0,844.0
7541,951ccd0041bd1700,fb41432b622992a9,2816ced060a21be3,2015-06-20,0,0,0,900,1,0,86,17,86,0,0,0,0,0,19,9,67,17,0.0,850.0
7542,7045f8c1d5f6abff,39cc64bf0a269db9,9f755fb04cc21499,2015-06-20,0,1,0,900,5,4,31,5,31,0,0,0,0,0,12,6,19,5,0.0,450.8
7543,7045f8c1d5f6abff,9f755fb04cc21499,39cc64bf0a269db9,2015-06-20,0,1,0,900,3,1,100,49,74,26,2,1,24,17,16,12,58,32,109.2,648.0
7544,447462bc8e540f10,4638cc6479cc0afe,87a1dc546b1c5caf,2015-06-20,0,0,0,101,0,0,1,0,1,0,0,0,0,0,1,1,0,0,0.0,101.0
7545,447462bc8e540f10,87a1dc546b1c5caf,4638cc6479cc0afe,2015-06-20,0,2,1,101,1,1,0,0,0,0,0,0,0,0,0,0,0,0,0.0,22.0
7546,312c742e614f8993,7c3c48cf54a2848e,8b1ed83b02303075,2015-06-20,0,0,0,386,6,1,41,3,41,0,0,0,0,0,21,13,20,3,0.0,285.7
7547,312c742e614f8993,8b1ed83b02303075,7c3c48cf54a2848e,2015-06-20,1,0,0,386,1,0,60,24,50,10,0,0,10,6,9,7,41,18,48.3,246.0
7548,2f0cbf0502173a79,3d6749c4267da18f,c742287ed86a09bc,2015-06-20,1,0,0,862,0,0,204,81,195,9,4,4,5,2,45,41,150,79,22.1,754.0
7549,2f0cbf0502173a79,c742287ed86a09bc,3d6749c4267da18f,2015-06-20,0,0,0,862,11,0,88,13,88,0,0,0,0,0,19,12,69,13,0.0,685.9
7550,0b98d84a2795f7f8,8f5c8850b2484173,cd7763bcadb5d4c8,2015-06-20,1,0,0,390,0,0,43,15,30,13,0,0,13,8,9,8,21,7,13.9,375.0
7551,0b98d84a2795f7f8,cd7763bcadb5d4c8,8f5c8850b2484173,2015-06-20,0,0,0,390,7,0,38,5,38,0,0,0,0,0,14,12,24,5,0.0,353.1
7552,08cbd4c521831adf,31d7446b184e3305,a3be148af5c7b088,2015-06-20,1,0,0,504,3,0,41,13,41,0,0,0,0,0,6,5,35,13,0.0,332.7
7553,08cbd4c521831adf,a3be148af5c7b088,31d7446b184e3305,2015-06-20,0,0,0,504,3,2,51,16,43,8,1,1,7,5,18,12,25,11,85.3,216.0
7554,008d0158831dcbd4,185fb0200a4605e6,1fcfc3709fe58151,2015-06-20,0,0,0,177,1,0,12,1,12,0,0,0,0,0,5,2,7,1,0.0,148.0
7555,008d0158831dcbd4,1fcfc3709fe58151,185fb0200a4605e6,2015-06-20,0,1,1,177,2,2,13,2,13,0,0,0,0,0,4,4,9,2,0.0,96.0
7556,fd776d7b554a85d0,33a331684283900f,aa5b4eff51bdc7d1,2015-06-13,0,0,0,900,11,3,64,16,64,0,0,0,0,0,17,15,47,16,0.0,673.0
7557,fd776d7b554a85d0,aa5b4eff51bdc7d1,33a331684283900f,2015-06-13,0,0,0,900,1,0,129,33,129,0,0,0,0,0,10,4,119,33,0.0,900.0
7558,dc93921bd9342341,8c0580d4fff106c1,a8e6a69796280f17,2015-06-13,1,0,0,600,2,1,110,41,94,16,0,0,16,13,23,18,71,28,129.8,377.0
7559,dc93921bd9342341,a8e6a69796280f17,8c0580d4fff106c1,2015-06-13,0,0,0,600,2,0,49,8,47,2,0,0,2,0,12,10,35,8,4.0,458.2
7560,c7bc785e99d3ee2a,39330403ad27c2bb,80daefbed11ce998,2015-06-13,1,1,1,23,0,0,4,2,3,1,0,0,1,0,0,0,3,2,2.0,21.0
7561,c7bc785e99d3ee2a,80daefbed11ce998,39330403ad27c2bb,2015-06-13,0,0,0,23,1,0,1,0,1,0,0,0,0,0,0,0,1,0,0.0,19.0
7562,b2b6cf87cde17136,1f4b04a926ef1287,97a6bbe6e6566a94,2015-06-13,0,0,0,900,7,4,109,24,107,2,0,0,2,2,22,16,85,22,50.9,547.0
7563,b2b6cf87cde17136,97a6bbe6e6566a94,1f4b04a926ef1287,2015-06-13,0,0,0,900,2,0,74,9,72,2,1,1,1,1,34,24,38,8,22.0,772.1
7564,ac2887a0855a3266,94508d80e1f885fc,99c7610aa74995d3,2015-06-13,0,0,0,900,0,0,55,8,55,0,0,0,0,0,22,13,33,8,0.0,900.0
7565,ac2887a0855a3266,99c7610aa74995d3,94508d80e1f885fc,2015-06-13,0,0,0,900,17,4,41,1,41,0,0,0,0,0,24,16,17,1,0.0,518.0
7566,93f1b09aa792405e,0ff11cc094e887bc,492b202d2064e7a9,2015-06-13,0,0,0,733,5,4,169,54,169,0,0,0,0,0,41,34,128,54,0.0,555.0
7567,93f1b09aa792405e,492b202d2064e7a9,0ff11cc094e887bc,2015-06-13,0,1,1,733,3,1,174,79,174,0,0,0,0,0,24,17,150,79,0.0,703.0
7568,47e8726b301f3f32,519e4fe37ce9ff75,83fd97284f4bb4a4,2015-06-13,0,0,0,54,0,0,3,0,3,0,0,0,0,0,0,0,3,0,0.0,54.0
7569,47e8726b301f3f32,83fd97284f4bb4a4,519e4fe37ce9ff75,2015-06-13,0,1,1,54,0,0,1,0,1,0,0,0,0,0,1,1,0,0,0.0,32.0
7570,3b6dfd089301d16e,31ef8b67e13495b3,f0feeb2192937424,2015-06-13,0,0,0,900,12,2,80,14,76,4,0,0,4,1,24,18,52,13,128.0,354.4
7571,3b6dfd089301d16e,f0feeb2192937424,31ef8b67e13495b3,2015-06-13,0,0,0,900,0,0,68,16,67,1,0,0,1,0,18,11,49,16,1.6,747.0
7572,28c33e9353dac666,056c493bbd76a918,32be4b7f7de1c905,2015-06-13,0,0,0,900,15,1,143,39,141,2,0,0,2,0,31,23,110,39,21.8,593.3
7573,28c33e9353dac666,32be4b7f7de1c905,056c493bbd76a918,2015-06-13,0,0,0,900,1,0,144,39,143,1,0,0,1,1,11,9,132,38,1.7,847.2
7574,243e5e9b6678f303,40093d1d2d78394e,cbf5e6f231b55443,2015-06-13,0,0,0,900,14,5,79,30,52,27,0,0,27,16,12,9,40,14,509.1,342.9
7575,243e5e9b6678f303,cbf5e6f231b55443,40093d1d2d78394e,2015-06-13,0,2,0,900,1,1,100,33,83,17,1,1,16,12,25,22,58,21,29.1,354.9
7576,0452dd001f4adb6e,436f970c9ea9169c,cc900c6a71ed23f3,2015-06-13,0,1,0,900,0,0,106,13,101,5,1,1,4,3,57,46,44,10,40.7,720.0
7577,0452dd001f4adb6e,cc900c6a71ed23f3,436f970c9ea9169c,2015-06-13,0,0,0,900,11,6,158,17,155,3,1,0,2,1,21,17,134,16,123.0,572.3
7578,f930743af6564795,029eaff01e6bb8f0,813550bc53b15fb0,2015-06-06,2,1,0,158,2,1,36,25,33,3,0,0,3,3,2,2,31,22,0.0,158.0
7579,f930743af6564795,813550bc53b15fb0,029eaff01e6bb8f0,2015-06-06,0,0,0,158,0,0,13,5,13,0,0,0,0,0,3,1,10,5,0.0,71.0
7580,cad44cd2466fb68f,a4e85a58fbce64b2,c5a126ace82a6025,2015-06-06,0,0,0,97,0,0,9,1,9,0,0,0,0,0,2,0,7,1,0.0,95.3
7581,cad44cd2466fb68f,c5a126ace82a6025,a4e85a58fbce64b2,2015-06-06,2,0,0,97,0,0,39,11,35,4,0,0,4,2,7,5,28,9,1.7,89.0
7582,c611e81778c0b1fc,7aa3d6964eff4877,7ea4a9f07df33a45,2015-06-06,0,0,0,21,0,0,5,0,5,0,0,0,0,0,0,0,5,0,0.0,18.0
7583,c611e81778c0b1fc,7ea4a9f07df33a45,7aa3d6964eff4877,2015-06-06,1,0,0,21,0,0,9,5,5,4,0,0,4,3,0,0,5,2,0.0,21.0
7584,c39da8538d9c0321,92fa1401b7927da3,aa6e591c2a2cdecd,2015-06-06,0,0,0,900,0,0,211,36,211,0,0,0,0,0,52,31,159,36,0.0,886.0
7585,c39da8538d9c0321,aa6e591c2a2cdecd,92fa1401b7927da3,2015-06-06,0,0,0,900,7,3,151,38,151,0,0,0,0,0,15,9,136,38,0.0,714.0
7586,a7c04dc830923313,c8097968da5e5f13,de45aaae23dfa392,2015-06-06,0,0,0,900,7,4,57,15,55,2,0,0,2,2,21,17,34,13,59.7,512.0
7587,a7c04dc830923313,de45aaae23dfa392,c8097968da5e5f13,2015-06-06,0,0,0,900,4,0,84,17,84,0,0,0,0,0,14,11,70,17,0.0,669.3
7588,97febb293c99e5a8,1ccf4e7caff270df,c80095f6092271a7,2015-06-06,1,0,0,28,0,0,15,12,6,9,0,0,9,8,0,0,6,4,4.1,23.0
7589,97febb293c99e5a8,c80095f6092271a7,1ccf4e7caff270df,2015-06-06,0,0,0,28,0,0,6,3,6,0,0,0,0,0,1,0,5,3,0.0,23.9
7590,5b0fcecc55bebd5c,ca2efc9d7d523c43,d3df1add9d9a7efb,2015-06-06,1,0,0,348,4,3,37,22,18,19,0,0,19,15,3,1,15,7,143.2,137.0
7591,5b0fcecc55bebd5c,d3df1add9d9a7efb,ca2efc9d7d523c43,2015-06-06,0,0,0,348,0,0,23,5,23,0,0,0,0,0,3,1,20,5,0.0,149.8
7592,5a36c9362552e0dc,36549928f90f1d36,45230be0641f3f53,2015-06-06,0,2,1,154,2,1,3,2,2,1,0,0,1,1,0,0,2,1,65.5,23.0
7593,5a36c9362552e0dc,45230be0641f3f53,36549928f90f1d36,2015-06-06,0,0,0,154,0,0,4,0,4,0,0,0,0,0,3,3,1,0,0.0,88.5
7594,3caa22209cb559b7,a36556bb1565e32d,e56daf7725a0b5ab,2015-06-06,0,3,1,898,0,0,175,42,175,0,0,0,0,0,32,25,143,42,0.0,870.0
7595,3caa22209cb559b7,e56daf7725a0b5ab,a36556bb1565e32d,2015-06-06,0,0,0,898,3,2,171,47,171,0,0,0,0,0,32,16,139,47,0.0,768.0
7596,29c7cb102ddd7ec4,8a59d346dc976a10,def8166ff24bd237,2015-06-06,0,0,0,850,11,6,94,33,77,17,1,1,16,11,6,5,71,22,476.9,304.8
7597,29c7cb102ddd7ec4,def8166ff24bd237,8a59d346dc976a10,2015-06-06,1,1,0,850,0,0,101,39,79,22,0,0,22,14,4,2,75,25,40.2,320.1
7598,245009a9e1a0f60b,16690d100f995f8f,32ba186f4b0e3267,2015-06-06,1,0,0,300,0,0,40,7,40,0,0,0,0,0,14,8,26,7,0.0,300.0
7599,245009a9e1a0f60b,32ba186f4b0e3267,16690d100f995f8f,2015-06-06,0,0,0,300,1,0,13,1,13,0,0,0,0,0,6,1,7,1,0.0,300.0
7600,09f67db0cfaee022,ba280572acfba13f,bd58d34e39b7b12a,2015-06-06,0,0,0,114,1,0,21,6,21,0,0,0,0,0,3,2,18,6,0.0,114.0
7601,09f67db0cfaee022,bd58d34e39b7b12a,ba280572acfba13f,2015-06-06,0,1,1,114,0,0,16,4,16,0,0,0,0,0,2,1,14,4,0.0,112.0
7602,ff64fc34065565d0,07225ba28ae309b6,6fb1ba67bef41b37,2015-05-30,1,2,1,670,2,1,84,36,47,37,4,4,33,24,29,24,18,12,67.6,458.0
7603,ff64fc34065565d0,6fb1ba67bef41b37,07225ba28ae309b6,2015-05-30,0,1,0,670,10,2,69,24,62,7,0,0,7,6,16,13,46,18,95.0,222.4
7604,e54fe354981fe3e7,7413b80dbb0f8f9f,cbd3e590a85b18c5,2015-05-30,0,0,0,330,0,0,23,7,23,0,0,0,0,0,0,0,23,7,0.0,40.0
7605,e54fe354981fe3e7,cbd3e590a85b18c5,7413b80dbb0f8f9f,2015-05-30,1,0,0,330,5,3,69,38,17,52,0,0,52,31,1,1,16,7,290.0,40.0
7606,d6c02b4bb64ff795,5aedf14771ca82d2,b102c26727306ab6,2015-05-30,0,0,0,900,9,0,66,12,60,6,1,0,5,2,18,16,42,10,79.9,550.1
7607,d6c02b4bb64ff795,b102c26727306ab6,5aedf14771ca82d2,2015-05-30,1,0,0,900,5,4,54,19,49,5,0,0,5,4,2,2,47,15,56.9,729.1
7608,d4a309663a4da799,14ff46596ad80609,a8283a4f415e1eb9,2015-05-30,0,0,0,900,12,4,83,23,80,3,0,0,3,1,6,2,74,22,86.8,513.8
7609,d4a309663a4da799,a8283a4f415e1eb9,14ff46596ad80609,2015-05-30,0,0,0,900,0,0,191,32,187,4,4,4,0,0,39,30,148,32,10.2,767.2
7610,bf658320ccd69021,57b10fca4f9c9a7a,b7ffa72aa148599a,2015-05-30,0,1,1,171,5,3,13,1,12,1,0,0,1,0,2,2,10,1,40.0,91.0
7611,bf658320ccd69021,b7ffa72aa148599a,57b10fca4f9c9a7a,2015-05-30,0,0,0,171,0,0,11,5,11,0,0,0,0,0,3,2,8,5,0.0,131.0
7612,9968d308e97c6531,29af297d9f1de0f8,b71ce838b01f2cad,2015-05-30,0,0,0,211,4,3,13,5,10,3,0,0,3,3,0,0,10,2,71.0,69.0
7613,9968d308e97c6531,b71ce838b01f2cad,29af297d9f1de0f8,2015-05-30,0,1,0,211,0,0,7,1,7,0,0,0,0,0,5,4,2,1,0.0,129.0
7614,8801fbb87bdedbe3,31ee470ef5dc8d7f,f9f07bb5a43535ed,2015-05-30,0,1,0,600,0,0,69,11,69,0,0,0,0,0,26,23,43,11,0.0,478.0
7615,8801fbb87bdedbe3,f9f07bb5a43535ed,31ee470ef5dc8d7f,2015-05-30,1,0,0,600,3,2,162,50,136,26,1,1,25,21,33,24,103,29,117.0,447.0
7616,7af604e5aa43bb3b,8adcbd525fab8d9b,9d19d9e4aa2662e8,2015-05-30,0,0,0,900,2,0,131,37,128,3,0,0,3,2,25,20,103,35,6.4,823.4
7617,7af604e5aa43bb3b,9d19d9e4aa2662e8,8adcbd525fab8d9b,2015-05-30,0,0,0,900,10,6,139,14,135,4,0,0,4,2,38,27,97,12,40.6,639.6
7618,6a9ea8e420a52a21,b69f24c500d783e7,bc3ec52ef70fc155,2015-05-30,0,0,0,900,14,0,96,10,96,0,0,0,0,0,43,36,53,10,0.0,503.0
7619,6a9ea8e420a52a21,bc3ec52ef70fc155,b69f24c500d783e7,2015-05-30,0,0,0,900,0,0,61,14,61,0,0,0,0,0,24,21,37,14,0.0,876.0
7620,61d6b591430b6e25,32c03df3c9760069,9ce6d5a03af801b7,2015-05-30,0,0,0,397,3,0,39,3,39,0,0,0,0,0,25,19,14,3,0.0,218.0
7621,61d6b591430b6e25,9ce6d5a03af801b7,32c03df3c9760069,2015-05-30,1,0,0,397,2,0,41,15,31,10,1,1,9,7,12,9,19,8,60.0,331.0
7622,109674a1ee00f55d,67a992d4cff22466,75a6a390fd5dca46,2015-05-30,0,0,0,900,2,0,37,11,36,1,0,0,1,0,2,2,34,11,16.5,473.0
7623,109674a1ee00f55d,75a6a390fd5dca46,67a992d4cff22466,2015-05-30,0,0,0,900,3,3,72,24,50,22,3,2,19,10,15,15,35,14,394.0,292.5
7624,0c5640433ba44a1b,1588b787bda7b540,2153a7f8396a46cc,2015-05-30,1,0,0,298,2,0,42,11,31,11,3,2,8,5,16,13,15,6,24.5,240.0
7625,0c5640433ba44a1b,2153a7f8396a46cc,1588b787bda7b540,2015-05-30,0,0,0,298,2,0,43,7,43,0,0,0,0,0,18,14,25,7,0.0,228.5
7626,c2f0a53cd67e1736,6da99156486ed6c2,9bcf8603ceb25680,2015-05-23,0,0,0,733,2,0,44,9,44,0,0,0,0,0,15,11,29,9,0.0,355.6
7627,c2f0a53cd67e1736,9bcf8603ceb25680,6da99156486ed6c2,2015-05-23,0,1,1,733,8,1,44,26,24,20,0,0,20,19,7,4,17,7,299.4,269.0
7628,bee780601ad13583,1d00756835ca67c9,c21a036b4e012f1c,2015-05-23,1,0,0,584,0,0,171,43,171,0,0,0,0,0,31,28,140,43,0.0,584.0
7629,bee780601ad13583,c21a036b4e012f1c,1d00756835ca67c9,2015-05-23,0,0,0,584,0,0,129,25,129,0,0,0,0,0,64,47,65,25,0.0,584.0
7630,b34c608bdfa655e8,0dba4df5f34d5ff0,65578a75fa7900e3,2015-05-23,0,0,0,900,11,1,103,15,102,1,0,0,1,0,41,30,61,15,9.7,725.0
7631,b34c608bdfa655e8,65578a75fa7900e3,0dba4df5f34d5ff0,2015-05-23,0,0,0,900,3,1,74,15,74,0,0,0,0,0,34,28,40,15,0.0,838.3
7632,652a73f4bf7f1932,3236bf606fe9fa5b,3738e68d2261e60f,2015-05-23,1,0,0,281,0,0,38,9,36,2,0,0,2,1,7,6,29,8,4.0,274.6
7633,652a73f4bf7f1932,3738e68d2261e60f,3236bf606fe9fa5b,2015-05-23,1,0,0,281,0,0,85,42,82,3,0,0,3,3,12,9,70,39,0.4,272.0
7634,6257627ba49e42ab,57ab4d7c0bc09a30,99506df1af6c8b3b,2015-05-23,0,0,0,900,17,0,85,14,85,0,0,0,0,0,29,23,56,14,0.0,889.2
7635,6257627ba49e42ab,99506df1af6c8b3b,57ab4d7c0bc09a30,2015-05-23,0,0,0,900,3,2,98,13,97,1,0,0,1,0,22,18,75,13,1.8,862.0
7636,530fb0d1a26fc57a,365fee2da473b177,d967f0128c323de6,2015-05-23,1,0,0,759,2,1,50,18,49,1,0,0,1,1,5,5,44,17,3.6,251.8
7637,530fb0d1a26fc57a,d967f0128c323de6,365fee2da473b177,2015-05-23,0,3,1,759,8,3,41,20,21,20,0,0,20,15,4,3,17,5,464.2,198.4
7638,419d8143afbcd61c,9fa568ad2bf2cb0b,f65dcb22dada2223,2015-05-23,0,0,0,900,2,1,128,31,128,0,0,0,0,0,41,33,87,31,0.0,861.1
7639,419d8143afbcd61c,f65dcb22dada2223,9fa568ad2bf2cb0b,2015-05-23,0,0,0,900,7,1,91,17,90,1,0,0,1,1,33,18,57,16,7.9,813.0
7640,3c3da227fbe36a28,275aca31f61ba28c,6905d45bd71b50a9,2015-05-23,0,1,1,458,5,3,50,27,43,7,0,0,7,6,6,5,37,21,60.0,278.0
7641,3c3da227fbe36a28,6905d45bd71b50a9,275aca31f61ba28c,2015-05-23,0,0,0,458,0,0,25,2,25,0,0,0,0,0,11,5,14,2,0.0,398.0
7642,3a25be6438e3f94a,80eacd4da0617c57,92437c6775b3f7d1,2015-05-23,0,0,0,900,6,4,109,35,81,28,0,0,28,22,36,28,45,13,320.8,341.5
7643,3a25be6438e3f94a,92437c6775b3f7d1,80eacd4da0617c57,2015-05-23,0,0,0,900,3,0,75,14,70,5,5,4,0,0,28,24,42,14,8.5,538.2
7644,318460613b6018e9,0ee783aa00e468f0,3a8176e15b9887c1,2015-05-23,0,0,0,173,0,0,32,15,32,0,0,0,0,0,4,3,28,15,0.0,100.0
7645,318460613b6018e9,3a8176e15b9887c1,0ee783aa00e468f0,2015-05-23,1,0,0,173,2,1,69,46,12,57,0,0,57,43,2,0,10,3,73.0,100.0
7646,0c36a08b1bf60f45,dc9572dd6ec74859,f5990c11974d8e9c,2015-05-23,0,0,0,900,10,2,51,23,29,22,0,0,22,16,3,3,26,7,536.6,187.6
7647,0c36a08b1bf60f45,f5990c11974d8e9c,dc9572dd6ec74859,2015-05-23,0,2,0,900,0,0,26,10,19,7,0,0,7,7,10,6,9,3,29.4,321.4
7648,c13b2493018fc98b,5ea918ea81b7dee2,9eb069062a0cfc13,2015-05-16,0,0,0,900,6,1,108,7,108,0,0,0,0,0,4,2,104,7,0.0,839.2
7649,c13b2493018fc98b,9eb069062a0cfc13,5ea918ea81b7dee2,2015-05-16,0,0,0,900,5,0,109,24,101,8,0,0,8,7,36,28,65,17,21.8,802.0
7650,97c302628f231da3,633a45d131192ffe,7b310409440c9102,2015-05-16,0,1,0,900,11,3,51,10,45,6,2,2,4,1,13,8,32,9,135.9,444.5
7651,97c302628f231da3,7b310409440c9102,633a45d131192ffe,2015-05-16,0,0,0,900,2,1,47,6,40,7,1,0,6,1,15,14,25,5,70.5,613.1
7652,80551dceed42e7ab,2c1170b825f58e57,b9c03e7a4557e542,2015-05-16,1,0,0,599,2,2,92,30,83,9,0,0,9,7,24,16,59,23,171.9,408.0
7653,80551dceed42e7ab,b9c03e7a4557e542,2c1170b825f58e57,2015-05-16,0,0,0,599,0,0,32,3,32,0,0,0,0,0,17,15,15,3,0.0,427.1
7654,7d60cb78ea70fae0,78114b7199cef90c,f2688492b9a525a3,2015-05-16,0,0,0,1500,3,0,147,34,147,0,0,0,0,0,22,14,125,34,0.0,1485.6
7655,7d60cb78ea70fae0,f2688492b9a525a3,78114b7199cef90c,2015-05-16,0,0,0,1500,13,5,258,40,256,2,0,0,2,2,61,43,195,38,14.4,1277.0
7656,49749ee78bc54a48,0d0351c20169a499,57887765f831e228,2015-05-16,1,3,1,493,1,1,54,18,34,20,2,2,18,9,6,3,28,9,185.7,191.9
7657,49749ee78bc54a48,57887765f831e228,0d0351c20169a499,2015-05-16,0,0,0,493,3,2,54,15,47,7,1,1,6,3,13,11,34,12,41.1,172.3
7658,4702ef17c48bf1d1,40ff198adda94b9f,938ad489fb7a1f31,2015-05-16,0,0,0,900,4,0,77,5,77,0,0,0,0,0,36,27,41,5,0.0,789.5
7659,4702ef17c48bf1d1,938ad489fb7a1f31,40ff198adda94b9f,2015-05-16,0,0,0,900,13,7,57,11,51,6,1,1,5,4,21,15,30,7,83.5,552.0
7660,3b463d688d598a72,172c2135e70f87b7,179f1948dc234f1f,2015-05-16,0,0,0,900,2,1,96,27,93,3,0,0,3,2,22,15,71,25,0.5,562.5
7661,3b463d688d598a72,179f1948dc234f1f,172c2135e70f87b7,2015-05-16,0,0,0,900,16,9,71,30,50,21,0,0,21,12,10,5,40,18,332.5,424.5
7662,1e176413438fabd5,53ec9cb470e1a4ea,9a2d3567abc02e34,2015-05-16,1,1,1,236,0,0,31,7,27,4,0,0,4,2,8,6,19,5,31.0,174.0
7663,1e176413438fabd5,9a2d3567abc02e34,53ec9cb470e1a4ea,2015-05-16,0,0,0,236,1,1,34,6,34,0,0,0,0,0,10,6,24,6,0.0,205.0
7664,1caec47dc08613a7,05560764359161e4,232c582f29f8f65e,2015-05-16,0,0,0,900,1,0,46,3,46,0,0,0,0,0,18,6,28,3,0.0,248.0
7665,1caec47dc08613a7,232c582f29f8f65e,05560764359161e4,2015-05-16,0,0,0,900,4,4,85,38,47,38,7,6,31,28,12,12,35,10,652.0,248.0
7666,14a40f30e0cb22c9,203c957eac95dd87,84b3e7d38f2d2ec5,2015-05-16,0,0,0,384,0,0,36,12,36,0,0,0,0,0,4,3,32,12,0.0,204.6
7667,14a40f30e0cb22c9,84b3e7d38f2d2ec5,203c957eac95dd87,2015-05-16,1,0,0,384,4,2,75,34,33,42,1,1,41,25,10,8,23,9,147.4,198.0
7668,093ca77f7f7219f6,64360e618823a8e4,a00ec21cfbba17b6,2015-05-16,0,0,0,900,12,6,24,7,19,5,0,0,5,2,6,5,13,5,135.7,270.0
7669,093ca77f7f7219f6,a00ec21cfbba17b6,64360e618823a8e4,2015-05-16,0,1,0,900,3,2,60,15,27,33,0,0,33,12,18,14,9,3,250.0,370.3
7670,00684df5ed23e6ca,e64b96c07d7ce999,e9213f53ddeca978,2015-05-16,1,0,0,85,0,0,39,13,24,15,0,0,15,9,1,0,23,4,12.0,73.0
7671,00684df5ed23e6ca,e9213f53ddeca978,e64b96c07d7ce999,2015-05-16,0,0,0,85,0,0,16,5,16,0,0,0,0,0,2,1,14,5,0.0,73.0
7672,f208b79b0d78045b,bdcbb976816fd256,d156513a19acf856,2015-05-09,0,0,0,49,0,0,8,1,8,0,0,0,0,0,1,1,7,1,0.0,45.0
7673,f208b79b0d78045b,d156513a19acf856,bdcbb976816fd256,2015-05-09,1,0,0,49,0,0,13,8,11,2,0,0,2,2,0,0,11,6,4.0,45.0
7674,e4549c57faca7a64,77350fd0e6d1dba8,907e60fd13407e1e,2015-05-09,0,0,0,249,3,1,17,6,15,2,0,0,2,2,3,1,12,4,19.5,114.3
7675,e4549c57faca7a64,907e60fd13407e1e,77350fd0e6d1dba8,2015-05-09,0,1,1,249,0,0,40,17,29,11,0,0,11,7,5,4,24,10,56.7,95.5
7676,d1c4c06780cbd36e,05b43e0ead3df345,26b63bc5c0c1f65d,2015-05-09,0,0,0,795,4,2,190,50,177,13,1,1,12,8,43,30,134,42,72.8,515.0
7677,d1c4c06780cbd36e,26b63bc5c0c1f65d,05b43e0ead3df345,2015-05-09,0,2,1,795,5,2,109,18,109,0,0,0,0,0,46,26,63,18,0.0,664.2
7678,979269d4ab5784af,1e7483dbff40b84b,494b0bfdbac74502,2015-05-09,0,1,0,900,3,1,106,42,106,0,0,0,0,0,17,17,89,42,0.0,565.7
7679,979269d4ab5784af,494b0bfdbac74502,1e7483dbff40b84b,2015-05-09,0,1,0,900,10,6,85,23,81,4,1,1,3,3,25,18,56,20,33.3,442.0
7680,8a39075a9ffaa971,00debc804e2b1cd4,34e552520a934063,2015-05-09,2,1,0,594,2,1,56,10,54,2,0,0,2,2,20,15,34,8,4.5,472.6
7681,8a39075a9ffaa971,34e552520a934063,00debc804e2b1cd4,2015-05-09,0,1,1,594,4,1,75,35,66,9,1,1,8,7,8,6,58,28,78.4,284.5
7682,7ec24848cac6c5a1,0c6d9ea8306c029e,e1147d3d2dabe1ce,2015-05-09,0,0,0,44,0,0,7,0,7,0,0,0,0,0,2,2,5,0,0.0,40.0
7683,7ec24848cac6c5a1,e1147d3d2dabe1ce,0c6d9ea8306c029e,2015-05-09,1,0,0,44,0,0,14,9,11,3,0,0,3,3,2,1,9,6,4.0,40.0
7684,57b986d06bde71c2,d28dee5c705991df,eef9b891edbd4604,2015-05-09,1,0,0,1367,8,6,180,105,113,67,4,4,63,53,4,4,109,52,779.6,378.0
7685,57b986d06bde71c2,eef9b891edbd4604,d28dee5c705991df,2015-05-09,0,0,0,1367,0,0,96,29,96,0,0,0,0,0,7,4,89,29,0.0,587.4
7686,4f722e80eadb6d2f,193b9d1858bc4df3,ef7fa30364cbe7f2,2015-05-09,1,0,0,553,0,0,61,18,58,3,0,0,3,2,12,3,46,16,4.5,544.0
7687,4f722e80eadb6d2f,ef7fa30364cbe7f2,193b9d1858bc4df3,2015-05-09,0,0,0,553,5,2,92,23,92,0,0,0,0,0,22,9,70,23,0.0,428.5
7688,43baf5b905686ebf,7339d340aa2889cb,f40ec51dd4de47c3,2015-05-09,0,0,0,900,0,0,82,13,62,20,4,3,16,6,25,15,37,7,125.0,709.5
7689,43baf5b905686ebf,f40ec51dd4de47c3,7339d340aa2889cb,2015-05-09,1,2,0,900,8,2,67,19,63,4,0,0,4,2,11,4,52,17,65.5,595.0
7690,418b6f692abe9e35,6256b2b1562cb8e1,a845f0735bc67405,2015-05-09,0,1,1,293,1,0,26,5,26,0,0,0,0,0,9,5,17,5,0.0,286.0
7691,418b6f692abe9e35,a845f0735bc67405,6256b2b1562cb8e1,2015-05-09,0,0,0,293,2,1,28,4,28,0,0,0,0,0,3,0,25,4,0.0,203.0
7692,398f4857f9692204,840d2c82ea68b9aa,e18a19001a3f7c7d,2015-05-09,2,0,0,299,1,0,60,18,51,9,1,1,8,7,10,8,41,11,17.2,212.6
7693,398f4857f9692204,e18a19001a3f7c7d,840d2c82ea68b9aa,2015-05-09,0,0,0,299,3,1,49,13,38,11,0,0,11,5,4,2,34,8,63.4,183.8
7694,0fa31c9f7495810b,4b4753d19489297f,cb52f9490c2dc069,2015-05-09,0,0,0,56,0,0,5,3,5,0,0,0,0,0,0,0,5,3,0.0,56.0
7695,0fa31c9f7495810b,cb52f9490c2dc069,4b4753d19489297f,2015-05-09,1,0,0,56,0,0,38,18,38,0,0,0,0,0,5,2,33,18,0.0,56.0
7696,ccbbf1ccd4513551,2b93ebd9f5417ad2,5d7bdab5e03e3216,2015-04-25,0,0,0,900,0,0,202,56,194,8,0,0,8,5,26,19,168,51,20.4,815.2
7697,ccbbf1ccd4513551,5d7bdab5e03e3216,2b93ebd9f5417ad2,2015-04-25,1,0,0,900,8,2,131,36,117,14,2,1,12,5,14,10,103,31,61.8,804.6
7698,ab475a3a4487d6d3,4a57ebb14315b251,e50cd77732d39967,2015-04-25,0,1,0,900,4,2,52,15,48,4,0,0,4,4,4,3,44,11,132.4,418.8
7699,ab475a3a4487d6d3,e50cd77732d39967,4a57ebb14315b251,2015-04-25,0,1,0,900,5,2,65,15,57,8,0,0,8,6,15,12,42,9,150.2,354.6
7700,78f1457371e2ef6b,2b074403b7c6cdb4,b4eeac608fc82f88,2015-04-25,1,0,0,258,0,0,75,18,75,0,0,0,0,0,17,13,58,18,0.0,258.0
7701,78f1457371e2ef6b,b4eeac608fc82f88,2b074403b7c6cdb4,2015-04-25,0,0,0,258,1,1,56,12,56,0,0,0,0,0,13,8,43,12,0.0,235.0
7702,71e123d40fff9edb,46a2f24feb258ae0,ffdeb4fbea09ce75,2015-04-25,0,2,0,900,2,2,124,17,123,1,0,0,1,1,31,21,92,16,2.4,697.1
7703,71e123d40fff9edb,ffdeb4fbea09ce75,46a2f24feb258ae0,2015-04-25,0,1,0,900,5,1,107,26,98,9,1,1,8,5,28,19,70,21,147.9,519.6
7704,6c2097664ac1bf16,8a304bfd6bf04a57,98aa60cf58071fd6,2015-04-25,0,1,1,1499,22,14,121,21,109,12,5,5,7,6,60,40,49,15,282.2,676.0
7705,6c2097664ac1bf16,98aa60cf58071fd6,8a304bfd6bf04a57,2015-04-25,0,0,0,1499,5,1,91,18,91,0,0,0,0,0,21,13,70,18,0.0,1154.8
7706,6b532f492e98d22f,36df8e119aec6175,4c2d90e335e6df19,2015-04-25,0,0,0,487,0,0,130,37,123,7,1,1,6,6,39,27,84,31,32.1,400.0
7707,6b532f492e98d22f,4c2d90e335e6df19,36df8e119aec6175,2015-04-25,0,1,1,487,3,1,99,18,99,0,0,0,0,0,22,16,77,18,0.0,403.9
7708,591699203b264f6c,9fa3bd637edd9aa2,d512d9f204059f57,2015-04-25,0,1,0,900,6,3,48,11,38,10,1,1,9,6,21,9,17,5,212.2,453.0
7709,591699203b264f6c,d512d9f204059f57,9fa3bd637edd9aa2,2015-04-25,0,0,0,900,2,2,35,15,31,4,0,0,4,3,7,6,24,12,65.0,427.8
7710,48f23cc8cc5ad9a9,a331233f597090a5,c03a5022f8439f2a,2015-04-25,0,0,0,900,3,1,202,36,200,2,0,0,2,0,80,58,120,36,2.3,866.0
7711,48f23cc8cc5ad9a9,c03a5022f8439f2a,a331233f597090a5,2015-04-25,0,0,0,900,1,0,172,52,172,0,0,0,0,0,40,32,132,52,0.0,887.7
7712,059dcd0b3b8e0a3f,49858bf46dabf6fb,e5ecaf884b6da2bc,2015-04-25,0,0,0,900,6,6,64,26,34,30,2,2,28,17,12,8,22,9,488.1,298.0
7713,059dcd0b3b8e0a3f,e5ecaf884b6da2bc,49858bf46dabf6fb,2015-04-25,0,1,0,900,0,0,62,4,62,0,0,0,0,0,23,13,39,4,0.0,411.9
7714,0590fb4acc06fa93,49f4b511932f71e9,55ee431411ccf07a,2015-04-25,0,0,0,695,0,0,52,14,50,2,0,0,2,1,5,3,45,13,0.0,634.5
7715,0590fb4acc06fa93,55ee431411ccf07a,49f4b511932f71e9,2015-04-25,1,1,1,695,15,3,86,22,81,5,1,1,4,3,30,26,51,19,60.5,320.0
7716,f4717203e762d780,6c2030e0a143a94b,7a703c565ccaa18f,2015-04-18,0,0,0,153,0,0,14,2,14,0,0,0,0,0,6,5,8,2,0.0,63.0
7717,f4717203e762d780,7a703c565ccaa18f,6c2030e0a143a94b,2015-04-18,0,1,1,153,1,1,9,2,8,1,1,1,0,0,4,3,4,2,90.0,63.0
7718,f22d193f3ab42bc5,150ff4cc642270b9,d247691a6c0e9034,2015-04-18,0,3,1,838,0,0,198,51,190,8,2,2,6,3,33,29,157,48,54.8,746.7
7719,f22d193f3ab42bc5,d247691a6c0e9034,150ff4cc642270b9,2015-04-18,0,0,0,838,3,0,136,29,135,1,0,0,1,0,38,27,97,29,2.3,776.2
7720,e2b4130c7b1ff8bc,4d5197f331c47290,b6850671a008bf9a,2015-04-18,0,0,0,900,5,2,92,45,42,50,0,0,50,37,25,22,17,8,411.0,248.9
7721,e2b4130c7b1ff8bc,b6850671a008bf9a,4d5197f331c47290,2015-04-18,0,1,0,900,4,0,47,12,44,3,0,0,3,2,23,16,21,10,18.1,326.0
7722,c19f394f3c237789,50db8711c70196cd,e51e5cb722bd47a8,2015-04-18,1,0,0,294,1,0,41,13,34,7,0,0,7,7,8,5,26,6,3.1,269.1
7723,c19f394f3c237789,e51e5cb722bd47a8,50db8711c70196cd,2015-04-18,0,0,0,294,3,1,23,8,19,4,0,0,4,4,6,6,13,4,20.9,243.9
7724,bd246b9789f88e1c,4b47e71384a9522f,6c7e25571490aa3b,2015-04-18,1,1,1,821,2,2,130,28,114,16,3,2,13,7,38,18,76,21,120.5,595.0
7725,bd246b9789f88e1c,6c7e25571490aa3b,4b47e71384a9522f,2015-04-18,0,0,0,821,5,0,164,27,164,0,0,0,0,0,30,12,134,27,0.0,673.5
7726,6b92396d42918366,5e4eec08896c9423,fcd448a2fe1a23cc,2015-04-18,0,0,0,858,4,0,279,97,279,0,0,0,0,0,23,14,256,97,0.0,858.0
7727,6b92396d42918366,fcd448a2fe1a23cc,5e4eec08896c9423,2015-04-18,1,0,0,858,0,0,168,37,168,0,0,0,0,0,39,33,129,37,0.0,858.0
7728,642a8cc1195c5198,8cad40a75e5c97f5,dfae5da5676e4194,2015-04-18,0,0,0,900,3,3,140,36,140,0,0,0,0,0,1,1,139,36,0.0,566.6
7729,642a8cc1195c5198,dfae5da5676e4194,8cad40a75e5c97f5,2015-04-18,0,0,0,900,12,3,138,37,132,6,1,1,5,4,7,6,125,33,84.4,703.0
7730,5965800d88e0677c,00e11b5c8b7bfeeb,f7a7f7118d4b01b6,2015-04-18,0,2,1,451,1,1,44,14,24,20,0,0,20,11,10,9,14,3,181.0,176.0
7731,5965800d88e0677c,f7a7f7118d4b01b6,00e11b5c8b7bfeeb,2015-04-18,0,0,0,451,0,0,27,7,25,2,0,0,2,1,7,6,18,6,85.0,185.0
7732,4785bf265d05d85f,893d51aaf024eddd,c2e3e67b5911bfb7,2015-04-18,0,0,0,300,3,1,18,5,18,0,0,0,0,0,7,6,11,5,0.0,154.0
7733,4785bf265d05d85f,c2e3e67b5911bfb7,893d51aaf024eddd,2015-04-18,1,0,0,300,3,2,24,8,15,9,0,0,9,4,7,4,8,4,87.0,155.0
7734,2bcb878e9d02b8f7,08af939f41b5a57b,d1941565abf50b16,2015-04-18,0,1,0,900,4,2,54,17,44,10,0,0,10,7,17,10,27,10,276.5,181.0
7735,2bcb878e9d02b8f7,d1941565abf50b16,08af939f41b5a57b,2015-04-18,0,3,0,900,0,0,27,4,27,0,0,0,0,0,8,7,19,4,0.0,607.5
7736,2230a5dbc0907859,48e093ea1f43a053,cb696ebfb6598724,2015-04-18,0,0,0,731,1,0,42,6,42,0,0,0,0,0,12,7,30,6,0.0,700.0
7737,2230a5dbc0907859,cb696ebfb6598724,48e093ea1f43a053,2015-04-18,0,1,1,731,15,3,54,8,54,0,0,0,0,0,26,24,28,8,0.0,274.0
7738,fe9a58e79d54695b,12f91bfa8f1f723b,b4192a975027aab6,2015-04-11,0,0,0,90,0,0,24,3,24,0,0,0,0,0,12,8,12,3,0.0,74.0
7739,fe9a58e79d54695b,b4192a975027aab6,12f91bfa8f1f723b,2015-04-11,0,1,1,90,0,0,32,11,32,0,0,0,0,0,2,1,30,11,0.0,79.0
7740,ec0a1c09d1b113b8,f1fac969a1d70b08,fd5b6598a3b70c0a,2015-04-11,1,0,0,8,0,0,3,3,1,2,0,0,2,2,0,0,1,1,2.0,6.0
7741,ec0a1c09d1b113b8,fd5b6598a3b70c0a,f1fac969a1d70b08,2015-04-11,0,0,0,8,0,0,4,0,4,0,0,0,0,0,1,0,3,0,0.0,6.0
7742,e8d336f4465e6640,31a13532e724ca2b,5c2ce761399dc9c5,2015-04-11,1,2,0,395,0,0,42,27,11,31,1,1,30,24,6,3,5,3,187.9,153.5
7743,e8d336f4465e6640,5c2ce761399dc9c5,31a13532e724ca2b,2015-04-11,0,0,0,395,5,0,5,1,4,1,0,0,1,0,3,2,1,1,47.5,112.1
7744,badc8c379cc2e6ff,e17ac6410c8377f4,f215cfbd4ba3c270,2015-04-11,0,0,0,900,11,10,53,12,49,4,0,0,4,0,30,29,19,12,61.0,244.0
7745,badc8c379cc2e6ff,f215cfbd4ba3c270,e17ac6410c8377f4,2015-04-11,0,2,0,900,4,0,21,2,21,0,0,0,0,0,11,11,10,2,0.0,676.0
7746,b2bb725b17ab51b8,1e1dbd1cc5a7469e,99df7d0a2a08a8a8,2015-04-11,0,0,0,900,2,0,86,15,86,0,0,0,0,0,40,28,46,15,0.0,557.0
7747,b2bb725b17ab51b8,99df7d0a2a08a8a8,1e1dbd1cc5a7469e,2015-04-11,0,0,0,900,3,0,106,25,106,0,0,0,0,0,29,19,77,25,0.0,871.0
7748,a39d0adbeffe49de,470fedbc8563ac47,c727c7d31c50c4cf,2015-04-11,0,0,0,900,3,1,44,16,38,6,1,1,5,5,20,19,18,11,13.8,462.4
7749,a39d0adbeffe49de,c727c7d31c50c4cf,470fedbc8563ac47,2015-04-11,0,0,0,900,4,3,100,29,59,41,16,14,25,22,40,40,19,7,347.6,140.2
7750,8502afcf211973a9,0d1c163b206e8c5f,8b1ed83b02303075,2015-04-11,0,0,0,900,10,1,72,10,71,1,0,0,1,1,29,27,42,9,18.8,653.0
7751,8502afcf211973a9,8b1ed83b02303075,0d1c163b206e8c5f,2015-04-11,0,1,0,900,3,2,143,45,137,6,1,1,5,5,38,34,99,40,22.0,760.2
7752,79e293137ef6421d,1bcaac2d99b90fce,c575ab451e3c5b1d,2015-04-11,0,0,0,900,3,2,82,40,80,2,0,0,2,1,13,11,67,39,239.0,657.0
7753,79e293137ef6421d,c575ab451e3c5b1d,1bcaac2d99b90fce,2015-04-11,0,0,0,900,0,0,111,33,110,1,0,0,1,1,16,14,94,32,4.0,657.0
7754,6e652cbaaa406598,4fcf6e0c4e0e6664,e76d9f656ceb82ab,2015-04-11,0,0,0,514,8,1,45,4,45,0,0,0,0,0,28,28,17,4,0.0,325.0
7755,6e652cbaaa406598,e76d9f656ceb82ab,4fcf6e0c4e0e6664,2015-04-11,0,1,1,514,1,0,62,34,62,0,0,0,0,0,10,8,52,34,0.0,405.0
7756,6a7892754af30685,270b89c00ef0c55c,c32fb8c0f6471a4d,2015-04-11,0,1,0,810,7,2,47,16,25,22,0,0,22,12,5,3,20,4,323.5,366.3
7757,6a7892754af30685,c32fb8c0f6471a4d,270b89c00ef0c55c,2015-04-11,1,0,0,810,1,0,46,20,25,21,0,0,21,16,2,1,23,4,46.7,426.5
7758,63c08ecea35e8bee,9310418684bc896f,ec2d13a87d3d9541,2015-04-11,0,0,0,900,4,3,60,15,52,8,1,1,7,5,19,14,33,10,53.4,713.0
7759,63c08ecea35e8bee,ec2d13a87d3d9541,9310418684bc896f,2015-04-11,0,0,0,900,11,3,45,6,45,0,0,0,0,0,21,11,24,6,0.0,248.6
7760,439905344ee8035e,3623bd267a2eef2e,42a7e90605df3c8a,2015-04-11,0,3,0,900,2,2,25,4,17,8,6,6,2,1,8,7,9,3,543.1,153.2
7761,439905344ee8035e,42a7e90605df3c8a,3623bd267a2eef2e,2015-04-11,0,1,0,900,2,1,23,8,18,5,1,1,4,4,8,5,10,4,135.8,193.89999999999998
7762,f9373ab59b7a853b,2f5cbecbbe18bac4,cc900af167fbedfd,2015-04-04,0,0,0,297,1,0,25,5,25,0,0,0,0,0,6,4,19,5,0.0,231.8
7763,f9373ab59b7a853b,cc900af167fbedfd,2f5cbecbbe18bac4,2015-04-04,1,0,0,297,2,1,59,14,41,18,3,2,15,9,12,6,29,5,34.2,240.0
7764,cc7afab68363e076,072a10e85f7d4bff,3253b16d38ae087d,2015-04-04,0,0,0,239,2,1,5,0,5,0,0,0,0,0,0,0,5,0,0.0,41.900000000000006
7765,cc7afab68363e076,3253b16d38ae087d,072a10e85f7d4bff,2015-04-04,1,0,0,239,1,1,73,32,14,59,0,0,59,32,8,5,6,0,154.1,64.0
7766,bbebfc54abbb1d8b,3974fa35c917af1d,b5b684eac99ae0a3,2015-04-04,0,0,0,165,0,0,22,2,22,0,0,0,0,0,6,6,16,2,0.0,135.5
7767,bbebfc54abbb1d8b,b5b684eac99ae0a3,3974fa35c917af1d,2015-04-04,2,0,0,165,0,0,32,24,14,18,0,0,18,17,4,3,10,7,29.5,124.0
7768,9eb92b670eebdcd4,c58f51dedb310998,c76ec2bc3a57666a,2015-04-04,0,0,0,900,7,4,128,48,116,12,0,0,12,11,15,11,101,37,183.4,579.0
7769,9eb92b670eebdcd4,c76ec2bc3a57666a,c58f51dedb310998,2015-04-04,0,0,0,900,4,0,120,36,120,0,0,0,0,0,35,29,85,36,0.0,560.6
7770,8cf571afc2618df4,51a0c09cbe9b8472,729d4bd5a6cd0a97,2015-04-04,0,0,0,900,8,2,66,19,65,1,0,0,1,1,23,19,42,18,5.9,744.5
7771,8cf571afc2618df4,729d4bd5a6cd0a97,51a0c09cbe9b8472,2015-04-04,0,0,0,900,9,2,102,6,97,5,0,0,5,5,43,40,54,1,60.5,446.1
7772,85dcf9425d3c4e56,7d96bc577e5178b2,d06f8869449ba7bd,2015-04-04,0,0,0,900,17,2,55,16,55,0,0,0,0,0,14,5,41,16,0.0,643.3
7773,85dcf9425d3c4e56,d06f8869449ba7bd,7d96bc577e5178b2,2015-04-04,1,0,0,900,5,2,72,21,61,11,1,1,10,7,12,9,49,14,82.7,727.0
7774,634dbcef5111f939,47b9e0e7703a4868,59279a7c978f7da0,2015-04-04,0,0,0,900,0,0,170,62,161,9,0,0,9,5,24,21,137,57,15.0,875.0
7775,634dbcef5111f939,59279a7c978f7da0,47b9e0e7703a4868,2015-04-04,0,0,0,900,9,0,153,18,153,0,0,0,0,0,46,37,107,18,0.0,878.0
7776,3845a6838fe00265,6dd758d34da8d254,9b75954db8db2a08,2015-04-04,0,0,0,900,0,0,84,31,83,1,0,0,1,0,24,19,59,31,1.7,771.6
7777,3845a6838fe00265,9b75954db8db2a08,6dd758d34da8d254,2015-04-04,0,0,0,900,12,2,72,12,67,5,1,1,4,3,12,10,55,9,80.4,335.3
7778,12c600dc64edb403,029eaff01e6bb8f0,f53d4f21d1b5f2dc,2015-04-04,2,0,0,225,0,0,50,20,43,7,0,0,7,3,5,4,38,17,35.8,179.0
7779,12c600dc64edb403,f53d4f21d1b5f2dc,029eaff01e6bb8f0,2015-04-04,0,0,0,225,2,0,56,12,56,0,0,0,0,0,10,8,46,12,0.0,131.2
7780,0c25bb24dbb63655,960d6cae8879ba2b,c47df9303d318c67,2015-04-04,0,0,0,900,0,0,84,13,84,0,0,0,0,0,13,11,71,13,0.0,595.0
7781,0c25bb24dbb63655,c47df9303d318c67,960d6cae8879ba2b,2015-04-04,0,1,0,900,11,6,64,4,54,10,9,9,1,1,15,14,39,3,305.0,229.0
7782,fe5427398fd9d9dc,80fa8218c99f9c58,8ef4a91ac694b7ce,2015-03-21,1,0,0,116,0,0,17,8,14,3,0,0,3,2,8,7,6,6,1.0,115.0
7783,fe5427398fd9d9dc,8ef4a91ac694b7ce,80fa8218c99f9c58,2015-03-21,0,0,0,116,2,0,8,1,8,0,0,0,0,0,1,0,7,1,0.0,114.0
7784,c3ba8f1a4ddc0dc3,0ccab7c889ede9ea,abd2109bc4cb0291,2015-03-21,1,0,0,694,8,2,98,16,98,0,0,0,0,0,11,4,87,16,0.0,652.0
7785,c3ba8f1a4ddc0dc3,abd2109bc4cb0291,0ccab7c889ede9ea,2015-03-21,0,0,0,694,0,0,79,8,79,0,0,0,0,0,15,7,64,8,0.0,694.0
7786,bc096e8ae14582ec,427b5953ac8e3a27,4c7781da8c6cae93,2015-03-21,0,2,0,1500,14,5,69,32,39,30,2,2,28,22,2,2,37,10,828.0,576.0
7787,bc096e8ae14582ec,4c7781da8c6cae93,427b5953ac8e3a27,2015-03-21,0,0,0,1500,0,0,91,8,88,3,0,0,3,1,31,17,57,7,96.0,576.0
7788,b068a4ee6d842606,159da492e000afbf,519e4fe37ce9ff75,2015-03-21,0,1,0,465,4,2,48,11,48,0,0,0,0,0,17,14,31,11,0.0,369.0
7789,b068a4ee6d842606,519e4fe37ce9ff75,159da492e000afbf,2015-03-21,0,0,0,465,0,0,72,14,72,0,0,0,0,0,17,8,55,14,0.0,396.0
7790,9150344ed35f355d,8fd808923cffff82,fa37628269132d1a,2015-03-21,0,0,0,194,0,0,6,0,6,0,0,0,0,0,2,1,4,0,0.0,64.0
7791,9150344ed35f355d,fa37628269132d1a,8fd808923cffff82,2015-03-21,0,1,1,194,2,0,4,0,4,0,0,0,0,0,1,1,3,0,0.0,183.0
7792,7259a1046143e632,44470bfd9483c7ad,6c7020b859c7a3ce,2015-03-21,0,0,0,91,0,0,4,0,4,0,0,0,0,0,2,1,2,0,0.0,89.0
7793,7259a1046143e632,6c7020b859c7a3ce,44470bfd9483c7ad,2015-03-21,1,0,0,91,0,0,7,4,6,1,0,0,1,1,2,1,4,3,2.0,89.0
7794,632f6960544caa3c,064b7dc68d786254,8bbc0cfc01bc1ba1,2015-03-21,1,0,0,900,5,0,101,35,100,1,0,0,1,0,18,9,82,35,9.3,576.1
7795,632f6960544caa3c,8bbc0cfc01bc1ba1,064b7dc68d786254,2015-03-21,0,0,0,900,6,5,191,65,167,24,2,2,22,15,36,27,131,50,267.9,477.7
7796,55c6d02e838dc60f,23024fdfc966410a,57b10fca4f9c9a7a,2015-03-21,0,2,1,854,5,2,44,8,40,4,0,0,4,4,12,9,28,4,137.7,613.0
7797,55c6d02e838dc60f,57b10fca4f9c9a7a,23024fdfc966410a,2015-03-21,0,0,0,854,0,0,76,22,76,0,0,0,0,0,9,7,67,22,0.0,515.3
7798,22a243c5fba0fb46,a8283a4f415e1eb9,c136b2a8852da5bd,2015-03-21,0,0,0,900,3,3,115,29,75,40,2,2,38,15,11,8,64,14,495.1,343.0
7799,22a243c5fba0fb46,c136b2a8852da5bd,a8283a4f415e1eb9,2015-03-21,0,0,0,900,0,0,74,17,67,7,1,1,6,4,22,16,45,13,0.0,404.9
7800,1641d396e409a350,5866fc86183a9fb8,dd37fd509af89f15,2015-03-21,0,1,1,261,1,0,32,8,27,5,1,1,4,3,9,5,18,5,40.8,212.0
7801,1641d396e409a350,dd37fd509af89f15,5866fc86183a9fb8,2015-03-21,0,0,0,261,3,0,21,4,21,0,0,0,0,0,1,0,20,4,0.0,156.2
7802,0eac602503b48b1a,5331b25a60417ffb,9c65736747ca92ec,2015-03-21,0,0,0,449,3,0,36,8,36,0,0,0,0,0,6,6,30,8,0.0,341.0
7803,0eac602503b48b1a,9c65736747ca92ec,5331b25a60417ffb,2015-03-21,0,1,1,449,2,1,39,6,39,0,0,0,0,0,14,6,25,6,0.0,362.0
7804,0c299ce3719d9ea2,ddf3e0ea10ea6d8c,de45aaae23dfa392,2015-03-21,0,0,0,192,0,0,4,0,4,0,0,0,0,0,1,0,3,0,0.0,31.0
7805,0c299ce3719d9ea2,de45aaae23dfa392,ddf3e0ea10ea6d8c,2015-03-21,0,1,1,192,1,1,34,18,4,30,0,0,30,16,0,0,4,2,161.0,31.0
7806,d61a7b593218234b,08af939f41b5a57b,5f99b2bafb10305f,2015-03-14,0,2,1,458,1,1,51,13,43,8,1,1,7,6,15,13,28,7,79.4,329.0
7807,d61a7b593218234b,5f99b2bafb10305f,08af939f41b5a57b,2015-03-14,0,0,0,458,5,0,43,10,43,0,0,0,0,0,12,7,31,10,0.0,354.6
7808,d4d6c5ff6bef93ce,33e00249ef08d3a4,654ae722109a0d31,2015-03-14,0,0,0,107,0,0,23,2,23,0,0,0,0,0,6,4,17,2,0.0,106.0
7809,d4d6c5ff6bef93ce,654ae722109a0d31,33e00249ef08d3a4,2015-03-14,1,0,0,107,0,0,40,11,38,2,0,0,2,1,5,4,33,10,1.0,106.0
7810,bd52e19f2fbefdde,3d6749c4267da18f,d910665038efc639,2015-03-14,1,0,0,557,0,0,105,50,100,5,0,0,5,5,4,3,96,45,4.7,529.0
7811,bd52e19f2fbefdde,d910665038efc639,3d6749c4267da18f,2015-03-14,0,0,0,557,17,1,22,3,22,0,0,0,0,0,3,1,19,3,0.0,485.3
7812,875304f54becda0e,20999e27ddd94bda,de75d1c45a39e221,2015-03-14,1,0,0,394,1,1,90,25,74,16,0,0,16,9,4,3,70,16,19.6,275.0
7813,875304f54becda0e,de75d1c45a39e221,20999e27ddd94bda,2015-03-14,0,0,0,394,3,1,100,33,93,7,0,0,7,4,9,6,84,29,97.0,277.4
7814,7685da6f627bd98f,3f7c14c7eca7195d,b4ad3a06ee4d660c,2015-03-14,1,0,0,900,4,0,77,18,75,2,0,0,2,0,9,5,66,18,4.0,866.0
7815,7685da6f627bd98f,b4ad3a06ee4d660c,3f7c14c7eca7195d,2015-03-14,0,0,0,900,2,0,84,18,83,1,0,0,1,1,55,44,28,17,0.0,896.0
7816,6b07c3a9a95493cf,056c493bbd76a918,b2e3aca4cd363477,2015-03-14,0,1,0,900,7,6,93,28,69,24,9,7,15,12,22,15,47,16,333.1,331.0
7817,6b07c3a9a95493cf,b2e3aca4cd363477,056c493bbd76a918,2015-03-14,0,0,0,900,0,0,71,11,71,0,0,0,0,0,21,11,50,11,0.0,524.9
7818,66aa57912b5c5170,0941df56f6ac954b,31123249b0bbf52e,2015-03-14,0,0,0,900,10,9,67,27,41,26,2,2,24,13,8,7,33,14,577.2,230.5
7819,66aa57912b5c5170,31123249b0bbf52e,0941df56f6ac954b,2015-03-14,0,0,0,900,0,0,49,16,47,2,0,0,2,2,9,7,38,14,3.5,301.79999999999995
7820,39e6cba2480c6d82,6a2f7c151031653d,cbb682f5fcc44bfc,2015-03-14,0,0,0,1500,10,9,171,44,141,30,4,3,26,18,54,43,87,26,563.0,605.0
7821,39e6cba2480c6d82,cbb682f5fcc44bfc,6a2f7c151031653d,2015-03-14,0,0,0,1500,1,0,162,38,161,1,0,0,1,0,21,16,140,38,13.0,885.0
7822,27e421b97bf57d3d,34f88592c0ab7a54,3a12a2f096a6d975,2015-03-14,1,0,0,547,4,2,113,24,92,21,0,0,21,14,31,15,61,10,104.2,413.0
7823,27e421b97bf57d3d,3a12a2f096a6d975,34f88592c0ab7a54,2015-03-14,0,0,0,547,0,0,49,7,49,0,0,0,0,0,15,9,34,7,0.0,442.8
7824,1cde536c460b1a0e,16b89be2f5c16fba,1d239d571e342453,2015-03-14,0,0,0,422,0,0,60,4,60,0,0,0,0,0,12,4,48,4,0.0,403.0
7825,1cde536c460b1a0e,1d239d571e342453,16b89be2f5c16fba,2015-03-14,1,0,0,422,0,0,84,26,84,0,0,0,0,0,8,3,76,26,0.0,417.0
7826,0337fa731f5b02c1,4f732e58ed907eff,501b07aec9b8fc2d,2015-03-14,1,0,0,393,0,0,75,16,73,2,0,0,2,2,16,9,57,14,2.0,391.0
7827,0337fa731f5b02c1,501b07aec9b8fc2d,4f732e58ed907eff,2015-03-14,0,0,0,393,1,0,111,12,111,0,0,0,0,0,20,11,91,12,0.0,390.0
7828,0027e179b743c86c,3aa794cbe1e3484b,91ea901c458e95dd,2015-03-14,0,0,0,792,0,0,36,7,36,0,0,0,0,0,2,2,34,7,0.0,533.8
7829,0027e179b743c86c,91ea901c458e95dd,3aa794cbe1e3484b,2015-03-14,1,0,0,792,6,2,45,19,28,17,0,0,17,10,4,3,24,9,258.2,473.0
7830,ffea776913451b6d,22a92d7f62195791,75e5fec9f72910ef,2015-02-28,0,2,1,157,1,1,38,5,30,8,1,1,7,2,10,5,20,3,45.0,112.0
7831,ffea776913451b6d,75e5fec9f72910ef,22a92d7f62195791,2015-02-28,0,0,0,157,1,0,20,2,20,0,0,0,0,0,2,0,18,2,0.0,112.0
7832,fe49ef11584415d0,179f1948dc234f1f,1c86754617d9813a,2015-02-28,0,0,0,100,1,0,1,0,1,0,0,0,0,0,1,0,0,0,0.0,100.0
7833,fe49ef11584415d0,1c86754617d9813a,179f1948dc234f1f,2015-02-28,0,1,1,100,0,0,3,0,3,0,0,0,0,0,1,1,2,0,0.0,47.0
7834,f3e1c02ce14bccfe,7e208569469c8bc8,d3df1add9d9a7efb,2015-02-28,0,1,0,498,3,1,13,2,9,4,0,0,4,2,7,5,2,0,100.0,166.3
7835,f3e1c02ce14bccfe,d3df1add9d9a7efb,7e208569469c8bc8,2015-02-28,1,0,0,498,2,0,82,47,11,71,2,2,69,44,4,4,7,3,231.7,150.0
7836,e083c7ae1548e08a,3ecd936bd8814108,8bdac25ce0bb874d,2015-02-28,0,0,0,14,0,0,1,0,1,0,0,0,0,0,1,0,0,0,0.0,11.0
7837,e083c7ae1548e08a,8bdac25ce0bb874d,3ecd936bd8814108,2015-02-28,0,1,1,14,0,0,0,0,0,0,0,0,0,0,0,0,0,0,0.0,9.0
7838,adc1038ed2e76391,777dea713da2441d,8f6a18831a120817,2015-02-28,0,0,0,900,0,0,254,60,254,0,0,0,0,0,43,27,211,60,0.0,876.0
7839,adc1038ed2e76391,8f6a18831a120817,777dea713da2441d,2015-02-28,0,0,0,900,10,0,209,58,209,0,0,0,0,0,43,29,166,58,0.0,798.0
7840,9f4bc2063685211c,303a05a7aa3ff761,cf65d56b0755ed3b,2015-02-28,0,0,0,139,0,0,20,3,20,0,0,0,0,0,9,7,11,3,0.0,122.0
7841,9f4bc2063685211c,cf65d56b0755ed3b,303a05a7aa3ff761,2015-02-28,1,0,0,139,0,0,25,7,25,0,0,0,0,0,7,5,18,7,0.0,138.0
7842,618b581f14a37e06,d81ac739417d7f53,dd37fd509af89f15,2015-02-28,0,1,1,560,0,0,52,14,52,0,0,0,0,0,1,1,51,14,0.0,538.0
7843,618b581f14a37e06,dd37fd509af89f15,d81ac739417d7f53,2015-02-28,0,0,0,560,6,1,40,5,40,0,0,0,0,0,5,2,35,5,0.0,348.0
7844,5c827dd56a08f700,4638cc6479cc0afe,e4e0f310b3cf23a8,2015-02-28,0,0,0,900,2,1,134,32,130,4,0,0,4,2,13,9,117,30,10.3,802.0
7845,5c827dd56a08f700,e4e0f310b3cf23a8,4638cc6479cc0afe,2015-02-28,0,0,0,900,9,2,99,22,99,0,0,0,0,0,26,15,73,22,0.0,694.7
7846,31e62d34abc3a762,634e2fb70bde3fd5,fc169c387b4b465d,2015-02-28,0,0,0,900,0,0,210,17,210,0,0,0,0,0,46,27,164,17,0.0,895.6
7847,31e62d34abc3a762,fc169c387b4b465d,634e2fb70bde3fd5,2015-02-28,0,0,0,900,5,0,139,24,138,1,0,0,1,1,32,16,106,23,1.4,885.0
7848,28255055879685bc,4834ff149dc9542a,72c4b253d2f5ebf2,2015-02-28,0,0,0,457,0,0,49,12,49,0,0,0,0,0,9,7,40,12,0.0,457.0
7849,28255055879685bc,72c4b253d2f5ebf2,4834ff149dc9542a,2015-02-28,0,0,0,457,2,1,49,12,49,0,0,0,0,0,6,4,43,12,0.0,447.0
7850,203b3098d892c3b1,4b47e71384a9522f,e9213f53ddeca978,2015-02-28,2,0,0,137,0,0,42,16,39,3,0,0,3,2,11,7,28,14,4.7,115.0
7851,203b3098d892c3b1,e9213f53ddeca978,4b47e71384a9522f,2015-02-28,0,0,0,137,1,0,24,6,24,0,0,0,0,0,4,1,20,6,0.0,130.3
7852,ec659c4e19f62700,8f0d576beba1cfcd,ed74afc8b5b47a61,2015-02-22,1,0,0,194,1,0,37,10,32,5,0,0,5,4,11,3,21,6,3.0,191.0
7853,ec659c4e19f62700,ed74afc8b5b47a61,8f0d576beba1cfcd,2015-02-22,0,0,0,194,0,0,20,1,20,0,0,0,0,0,11,7,9,1,0.0,191.0
7854,d785f22c4cc99a3d,511e82663651438d,64a50dad704d1d49,2015-02-22,0,0,0,900,1,1,187,27,183,4,0,0,4,2,30,11,153,25,48.8,839.0
7855,d785f22c4cc99a3d,64a50dad704d1d49,511e82663651438d,2015-02-22,0,0,0,900,2,0,98,15,98,0,0,0,0,0,28,16,70,15,0.0,851.2
7856,c7cbf6b47051fa7d,2f95a3c6d58b2aad,9ba2226646046b63,2015-02-22,0,0,0,900,4,2,59,18,56,3,0,0,3,3,15,13,41,15,20.7,535.9
7857,c7cbf6b47051fa7d,9ba2226646046b63,2f95a3c6d58b2aad,2015-02-22,0,0,0,900,4,3,95,16,54,41,16,12,25,12,28,16,26,4,302.1,459.3
7858,b6a609806d44659f,19db7ac26308178f,1d36f1ac66cf689d,2015-02-22,0,1,0,900,10,3,64,10,64,0,0,0,0,0,25,15,39,10,0.0,521.3
7859,b6a609806d44659f,1d36f1ac66cf689d,19db7ac26308178f,2015-02-22,0,0,0,900,2,0,72,18,69,3,0,0,3,1,13,4,56,17,11.7,818.0
7860,a7ff11c5dfe65e86,1971869b7e054261,8ce87f7e3a9baed2,2015-02-22,1,0,0,179,1,0,30,15,20,10,0,0,10,8,1,1,19,7,18.8,147.0
7861,a7ff11c5dfe65e86,8ce87f7e3a9baed2,1971869b7e054261,2015-02-22,0,0,0,179,2,0,12,1,12,0,0,0,0,0,8,6,4,1,0.0,76.2
7862,82e713f037e37fe9,0d8011111be000b2,6d1bffff14897645,2015-02-22,0,0,0,900,4,2,167,39,166,1,0,0,1,1,13,5,153,38,13.7,814.5
7863,82e713f037e37fe9,6d1bffff14897645,0d8011111be000b2,2015-02-22,0,0,0,900,3,1,162,39,161,1,0,0,1,1,31,11,130,38,3.5,858.3
7864,76726a66840ccfa4,6a1901c62ab3870f,c7d297714d9ab1a4,2015-02-22,1,0,0,114,0,0,15,5,15,0,0,0,0,0,1,1,14,5,0.0,52.0
7865,76726a66840ccfa4,c7d297714d9ab1a4,6a1901c62ab3870f,2015-02-22,0,1,1,114,0,0,16,5,16,0,0,0,0,0,1,1,15,5,0.0,114.0
7866,4228886e94a25a63,7dcf06c1967801c1,9b7694d064a8a0ad,2015-02-22,0,0,0,900,4,3,38,6,36,2,0,0,2,0,7,6,29,6,118.0,782.0
7867,4228886e94a25a63,9b7694d064a8a0ad,7dcf06c1967801c1,2015-02-22,0,0,0,900,4,0,80,10,80,0,0,0,0,0,16,8,64,10,0.0,775.0
7868,223f9a750428e1d0,1ff9589f9065a9ed,8349d55cdecd393a,2015-02-22,1,0,0,100,0,0,18,10,10,8,0,0,8,6,0,0,10,4,6.0,94.0
7869,223f9a750428e1d0,8349d55cdecd393a,1ff9589f9065a9ed,2015-02-22,0,0,0,100,0,0,3,0,3,0,0,0,0,0,3,1,0,0,0.0,94.0
7870,1574bb7476c9e556,d156513a19acf856,dbc17725b887860a,2015-02-22,1,0,0,214,0,0,8,4,6,2,0,0,2,2,0,0,6,2,2.0,211.0
7871,1574bb7476c9e556,dbc17725b887860a,d156513a19acf856,2015-02-22,0,0,0,214,0,0,36,6,36,0,0,0,0,0,13,7,23,6,0.0,212.0
7872,10cff9ac7ce89c28,3a314d9fa7c6825d,700a674c042b7a96,2015-02-22,1,0,0,900,1,0,131,16,127,4,1,1,3,2,31,22,96,14,44.0,823.0
7873,10cff9ac7ce89c28,700a674c042b7a96,3a314d9fa7c6825d,2015-02-22,0,0,0,900,5,0,137,23,137,0,0,0,0,0,13,7,124,23,0.0,840.0
7874,fb5ce6329f243d8b,2676b28836a5a836,638cfec7ec559d6e,2015-02-14,0,1,1,1138,5,3,154,26,149,5,2,2,3,3,43,29,106,23,171.9,861.5
7875,fb5ce6329f243d8b,638cfec7ec559d6e,2676b28836a5a836,2015-02-14,0,0,0,1138,3,2,143,23,142,1,0,0,1,0,32,21,110,23,1.5,949.1
7876,dcee56e0cbfacb45,e51fcd9cd84c0b93,ee9ebceabfd16fa7,2015-02-14,0,0,0,900,9,3,89,26,89,0,0,0,0,0,9,7,80,26,0.0,560.2
7877,dcee56e0cbfacb45,ee9ebceabfd16fa7,e51fcd9cd84c0b93,2015-02-14,0,3,0,900,5,4,153,42,134,19,3,2,16,12,23,18,111,30,145.8,616.0
7878,b91807add93763c9,4bd6b4800070b069,fe5a9547479396ab,2015-02-14,1,0,0,599,5,0,68,33,66,2,2,2,0,0,9,7,57,33,13.0,456.0
7879,b91807add93763c9,fe5a9547479396ab,4bd6b4800070b069,2015-02-14,0,1,0,599,2,1,63,24,63,0,0,0,0,0,11,9,52,24,0.0,491.0
7880,a4badfa86304f799,83fd97284f4bb4a4,a4dc47001f202bcd,2015-02-14,1,0,0,900,2,2,129,74,88,41,4,3,37,31,17,17,71,43,266.9,330.4
7881,a4badfa86304f799,a4dc47001f202bcd,83fd97284f4bb4a4,2015-02-14,0,0,0,900,8,3,72,13,65,7,1,1,6,4,12,10,53,9,198.6,406.1
7882,93ac52a9fdca03e1,57ab4d7c0bc09a30,c96d9178c9ed9e62,2015-02-14,0,0,0,900,11,6,33,14,22,11,2,2,9,8,5,5,17,6,439.3,257.2
7883,93ac52a9fdca03e1,c96d9178c9ed9e62,57ab4d7c0bc09a30,2015-02-14,0,0,0,900,2,1,88,31,67,21,1,1,20,14,15,11,52,17,43.8,385.7
7884,60820d105e57d5d6,b4c96c3d9139bf0e,bdcbb976816fd256,2015-02-14,0,0,0,900,4,1,296,49,296,0,0,0,0,0,1,1,295,49,0.0,898.0
7885,60820d105e57d5d6,bdcbb976816fd256,b4c96c3d9139bf0e,2015-02-14,0,0,0,900,0,0,190,59,190,0,0,0,0,0,3,2,187,59,0.0,900.0
7886,509bd83b00e4ab7c,150ff4cc642270b9,282fa667ff9c51ed,2015-02-14,0,0,0,900,1,1,176,40,170,6,1,1,5,3,30,16,140,37,54.4,742.6
7887,509bd83b00e4ab7c,282fa667ff9c51ed,150ff4cc642270b9,2015-02-14,0,0,0,900,2,0,132,12,131,1,0,0,1,0,39,19,92,12,3.4,814.6
7888,357781ff34a3d39f,5904b0b38dc6718d,c06a9b48d4132c8e,2015-02-14,0,0,0,409,8,0,32,10,25,7,0,0,7,4,3,2,22,6,77.0,180.6
7889,357781ff34a3d39f,c06a9b48d4132c8e,5904b0b38dc6718d,2015-02-14,0,1,1,409,0,0,63,25,33,30,2,1,28,13,8,6,25,12,85.4,184.0
7890,1a3572d1502efdf4,56c9acc4e86046a2,a4de54ea806fb525,2015-02-14,0,0,0,776,1,0,12,2,12,0,0,0,0,0,4,2,8,2,0.0,68.89999999999998
7891,1a3572d1502efdf4,a4de54ea806fb525,56c9acc4e86046a2,2015-02-14,0,4,1,776,6,5,28,11,7,21,6,6,15,10,2,2,5,1,669.1,75.0
7892,0bdb170e1fef36b6,71df36d6d8cf0d74,84b3e7d38f2d2ec5,2015-02-14,0,0,0,682,4,1,28,5,28,0,0,0,0,0,6,5,22,5,0.0,369.2
7893,0bdb170e1fef36b6,84b3e7d38f2d2ec5,71df36d6d8cf0d74,2015-02-14,0,1,1,682,4,3,112,52,91,21,3,3,18,16,28,21,63,36,120.8,354.0
7894,fa537adfb4a7b719,0dba4df5f34d5ff0,6809c31286b08d97,2015-01-31,0,0,0,900,13,8,152,43,146,6,0,0,6,1,27,24,119,42,157.5,690.0
7895,fa537adfb4a7b719,6809c31286b08d97,0dba4df5f34d5ff0,2015-01-31,0,0,0,900,0,0,150,13,150,0,0,0,0,0,44,16,106,13,0.0,742.5
7896,f4e490d25bd62d39,1f454354805b6f75,f57a8a52ca401ed9,2015-01-31,0,0,0,1500,0,0,217,57,217,0,0,0,0,0,62,51,155,57,0.0,1498.0
7897,f4e490d25bd62d39,f57a8a52ca401ed9,1f454354805b6f75,2015-01-31,0,0,0,1500,1,0,223,39,223,0,0,0,0,0,83,38,140,39,0.0,1498.0
7898,d52a5d085bfa569b,8c0580d4fff106c1,effd9de9937996f8,2015-01-31,0,0,0,900,0,0,143,13,143,0,0,0,0,0,34,19,109,13,0.0,858.0
7899,d52a5d085bfa569b,effd9de9937996f8,8c0580d4fff106c1,2015-01-31,0,0,0,900,0,0,104,14,104,0,0,0,0,0,28,13,76,14,0.0,874.0
7900,cbb4673397b5e96f,3bad7ef643840f67,59279a7c978f7da0,2015-01-31,0,0,0,514,1,0,86,31,86,0,0,0,0,0,2,1,84,31,0.0,496.8
7901,cbb4673397b5e96f,59279a7c978f7da0,3bad7ef643840f67,2015-01-31,1,0,0,514,3,1,154,44,148,6,0,0,6,3,22,15,126,41,10.2,492.0
7902,c699c0e56664ff11,701e057d63c124d9,c268b2cfebccf652,2015-01-31,0,0,0,900,6,1,92,13,77,15,6,6,9,3,28,21,49,10,126.0,680.8
7903,c699c0e56664ff11,c268b2cfebccf652,701e057d63c124d9,2015-01-31,0,3,0,900,0,0,121,19,117,4,0,0,4,0,35,19,82,19,9.2,728.0
7904,b347480405118de5,06f36cf4bd97ec77,b1a3e0aca758b322,2015-01-31,0,0,0,36,0,0,4,0,4,0,0,0,0,0,0,0,4,0,0.0,31.0
7905,b347480405118de5,b1a3e0aca758b322,06f36cf4bd97ec77,2015-01-31,1,0,0,36,0,0,18,10,6,12,0,0,12,7,1,1,5,3,5.0,31.0
7906,7fa227a1c5ef2238,7be74a12d7352df2,b96619b3acd7d9da,2015-01-31,1,0,0,900,2,1,105,25,83,22,0,0,22,8,14,9,69,17,209.4,338.0
7907,7fa227a1c5ef2238,b96619b3acd7d9da,7be74a12d7352df2,2015-01-31,0,2,0,900,0,0,60,14,51,9,2,2,7,5,9,7,42,9,267.0,334.6
7908,776a8a645868f616,c80095f6092271a7,cfb65863d5099327,2015-01-31,1,0,0,525,0,0,65,22,61,4,0,0,4,3,5,4,56,19,10.9,487.0
7909,776a8a645868f616,cfb65863d5099327,c80095f6092271a7,2015-01-31,0,2,1,525,2,1,61,16,61,0,0,0,0,0,7,4,54,16,0.0,393.1
7910,6451724f8a836167,993d385f5a475375,dea070ed4a2a8281,2015-01-31,0,0,0,116,0,0,28,1,28,0,0,0,0,0,0,0,28,1,0.0,111.5
7911,6451724f8a836167,dea070ed4a2a8281,993d385f5a475375,2015-01-31,1,0,0,116,0,0,38,15,27,11,0,0,11,8,6,5,21,7,4.5,109.0
7912,5b0ebb843af7465e,7c6e87729e824ef4,9147679e1a4ad4a3,2015-01-31,0,0,0,900,1,0,75,12,74,1,0,0,1,0,14,9,60,12,12.2,744.2
7913,5b0ebb843af7465e,9147679e1a4ad4a3,7c6e87729e824ef4,2015-01-31,0,0,0,900,6,0,59,12,53,6,0,0,6,0,7,3,46,12,94.8,729.8
7914,0a2f344e419bd4fd,2aa49b3766a59bcd,31ee470ef5dc8d7f,2015-01-31,0,0,0,339,0,0,96,30,96,0,0,0,0,0,8,7,88,30,0.0,335.9
7915,0a2f344e419bd4fd,31ee470ef5dc8d7f,2aa49b3766a59bcd,2015-01-31,1,0,0,339,0,0,68,13,60,8,0,0,8,6,17,10,43,7,3.1,334.0
7916,f88fefd5df0ba06c,49a74b9fb2e45fdf,55f446032177b119,2015-01-24,0,4,0,900,3,1,152,50,136,16,0,0,16,14,15,6,121,36,27.9,640.8
7917,f88fefd5df0ba06c,55f446032177b119,49a74b9fb2e45fdf,2015-01-24,0,0,0,900,4,2,135,26,108,27,4,2,23,11,14,11,94,15,212.2,589.1
7918,f47a32ec7dfda660,365fee2da473b177,3c6976f8182d9527,2015-01-24,1,0,0,135,0,0,47,29,26,21,0,0,21,17,2,1,24,12,25.8,103.0
7919,f47a32ec7dfda660,3c6976f8182d9527,365fee2da473b177,2015-01-24,0,0,0,135,0,0,20,8,20,0,0,0,0,0,4,2,16,8,0.0,109.2
7920,ee65977baeca3c85,4f11e9ce318ffbcb,8f5c8850b2484173,2015-01-24,0,0,0,338,1,0,38,6,37,1,1,0,0,0,4,3,33,6,0.0,289.2
7921,ee65977baeca3c85,8f5c8850b2484173,4f11e9ce318ffbcb,2015-01-24,1,0,0,338,2,2,59,26,47,12,1,1,11,7,14,10,33,19,48.8,277.0
7922,eb0775cf8ee7a4e6,3f52ce18fb98008f,b8aef0faf4ce9b31,2015-01-24,0,0,0,206,0,0,31,5,31,0,0,0,0,0,9,5,22,5,0.0,198.0
7923,eb0775cf8ee7a4e6,b8aef0faf4ce9b31,3f52ce18fb98008f,2015-01-24,1,0,0,206,0,0,26,6,25,1,0,0,1,1,5,4,20,5,6.0,182.0
7924,eab6e19a2a2a67f0,8b5f9ea38184ded3,ff6a1f63c254127e,2015-01-24,0,0,0,900,10,0,190,35,190,0,0,0,0,0,37,30,153,35,0.0,822.6
7925,eab6e19a2a2a67f0,ff6a1f63c254127e,8b5f9ea38184ded3,2015-01-24,0,0,0,900,1,0,201,81,200,1,0,0,1,0,20,6,180,81,1.4,893.0
7926,c910d2fe570b368a,1ccf4e7caff270df,232c582f29f8f65e,2015-01-24,0,0,0,70,0,0,11,1,11,0,0,0,0,0,3,3,8,1,0.0,68.0
7927,c910d2fe570b368a,232c582f29f8f65e,1ccf4e7caff270df,2015-01-24,1,0,0,70,0,0,22,3,21,1,0,0,1,1,1,1,20,2,2.0,68.0
7928,c740ceb0427b6317,3f56b99447f00607,cbd3e590a85b18c5,2015-01-24,0,0,0,900,2,0,7,1,7,0,0,0,0,0,1,1,6,1,0.0,67.0
7929,c740ceb0427b6317,cbd3e590a85b18c5,3f56b99447f00607,2015-01-24,0,0,0,900,3,2,56,33,16,40,1,1,39,28,0,0,16,5,833.0,67.0
7930,c565bf49fce2a4cd,6e0273f9478be71e,e70de1859b7ee78e,2015-01-24,1,0,0,162,3,0,33,8,31,2,0,0,2,2,8,6,23,6,11.6,133.0
7931,c565bf49fce2a4cd,e70de1859b7ee78e,6e0273f9478be71e,2015-01-24,0,0,0,162,0,0,14,5,14,0,0,0,0,0,3,3,11,5,0.0,128.4
7932,c3544bce29be1281,902ab9197b83d0db,c0ab242c40decc55,2015-01-24,0,0,0,900,9,0,129,11,129,0,0,0,0,0,43,24,86,11,0.0,802.0
7933,c3544bce29be1281,c0ab242c40decc55,902ab9197b83d0db,2015-01-24,0,0,0,900,3,1,117,19,116,1,0,0,1,1,15,7,101,18,9.0,855.0
7934,b2398418be9a3442,1091d4d957141094,1d4bbaabd8b60173,2015-01-24,1,1,1,84,0,0,16,11,6,10,0,0,10,9,2,2,4,2,25.0,54.0
7935,b2398418be9a3442,1d4bbaabd8b60173,1091d4d957141094,2015-01-24,0,0,0,84,1,0,8,4,8,0,0,0,0,0,1,0,7,4,0.0,49.0
7936,9c1d4f57a997a490,87a1dc546b1c5caf,b6c4451cb13c9303,2015-01-24,1,0,0,8,0,0,7,5,2,5,0,0,5,4,1,1,1,1,2.0,6.0
7937,9c1d4f57a997a490,b6c4451cb13c9303,87a1dc546b1c5caf,2015-01-24,0,0,0,8,0,0,0,0,0,0,0,0,0,0,0,0,0,0,0.0,6.0
7938,96f09d5db68951ef,202b0467521c9d6f,22061ff217907c78,2015-01-24,0,0,0,900,13,4,59,25,32,27,3,2,24,20,9,8,23,5,447.5,353.0
7939,96f09d5db68951ef,22061ff217907c78,202b0467521c9d6f,2015-01-24,0,0,0,900,0,0,36,11,36,0,0,0,0,0,8,6,28,11,0.0,452.5
7940,cf38ced734978fb8,7b310409440c9102,c8097968da5e5f13,2015-01-18,0,0,0,900,7,0,46,7,45,1,0,0,1,1,27,21,18,6,8.7,525.5
7941,cf38ced734978fb8,c8097968da5e5f13,7b310409440c9102,2015-01-18,0,0,0,900,9,4,65,18,54,11,4,3,7,6,32,26,22,12,148.5,351.3
7942,a4a78ec539238a5f,3a524c6700addc24,b12fc8a41e82d3a2,2015-01-18,0,0,0,900,1,0,167,44,167,0,0,0,0,0,20,11,147,44,0.0,799.9
7943,a4a78ec539238a5f,b12fc8a41e82d3a2,3a524c6700addc24,2015-01-18,1,1,0,900,2,2,211,50,194,17,1,1,16,10,10,7,184,40,96.1,753.0
7944,93569f4876c20488,1d00756835ca67c9,2676b28836a5a836,2015-01-18,0,0,0,900,7,1,125,19,125,0,0,0,0,0,49,38,76,19,0.0,868.0
7945,93569f4876c20488,2676b28836a5a836,1d00756835ca67c9,2015-01-18,0,0,0,900,1,0,155,13,155,0,0,0,0,0,84,73,71,13,0.0,900.0
7946,90e5169190971647,9450848a71d53776,fc31f896cde2bc2e,2015-01-18,1,0,0,137,0,0,50,24,40,10,0,0,10,10,6,5,34,14,8.5,126.0
7947,90e5169190971647,fc31f896cde2bc2e,9450848a71d53776,2015-01-18,0,0,0,137,0,0,15,0,15,0,0,0,0,0,11,10,4,0,0.0,98.5
7948,85e57ad2b3831621,40093d1d2d78394e,bd5403efbaa445c0,2015-01-18,0,4,1,883,8,5,102,25,98,4,1,0,3,2,16,12,82,23,96.0,510.8
7949,85e57ad2b3831621,bd5403efbaa445c0,40093d1d2d78394e,2015-01-18,0,0,0,883,7,3,109,41,103,6,1,1,5,4,29,27,74,37,36.2,600.0
7950,837a7a922066b214,65578a75fa7900e3,6dd758d34da8d254,2015-01-18,1,0,0,217,0,0,41,13,29,12,0,0,12,9,16,14,13,4,29.5,185.0
7951,837a7a922066b214,6dd758d34da8d254,65578a75fa7900e3,2015-01-18,0,0,0,217,0,0,18,3,18,0,0,0,0,0,8,7,10,3,0.0,187.5
7952,6359bba789ce28ae,99c7610aa74995d3,ab850a77a0fa487d,2015-01-18,0,0,0,900,12,4,112,20,110,2,0,0,2,0,36,29,74,20,53.6,629.0
7953,6359bba789ce28ae,ab850a77a0fa487d,99c7610aa74995d3,2015-01-18,1,0,0,900,0,0,155,41,151,4,0,0,4,2,23,11,128,39,3.0,840.4
7954,53d2d2de5c4cccf2,1f4b04a926ef1287,96c336b463e0662c,2015-01-18,1,0,0,714,5,4,111,40,52,59,9,6,50,32,16,13,36,8,425.0,277.3
7955,53d2d2de5c4cccf2,96c336b463e0662c,1f4b04a926ef1287,2015-01-18,0,1,0,714,4,1,39,6,38,1,0,0,1,1,13,10,25,5,11.7,254.0
7956,4d3cd5ecf4276c92,7b39035fae7268b8,cb52f9490c2dc069,2015-01-18,0,0,0,731,0,0,212,54,212,0,0,0,0,0,57,46,155,54,0.0,691.5
7957,4d3cd5ecf4276c92,cb52f9490c2dc069,7b39035fae7268b8,2015-01-18,1,0,0,731,2,0,141,44,139,2,0,0,2,1,28,22,111,43,13.5,522.0
7958,3d468536e8904b93,5f87a5c00b3d17ed,f4c49976c75c5ab2,2015-01-18,0,0,0,414,3,0,104,13,104,0,0,0,0,0,36,19,68,13,0.0,400.8
7959,3d468536e8904b93,f4c49976c75c5ab2,5f87a5c00b3d17ed,2015-01-18,1,0,0,414,0,0,119,49,110,9,0,0,9,7,20,15,90,42,10.2,388.0
7960,2d24929eaadf0351,6e7c758f5cdec01a,a7de976620f2ed13,2015-01-18,0,2,0,900,4,3,74,28,57,17,1,1,16,14,17,13,40,14,562.9,289.0
7961,2d24929eaadf0351,a7de976620f2ed13,6e7c758f5cdec01a,2015-01-18,0,0,0,900,0,0,64,11,59,5,0,0,5,2,14,11,45,9,15.0,322.1
7962,293919e355b362b1,14ff46596ad80609,75e5fec9f72910ef,2015-01-18,0,0,0,900,10,0,140,22,140,0,0,0,0,0,41,21,99,22,0.0,823.4
7963,293919e355b362b1,75e5fec9f72910ef,14ff46596ad80609,2015-01-18,0,0,0,900,6,2,127,21,126,1,0,0,1,0,21,17,105,21,8.6,780.0
7964,f81cd5b3903bccf8,98aa60cf58071fd6,b72a60a0cadff408,2015-01-03,0,0,0,900,2,1,108,30,108,0,0,0,0,0,19,14,89,30,0.0,782.0
7965,f81cd5b3903bccf8,b72a60a0cadff408,98aa60cf58071fd6,2015-01-03,0,2,0,900,1,0,89,6,89,0,0,0,0,0,32,17,57,6,0.0,900.0
7966,f4d91498ca3f0a1f,08e908ed6d18d6a0,1d00756835ca67c9,2015-01-03,0,0,0,900,7,1,53,5,53,0,0,0,0,0,21,10,32,5,0.0,613.2
7967,f4d91498ca3f0a1f,1d00756835ca67c9,08e908ed6d18d6a0,2015-01-03,0,2,0,900,1,1,83,6,74,9,8,6,1,1,33,25,41,5,165.8,679.0
7968,f3100979573e2895,6da99156486ed6c2,db1f2ed63b54b9a7,2015-01-03,0,0,0,900,2,0,128,21,128,0,0,0,0,0,33,21,95,21,0.0,885.5
7969,f3100979573e2895,db1f2ed63b54b9a7,6da99156486ed6c2,2015-01-03,0,0,0,900,3,2,129,40,127,2,0,0,2,2,20,13,107,38,14.5,791.0
7970,e4a9c93ff23eb5bb,16690d100f995f8f,a9bcf8717dd12532,2015-01-03,0,0,0,900,9,5,184,48,162,22,3,2,19,15,21,14,141,33,167.1,601.4
7971,e4a9c93ff23eb5bb,a9bcf8717dd12532,16690d100f995f8f,2015-01-03,0,3,0,900,6,5,92,19,91,1,0,0,1,1,14,14,77,18,17.6,556.9
7972,e0f49380b9d31de0,4ae4049426e0161d,c7d297714d9ab1a4,2015-01-03,0,0,0,900,3,0,116,7,116,0,0,0,0,0,37,21,79,7,0.0,884.9
7973,e0f49380b9d31de0,c7d297714d9ab1a4,4ae4049426e0161d,2015-01-03,0,0,0,900,0,0,221,64,220,1,0,0,1,0,34,21,186,64,1.1,884.0
7974,cee94cd937bf64f2,d1e7fc58d4225cdf,e5010b1b94ca5755,2015-01-03,0,0,0,429,2,0,52,9,52,0,0,0,0,0,14,12,38,9,0.0,428.0
7975,cee94cd937bf64f2,e5010b1b94ca5755,d1e7fc58d4225cdf,2015-01-03,1,0,0,429,0,0,94,10,92,2,0,0,2,1,29,23,63,9,1.0,427.0
7976,c0ca05832f518fef,13a0275fa13c4d26,ca2efc9d7d523c43,2015-01-03,0,0,0,177,0,0,20,5,20,0,0,0,0,0,8,5,12,5,0.0,174.0
7977,c0ca05832f518fef,ca2efc9d7d523c43,13a0275fa13c4d26,2015-01-03,1,0,0,177,0,0,31,10,25,6,0,0,6,4,4,2,21,6,3.0,174.0
7978,b2cda211e0e72811,0c6d9ea8306c029e,a8e6a69796280f17,2015-01-03,0,0,0,900,1,1,119,31,119,0,0,0,0,0,28,19,91,31,0.0,871.0
7979,b2cda211e0e72811,a8e6a69796280f17,0c6d9ea8306c029e,2015-01-03,0,0,0,900,7,0,64,14,64,0,0,0,0,0,25,16,39,14,0.0,813.0
7980,b10a94377bce3e22,a20d7dfaba74c067,e5c9de15bb58b1c6,2015-01-03,0,0,0,900,0,0,153,37,153,0,0,0,0,0,14,10,139,37,0.0,900.0
7981,b10a94377bce3e22,e5c9de15bb58b1c6,a20d7dfaba74c067,2015-01-03,0,0,0,900,2,1,344,125,344,0,0,0,0,0,40,27,304,125,0.0,866.0
7982,57385188587c83b9,07f72a2a7591b409,d967f0128c323de6,2015-01-03,0,0,0,1500,5,3,178,43,175,3,0,0,3,1,67,49,108,42,22.4,1085.7
7983,57385188587c83b9,d967f0128c323de6,07f72a2a7591b409,2015-01-03,0,0,0,1500,8,1,165,40,163,2,0,0,2,1,35,18,128,39,4.3,1383.6
7984,22e7485bceb841af,81801f57bd0a7c41,d8c7c61b176e3994,2015-01-03,0,0,0,890,0,0,132,24,132,0,0,0,0,0,32,19,100,24,0.0,850.4
7985,22e7485bceb841af,d8c7c61b176e3994,81801f57bd0a7c41,2015-01-03,2,0,0,890,3,1,134,42,127,7,0,0,7,4,12,7,115,38,22.6,861.0
7986,fb4bce82541b4061,7c3c48cf54a2848e,d1e1fdcea7c8a90a,2014-12-20,0,1,0,553,2,1,19,4,19,0,0,0,0,0,7,4,12,4,0.0,286.2
7987,fb4bce82541b4061,d1e1fdcea7c8a90a,7c3c48cf54a2848e,2014-12-20,0,1,1,553,3,2,37,10,28,9,3,2,6,4,13,13,15,6,231.8,141.0
7988,e17c7b239e8d6c32,52e76bb4b3e852f3,e51e5cb722bd47a8,2014-12-20,0,1,0,900,2,1,29,8,26,3,0,0,3,2,4,4,22,6,22.2,205.39999999999998
7989,e17c7b239e8d6c32,e51e5cb722bd47a8,52e76bb4b3e852f3,2014-12-20,0,0,0,900,8,4,94,58,14,80,3,3,77,55,1,1,13,3,657.6,203.8
7990,d92abff61b0ff5db,53278852bcd91e11,ab943cd2c3c17825,2014-12-20,0,0,0,119,0,0,6,3,6,0,0,0,0,0,0,0,6,3,0.0,92.3
7991,d92abff61b0ff5db,ab943cd2c3c17825,53278852bcd91e11,2014-12-20,1,0,0,119,0,0,21,9,18,3,0,0,3,2,9,9,9,7,26.7,21.0
7992,c26a094aa7ce817e,5fceb45939fc0c8a,b6452706b373eea1,2014-12-20,0,0,0,510,0,0,64,7,64,0,0,0,0,0,32,26,32,7,0.0,489.3
7993,c26a094aa7ce817e,b6452706b373eea1,5fceb45939fc0c8a,2014-12-20,0,1,1,510,2,1,111,33,109,2,0,0,2,1,18,15,91,32,20.7,479.0
7994,b9893ab3bed62e60,4b47e71384a9522f,d53482bef23235ba,2014-12-20,0,0,0,900,2,1,68,24,61,7,0,0,7,6,26,19,35,18,79.9,687.3
7995,b9893ab3bed62e60,d53482bef23235ba,4b47e71384a9522f,2014-12-20,0,0,0,900,4,1,80,23,70,10,1,1,9,7,19,12,51,16,75.7,714.1
7996,b57aaf04af8bdd34,5d7bdab5e03e3216,f7a7f7118d4b01b6,2014-12-20,0,0,0,62,0,0,2,0,2,0,0,0,0,0,1,0,1,0,0.0,59.2
7997,b57aaf04af8bdd34,f7a7f7118d4b01b6,5d7bdab5e03e3216,2014-12-20,1,0,0,62,0,0,19,10,10,9,0,0,9,6,2,2,8,4,2.8,58.0
7998,9f5c84d05107f42b,92a9aa9c93192871,ed209f6618c82e41,2014-12-20,0,1,0,900,6,1,97,25,91,6,0,0,6,4,17,12,74,21,37.6,373.2
7999,9f5c84d05107f42b,ed209f6618c82e41,92a9aa9c93192871,2014-12-20,0,0,0,900,6,5,52,21,42,10,0,0,10,8,10,9,32,13,363.8,389.4
8000,8a6ecf3dc2b17c19,4bcb6eb12b4ad4aa,92fa1401b7927da3,2014-12-20,1,0,0,299,0,0,21,6,21,0,0,0,0,0,9,8,12,6,0.0,298.0
8001,8a6ecf3dc2b17c19,92fa1401b7927da3,4bcb6eb12b4ad4aa,2014-12-20,0,1,0,299,3,2,35,11,35,0,0,0,0,0,5,4,30,11,0.0,115.0
8002,8040697ea2f36dbd,52ba464d9068d871,7ea1f74cef32f906,2014-12-20,0,0,0,897,0,0,118,13,118,0,0,0,0,0,62,43,56,13,0.0,865.3
8003,8040697ea2f36dbd,7ea1f74cef32f906,52ba464d9068d871,2014-12-20,2,0,0,897,2,1,161,52,148,13,1,1,12,8,52,38,96,44,31.7,836.0
8004,647f6d2b9b784222,5866fc86183a9fb8,b7ad576b8ae115e6,2014-12-20,0,1,1,75,1,1,2,1,2,0,0,0,0,0,1,1,1,1,0.0,10.0
8005,647f6d2b9b784222,b7ad576b8ae115e6,5866fc86183a9fb8,2014-12-20,0,0,0,75,0,0,3,1,3,0,0,0,0,0,1,1,2,1,0.0,75.0
8006,53e818dd5abdf787,2c99576fefe53c7c,b8592b4a383696cd,2014-12-20,1,1,1,833,4,2,138,29,137,1,0,0,1,0,40,30,97,29,4.3,691.0
8007,53e818dd5abdf787,b8592b4a383696cd,2c99576fefe53c7c,2014-12-20,0,0,0,833,7,0,111,32,111,0,0,0,0,0,35,26,76,32,0.0,573.7
8008,317e6940e8bf5290,7e47047d0971d566,81b8b3fb019dc69d,2014-12-20,1,0,0,361,2,0,46,11,46,0,0,0,0,0,13,13,33,11,0.0,298.2
8009,317e6940e8bf5290,81b8b3fb019dc69d,7e47047d0971d566,2014-12-20,1,0,0,361,0,0,73,23,68,5,0,0,5,2,17,14,51,21,42.8,284.0
8010,deaeb2383bbd32bf,519e4fe37ce9ff75,a54fc2d6fc224dc3,2014-12-13,0,1,1,112,0,0,12,3,11,1,0,0,1,1,3,2,8,2,20.0,72.0
8011,deaeb2383bbd32bf,a54fc2d6fc224dc3,519e4fe37ce9ff75,2014-12-13,0,0,0,112,2,0,10,2,10,0,0,0,0,0,3,2,7,2,0.0,92.0
8012,d4bfe75b61d2cbc6,6a2f7c151031653d,8355922d564b152c,2014-12-13,0,0,0,900,2,2,119,46,68,51,1,1,50,38,37,30,31,8,450.3,432.0
8013,d4bfe75b61d2cbc6,8355922d564b152c,6a2f7c151031653d,2014-12-13,0,0,0,900,0,0,104,12,104,0,0,0,0,0,6,1,98,12,0.0,449.7
8014,a4816be2c49e3942,129537073431e52e,49f4b511932f71e9,2014-12-13,0,0,0,900,1,0,161,41,144,17,0,0,17,12,42,34,102,29,0.0,613.4
8015,a4816be2c49e3942,49f4b511932f71e9,129537073431e52e,2014-12-13,0,0,0,900,4,4,140,56,114,26,3,2,23,17,26,19,88,39,286.6,448.0
8016,7ab72866ff2a6a7e,8e8e4487c621aa1c,a331233f597090a5,2014-12-13,0,0,0,804,5,3,60,13,57,3,0,0,3,2,12,11,45,11,17.2,585.4
8017,7ab72866ff2a6a7e,a331233f597090a5,8e8e4487c621aa1c,2014-12-13,1,0,0,804,0,0,122,50,94,28,2,2,26,19,14,11,80,31,80.6,642.8
8018,70d69cf33984d7d1,3d6749c4267da18f,ec34349e7dffcde7,2014-12-13,1,0,0,900,0,0,125,20,118,7,1,0,6,3,22,18,96,17,16.2,685.7
8019,70d69cf33984d7d1,ec34349e7dffcde7,3d6749c4267da18f,2014-12-13,0,1,0,900,16,7,70,18,63,7,0,0,7,5,11,9,52,13,147.3,357.8
8020,64f5c4f3f3d8ad2c,6ded9184b2284645,92437c6775b3f7d1,2014-12-13,1,1,0,846,0,0,75,9,72,3,0,0,3,3,21,13,51,6,7.5,573.4
8021,64f5c4f3f3d8ad2c,92437c6775b3f7d1,6ded9184b2284645,2014-12-13,0,1,1,846,4,1,95,28,69,26,6,6,20,19,34,22,35,9,247.6,419.5
8022,5a346087f4120fa3,270b89c00ef0c55c,ba280572acfba13f,2014-12-13,0,0,0,119,0,0,12,4,12,0,0,0,0,0,3,2,9,4,0.0,112.0
8023,5a346087f4120fa3,ba280572acfba13f,270b89c00ef0c55c,2014-12-13,1,0,0,119,0,0,18,12,13,5,0,0,5,5,0,0,13,7,7.0,112.0
8024,383f0de18e7ab9c5,056c493bbd76a918,fe91d254db77a7fc,2014-12-13,1,0,0,900,2,0,145,43,137,8,0,0,8,3,36,29,101,40,4.1,880.0
8025,383f0de18e7ab9c5,fe91d254db77a7fc,056c493bbd76a918,2014-12-13,0,0,0,900,1,0,161,16,161,0,0,0,0,0,18,9,143,16,0.0,895.9
8026,2ab2753040f455e0,63def5a5662a6917,d28dee5c705991df,2014-12-13,1,0,0,1500,1,1,303,78,297,6,1,1,5,4,100,44,197,74,31.6,1405.1
8027,2ab2753040f455e0,d28dee5c705991df,63def5a5662a6917,2014-12-13,0,0,0,1500,18,1,193,77,190,3,0,0,3,1,13,12,177,76,15.9,1288.4
8028,1cf53a0b9db52ac6,484acc7b0f856ce9,d512d9f204059f57,2014-12-13,0,0,1,57,0,0,7,3,7,0,0,0,0,0,2,1,5,3,0.0,57.0
8029,1cf53a0b9db52ac6,d512d9f204059f57,484acc7b0f856ce9,2014-12-13,0,0,0,57,1,1,3,2,3,0,0,0,0,0,0,0,3,2,0.0,38.0
8030,1b23096378482313,c5a126ace82a6025,d7adfcfdf7c6c1f8,2014-12-13,0,0,0,64,1,1,9,4,2,7,0,0,7,4,1,0,1,0,26.0,38.0
8031,1b23096378482313,d7adfcfdf7c6c1f8,c5a126ace82a6025,2014-12-13,0,3,1,64,0,0,2,0,2,0,0,0,0,0,1,0,1,0,0.0,38.0
8032,002921976d27b7da,b4ad3a06ee4d660c,ebc1f40e00e0c481,2014-12-13,1,0,0,253,2,1,25,12,5,20,3,2,17,12,4,3,1,0,139.1,93.0
8033,002921976d27b7da,ebc1f40e00e0c481,b4ad3a06ee4d660c,2014-12-13,0,0,0,253,0,0,5,0,5,0,0,0,0,0,2,2,3,0,0.0,113.9
8034,fa2bed87e5d6c568,4a57ebb14315b251,c742287ed86a09bc,2014-12-12,0,0,0,900,2,1,102,44,87,15,6,5,9,7,7,6,80,37,102.0,467.0
8035,fa2bed87e5d6c568,c742287ed86a09bc,4a57ebb14315b251,2014-12-12,0,0,0,900,8,4,98,24,78,20,1,0,19,14,21,15,57,10,297.0,397.0
8036,ed3222701a8c0521,31ef8b67e13495b3,bd878a638e0e3be3,2014-12-12,1,0,0,900,1,1,196,57,196,0,0,0,0,0,59,39,137,57,0.0,862.0
8037,ed3222701a8c0521,bd878a638e0e3be3,31ef8b67e13495b3,2014-12-12,0,0,0,900,2,0,145,7,145,0,0,0,0,0,48,30,97,7,0.0,896.0
8038,e1cfe75b3a8fe709,77350fd0e6d1dba8,b6850671a008bf9a,2014-12-12,0,1,0,485,3,2,5,3,3,2,0,0,2,2,1,1,2,1,109.3,24.0
8039,e1cfe75b3a8fe709,b6850671a008bf9a,77350fd0e6d1dba8,2014-12-12,0,3,1,485,1,1,14,8,6,8,0,0,8,7,1,0,5,1,297.0,78.7
8040,da3210cd829fceb7,5f99b2bafb10305f,b7ffa72aa148599a,2014-12-12,0,0,0,325,3,2,59,11,59,0,0,0,0,0,14,12,45,11,0.0,301.0
8041,da3210cd829fceb7,b7ffa72aa148599a,5f99b2bafb10305f,2014-12-12,0,0,0,325,0,0,47,9,46,1,0,0,1,0,18,9,28,9,1.0,323.0
8042,d643fc29c147d33c,c1ea9d56cd953586,f0feeb2192937424,2014-12-12,0,0,0,900,12,2,91,15,91,0,0,0,0,0,39,26,52,15,0.0,539.5
8043,d643fc29c147d33c,f0feeb2192937424,c1ea9d56cd953586,2014-12-12,1,0,0,900,1,0,159,68,150,9,0,0,9,7,46,39,104,61,24.5,639.0
8044,d417609ea9670fb3,813550bc53b15fb0,a36556bb1565e32d,2014-12-12,1,1,1,277,0,0,66,8,60,6,2,1,4,2,24,16,36,6,24.0,249.0
8045,d417609ea9670fb3,a36556bb1565e32d,813550bc53b15fb0,2014-12-12,0,0,0,277,0,0,46,2,46,0,0,0,0,0,20,13,26,2,0.0,253.0
8046,b079f3d5ad290afb,12f91bfa8f1f723b,165c244bcca3ed26,2014-12-12,0,0,0,900,4,2,223,41,208,15,0,0,15,9,104,68,104,32,86.4,560.0
8047,b079f3d5ad290afb,165c244bcca3ed26,12f91bfa8f1f723b,2014-12-12,0,0,0,900,3,0,111,22,111,0,0,0,0,0,51,36,60,22,0.0,771.6
8048,a2c28daf0be59fa7,26b63bc5c0c1f65d,e50cd77732d39967,2014-12-12,0,0,0,293,1,1,15,5,13,2,0,0,2,1,8,7,5,4,18.5,83.30000000000001
8049,a2c28daf0be59fa7,e50cd77732d39967,26b63bc5c0c1f65d,2014-12-12,0,1,1,293,2,1,26,13,15,11,0,0,11,9,5,3,10,4,135.7,89.5
8050,73c70a628f0ef14b,47b63240018d5d86,d910665038efc639,2014-12-12,0,0,0,686,3,1,72,16,68,4,0,0,4,2,19,12,49,14,6.9,500.9
8051,73c70a628f0ef14b,d910665038efc639,47b63240018d5d86,2014-12-12,0,1,1,686,7,5,90,36,66,24,0,0,24,20,11,6,55,16,161.1,377.1
8052,54afe8c42e2062d6,907e60fd13407e1e,dd4c16777fb2ccf9,2014-12-12,0,0,0,900,2,0,118,45,117,1,0,0,1,1,29,24,88,44,1.7,730.1
8053,54afe8c42e2062d6,dd4c16777fb2ccf9,907e60fd13407e1e,2014-12-12,0,1,0,900,5,1,99,33,91,8,0,0,8,6,33,23,58,27,107.9,426.3
8054,18ba44e67d5c5f38,07225ba28ae309b6,18968f97ad34f15c,2014-12-12,0,3,0,900,7,2,67,25,56,11,1,1,10,7,20,17,36,18,126.5,270.1
8055,18ba44e67d5c5f38,18968f97ad34f15c,07225ba28ae309b6,2014-12-12,0,0,0,900,0,0,79,34,53,26,2,1,24,16,18,13,35,18,307.9,394.5
8056,c5ae278a05b73db9,78114b7199cef90c,7ea4a9f07df33a45,2014-12-06,1,1,1,394,3,0,52,15,49,3,0,0,3,2,10,4,39,13,8.4,380.0
8057,c5ae278a05b73db9,7ea4a9f07df33a45,78114b7199cef90c,2014-12-06,0,0,0,394,0,0,56,7,56,0,0,0,0,0,9,8,47,7,0.0,385.6
8058,bf1a7590c455bc7b,c17041f1bb5768d8,cc900c6a71ed23f3,2014-12-06,0,1,0,900,3,1,164,33,163,1,1,1,0,0,40,24,123,33,2.0,764.3
8059,bf1a7590c455bc7b,cc900c6a71ed23f3,c17041f1bb5768d8,2014-12-06,1,2,0,900,5,3,193,32,182,11,2,1,9,4,56,27,126,28,55.7,746.0
8060,acc987adeab45bfc,8cad40a75e5c97f5,9deff9e3e8d94d47,2014-12-06,0,0,0,488,2,2,15,8,8,7,0,0,7,6,0,0,8,2,393.0,95.0
8061,acc987adeab45bfc,9deff9e3e8d94d47,8cad40a75e5c97f5,2014-12-06,1,0,0,488,2,1,24,5,24,0,0,0,0,0,9,6,15,5,0.0,79.0
8062,9b1e3d99fffb9c10,3236bf606fe9fa5b,89a407032911e27e,2014-12-06,1,0,0,290,1,1,37,24,7,30,0,0,30,22,1,1,6,2,97.7,189.0
8063,9b1e3d99fffb9c10,89a407032911e27e,3236bf606fe9fa5b,2014-12-06,0,0,0,290,3,1,13,3,13,0,0,0,0,0,7,2,6,3,0.0,143.3
8064,93b7ae1e0f79d100,aa5b4eff51bdc7d1,cbb682f5fcc44bfc,2014-12-06,0,0,0,413,8,1,78,16,76,2,0,0,2,2,16,11,60,14,29.0,152.0
8065,93b7ae1e0f79d100,cbb682f5fcc44bfc,aa5b4eff51bdc7d1,2014-12-06,0,1,1,413,0,0,58,26,58,0,0,0,0,0,5,4,53,26,0.0,381.0
8066,802eba82d2b6113e,fc169c387b4b465d,fc6e681bf6658faf,2014-12-06,0,1,1,299,2,1,10,3,10,0,0,0,0,0,3,2,7,3,0.0,216.0
8067,802eba82d2b6113e,fc6e681bf6658faf,fc169c387b4b465d,2014-12-06,0,0,0,299,2,1,16,5,16,0,0,0,0,0,7,6,9,5,0.0,110.0
8068,7e8f4240725316a4,22a92d7f62195791,e14b5aa06eea9653,2014-12-06,0,1,1,559,1,1,55,12,54,1,1,1,0,0,11,7,43,12,40.7,383.6
8069,7e8f4240725316a4,e14b5aa06eea9653,22a92d7f62195791,2014-12-06,1,0,0,559,5,2,76,14,69,7,0,0,7,3,1,1,68,11,53.4,396.3
8070,60030b35e276d338,5e4eec08896c9423,9b75954db8db2a08,2014-12-06,0,0,0,900,13,7,89,31,86,3,1,1,2,2,16,13,70,29,44.0,372.0
8071,60030b35e276d338,9b75954db8db2a08,5e4eec08896c9423,2014-12-06,0,1,0,900,1,0,69,12,69,0,0,0,0,0,22,16,47,12,0.0,856.0
8072,58112f9fc0058e68,bda04c573563cc2e,c727c7d31c50c4cf,2014-12-06,1,0,0,33,0,0,16,8,14,2,0,0,2,2,0,0,14,6,2.0,31.0
8073,58112f9fc0058e68,c727c7d31c50c4cf,bda04c573563cc2e,2014-12-06,0,0,0,33,0,0,6,2,6,0,0,0,0,0,0,0,6,2,0.0,31.0
8074,44fc830a664ed611,0941df56f6ac954b,f2925e6db404bf1d,2014-12-06,0,1,0,1500,17,5,228,66,226,2,1,1,1,0,51,44,175,66,56.4,856.2
8075,44fc830a664ed611,f2925e6db404bf1d,0941df56f6ac954b,2014-12-06,0,0,0,1500,0,0,201,71,173,28,12,12,16,14,41,33,132,57,23.8,1381.6
8076,2417f4130d707978,b57edace7b647f07,de75d1c45a39e221,2014-12-06,1,0,0,900,9,2,124,22,108,16,3,3,13,3,22,11,86,19,208.0,589.7
8077,2417f4130d707978,de75d1c45a39e221,b57edace7b647f07,2014-12-06,0,2,0,900,1,0,200,69,182,18,1,1,17,12,13,8,169,57,50.3,597.0
8078,e947baa4cad609d0,2816ced060a21be3,6256b2b1562cb8e1,2014-11-22,2,0,0,900,1,0,85,11,83,2,0,0,2,2,28,14,55,9,20.0,832.5
8079,e947baa4cad609d0,6256b2b1562cb8e1,2816ced060a21be3,2014-11-22,0,0,0,900,0,0,140,32,139,1,0,0,1,0,24,8,115,32,7.5,865.0
8080,e7859b4e70d4a9c1,05b43e0ead3df345,4d5197f331c47290,2014-11-22,0,0,0,774,5,5,49,14,40,9,2,2,7,6,12,12,28,8,55.5,340.6
8081,e7859b4e70d4a9c1,4d5197f331c47290,05b43e0ead3df345,2014-11-22,1,3,0,774,6,3,108,55,66,42,0,0,42,27,12,6,54,28,211.4,260.5
8082,a2bd4c46f89f19ae,c295de4e10acd4c9,eb29176b03dfa888,2014-11-22,0,0,0,900,5,0,121,51,120,1,1,1,0,0,33,28,87,51,4.4,553.3
8083,a2bd4c46f89f19ae,eb29176b03dfa888,c295de4e10acd4c9,2014-11-22,0,0,0,900,3,0,101,49,99,2,0,0,2,2,24,19,75,47,10.7,590.6
8084,8f9cfe0e283a6ccb,d247691a6c0e9034,f2688492b9a525a3,2014-11-22,0,0,0,1496,0,0,86,25,82,4,0,0,4,3,7,6,75,22,0.0,557.3
8085,8f9cfe0e283a6ccb,f2688492b9a525a3,d247691a6c0e9034,2014-11-22,0,2,1,1496,13,7,202,77,106,96,8,8,88,61,14,8,92,16,938.7,528.0
8086,56a0f335ef05c825,5f04e3d58d9ce982,c136b2a8852da5bd,2014-11-22,0,0,0,112,0,0,14,1,14,0,0,0,0,0,7,4,7,1,0.0,86.3
8087,56a0f335ef05c825,c136b2a8852da5bd,5f04e3d58d9ce982,2014-11-22,1,1,1,112,1,1,26,8,22,4,0,0,4,3,6,4,16,5,25.7,67.0
8088,55e9ea18b8a72b2e,172c2135e70f87b7,3a12a2f096a6d975,2014-11-22,0,0,0,900,1,0,130,15,129,1,0,0,1,1,35,19,94,14,2.2,704.9
8089,55e9ea18b8a72b2e,3a12a2f096a6d975,172c2135e70f87b7,2014-11-22,1,2,0,900,2,0,110,32,94,16,2,1,14,8,20,15,74,24,186.1,676.8
8090,2ff14dfede1d02dd,91ea901c458e95dd,98c23cb6da5b3352,2014-11-22,0,0,0,201,0,0,32,14,32,0,0,0,0,0,5,5,27,14,0.0,127.3
8091,2ff14dfede1d02dd,98c23cb6da5b3352,91ea901c458e95dd,2014-11-22,1,0,0,201,0,0,21,11,19,2,0,0,2,2,2,2,17,9,0.7,197.0
8092,2f93de8b39ec4625,64a50dad704d1d49,887961364be5ceb3,2014-11-22,0,0,0,900,0,0,133,25,131,2,0,0,2,2,46,29,85,23,0.0,900.0
8093,2f93de8b39ec4625,887961364be5ceb3,64a50dad704d1d49,2014-11-22,0,0,0,900,2,0,123,27,123,0,0,0,0,0,37,23,86,27,0.0,898.0
8094,1a637fbda4bdf575,85d0fafb8b75d634,e93b04e308913c2e,2014-11-22,0,0,0,18,0,0,4,0,4,0,0,0,0,0,1,0,3,0,0.0,12.0
8095,1a637fbda4bdf575,e93b04e308913c2e,85d0fafb8b75d634,2014-11-22,1,0,0,18,0,0,15,10,6,9,0,0,9,7,0,0,6,3,6.0,12.0
8096,171af1114dbfc29d,369e1ce458ef50a6,3aa794cbe1e3484b,2014-11-22,1,0,0,900,1,1,145,30,145,0,0,0,0,0,40,33,105,30,0.0,813.0
8097,171af1114dbfc29d,3aa794cbe1e3484b,369e1ce458ef50a6,2014-11-22,0,0,0,900,0,0,56,13,56,0,0,0,0,0,11,7,45,13,0.0,890.0
8098,079308cc2efa2e5d,80eacd4da0617c57,f53c1f4ceeed8c08,2014-11-22,0,0,0,900,3,2,199,60,195,4,0,0,4,2,46,34,149,58,22.6,750.8
8099,079308cc2efa2e5d,f53c1f4ceeed8c08,80eacd4da0617c57,2014-11-22,0,0,0,900,9,2,149,30,148,1,0,0,1,0,17,7,131,30,2.2,833.4
8100,033d968f325842e7,32be4b7f7de1c905,c945adc22c2bfe8f,2014-11-22,0,0,0,900,2,1,149,65,145,4,0,0,4,4,10,6,135,61,1.6,796.0
8101,033d968f325842e7,c945adc22c2bfe8f,32be4b7f7de1c905,2014-11-22,0,0,0,900,9,2,158,32,146,12,0,0,12,7,29,21,117,25,100.0,723.4
8102,a788042d4d0c50d4,01fcef7e3d051722,d05412b513b19621,2014-11-15,1,1,1,404,0,0,63,19,51,12,0,0,12,8,18,13,33,11,15.8,356.9
8103,a788042d4d0c50d4,d05412b513b19621,01fcef7e3d051722,2014-11-15,0,0,0,404,2,1,73,15,69,4,0,0,4,2,26,20,43,13,14.1,307.2
8104,9e47b2a66d0e9315,45230be0641f3f53,cbf5e6f231b55443,2014-11-15,0,0,0,900,1,0,72,13,66,6,1,1,5,3,28,19,38,10,74.7,736.8
8105,9e47b2a66d0e9315,cbf5e6f231b55443,45230be0641f3f53,2014-11-15,0,5,0,900,6,2,83,20,82,1,0,0,1,0,25,14,57,20,26.2,589.3
8106,925f745c03ebd638,94508d80e1f885fc,bad8be5827ea1bf1,2014-11-15,1,0,0,290,0,0,52,20,45,7,0,0,7,4,13,10,32,16,17.4,203.0
8107,925f745c03ebd638,bad8be5827ea1bf1,94508d80e1f885fc,2014-11-15,0,0,0,290,3,1,20,7,20,0,0,0,0,0,2,1,18,7,0.0,224.6
8108,7a440fcd8048b091,36549928f90f1d36,80daefbed11ce998,2014-11-15,0,2,0,900,4,3,111,28,99,12,1,1,11,8,13,9,86,20,192.0,692.0
8109,7a440fcd8048b091,80daefbed11ce998,36549928f90f1d36,2014-11-15,0,1,0,900,2,1,130,19,130,0,0,0,0,0,38,19,92,19,0.0,682.0
8110,7228398a1ab12183,3974fa35c917af1d,6f242453c91a5af0,2014-11-15,1,1,1,198,0,0,25,2,22,3,3,3,0,0,9,9,13,2,18.8,148.0
8111,7228398a1ab12183,6f242453c91a5af0,3974fa35c917af1d,2014-11-15,0,0,0,198,1,0,30,2,30,0,0,0,0,0,9,6,21,2,0.0,119.2
8112,4087bb7b3b1b9e24,436f970c9ea9169c,e9e7e1c8ff289e1b,2014-11-15,0,5,1,630,0,0,61,15,61,0,0,0,0,0,13,8,48,15,0.0,352.7
8113,4087bb7b3b1b9e24,e9e7e1c8ff289e1b,436f970c9ea9169c,2014-11-15,0,0,0,630,4,1,36,13,25,11,0,0,11,7,8,5,17,6,252.3,263.0
8114,22f52e3b614e0d8a,7c7332319c14094c,ec71a892fada28c7,2014-11-15,0,2,0,900,1,1,56,20,28,28,1,1,27,15,9,4,19,5,336.0,276.4
8115,22f52e3b614e0d8a,ec71a892fada28c7,7c7332319c14094c,2014-11-15,0,0,0,900,4,1,62,22,37,25,2,1,23,14,10,8,27,8,263.6,216.0
8116,1e1a09bbedf7781d,4b8fb0453a596b8e,8d49545dadf9b919,2014-11-15,0,2,1,218,0,0,7,1,6,1,0,0,1,1,5,3,1,0,71.0,57.0
8117,1e1a09bbedf7781d,8d49545dadf9b919,4b8fb0453a596b8e,2014-11-15,0,0,0,218,2,2,18,10,8,10,0,0,10,9,2,2,6,1,90.0,48.0
8118,12eec1df1fd078a2,8c0580d4fff106c1,d81ac739417d7f53,2014-11-15,0,1,1,286,2,1,36,13,28,8,0,0,8,5,4,3,24,8,92.8,170.0
8119,12eec1df1fd078a2,d81ac739417d7f53,8c0580d4fff106c1,2014-11-15,0,0,0,286,1,1,24,7,24,0,0,0,0,0,4,3,20,7,0.0,190.2
8120,07f9fc40f1e6aa87,76984112f697631f,f72465a784c1b084,2014-11-15,0,0,0,390,0,0,98,21,98,0,0,0,0,0,10,7,88,21,0.0,390.0
8121,07f9fc40f1e6aa87,f72465a784c1b084,76984112f697631f,2014-11-15,1,0,0,390,0,0,185,55,185,0,0,0,0,0,29,25,156,55,0.0,390.0
8122,03a200326e56d597,492b202d2064e7a9,eef9b891edbd4604,2014-11-15,1,0,0,447,3,0,37,11,25,12,2,1,10,6,11,9,14,5,7.0,394.8
8123,03a200326e56d597,eef9b891edbd4604,492b202d2064e7a9,2014-11-15,1,0,0,447,1,1,36,9,34,2,0,0,2,2,1,1,33,7,45.2,327.0
8124,fadb129e71d8fc22,ddf3e0ea10ea6d8c,e9213f53ddeca978,2014-11-08,0,0,0,900,0,0,68,10,68,0,0,0,0,0,20,13,48,10,0.0,325.4
8125,fadb129e71d8fc22,e9213f53ddeca978,ddf3e0ea10ea6d8c,2014-11-08,0,4,0,900,8,6,137,64,47,90,0,0,90,50,8,6,39,14,574.6,319.0
8126,e8907b881151b79d,140745cbbcb023ac,50db8711c70196cd,2014-11-08,0,0,0,34,0,0,3,0,3,0,0,0,0,0,2,2,1,0,0.0,28.0
8127,e8907b881151b79d,50db8711c70196cd,140745cbbcb023ac,2014-11-08,1,0,0,34,0,0,15,8,3,12,0,0,12,7,1,1,2,1,6.0,28.0
8128,db9f8144b50227f2,75a6a390fd5dca46,d343df8ba11f4c4e,2014-11-08,0,0,0,900,4,1,38,6,31,7,1,0,6,3,20,15,11,3,148.1,488.9
8129,db9f8144b50227f2,d343df8ba11f4c4e,75a6a390fd5dca46,2014-11-08,0,2,0,900,1,0,43,6,42,1,0,0,1,1,24,17,18,5,9.1,587.9
8130,cccb99dd4ec5c2d6,dc9572dd6ec74859,fb79582c410d049e,2014-11-08,0,1,1,806,12,5,62,13,55,7,0,0,7,5,18,10,37,8,234.7,302.3
8131,cccb99dd4ec5c2d6,fb79582c410d049e,dc9572dd6ec74859,2014-11-08,0,0,0,806,0,0,59,8,58,1,0,0,1,1,13,8,45,7,0.7,569.3
8132,cbe954d004415b51,cf65d56b0755ed3b,d317a5e2b3f88c5f,2014-11-08,0,0,0,900,0,0,156,54,156,0,0,0,0,0,36,25,120,54,0.0,711.4
8133,cbe954d004415b51,d317a5e2b3f88c5f,cf65d56b0755ed3b,2014-11-08,0,1,0,900,1,1,106,40,90,16,0,0,16,12,10,7,80,28,153.6,660.0
8134,a3480aa7bdc63c11,6f7c616b98e18c29,f1fac969a1d70b08,2014-11-08,0,1,0,900,9,3,81,18,51,30,5,5,25,10,17,11,34,8,366.9,431.6
8135,a3480aa7bdc63c11,f1fac969a1d70b08,6f7c616b98e18c29,2014-11-08,0,0,0,900,0,0,61,25,56,5,0,0,5,5,9,8,47,20,40.4,436.1
8136,7826c23386a1e09a,09f579be4520394a,c4731f43693b96b8,2014-11-08,0,0,0,900,3,2,40,10,30,10,1,1,9,4,6,4,24,6,313.1,372.4
8137,7826c23386a1e09a,c4731f43693b96b8,09f579be4520394a,2014-11-08,0,0,0,900,6,2,47,7,42,5,1,1,4,4,11,9,31,3,120.6,393.9
8138,49b05e23e3a2af13,2b074403b7c6cdb4,c10eb2f12c489f6d,2014-11-08,0,0,0,900,0,0,217,79,217,0,0,0,0,0,47,41,170,79,0.0,897.0
8139,49b05e23e3a2af13,c10eb2f12c489f6d,2b074403b7c6cdb4,2014-11-08,0,0,0,900,11,2,189,63,189,0,0,0,0,0,9,4,180,63,0.0,767.0
8140,208674403b0936d4,0c5c66ddd1886b83,f797f0c57a83353e,2014-11-08,1,0,0,31,0,0,14,9,11,3,0,0,3,3,0,0,11,6,1.3,28.0
8141,208674403b0936d4,f797f0c57a83353e,0c5c66ddd1886b83,2014-11-08,0,0,0,31,0,0,5,2,5,0,0,0,0,0,0,0,5,2,0.0,29.7
8142,207f105716df54f9,159da492e000afbf,98f6da59d765ec94,2014-11-08,0,1,1,255,1,1,8,2,8,0,0,0,0,0,3,2,5,2,0.0,50.0
8143,207f105716df54f9,98f6da59d765ec94,159da492e000afbf,2014-11-08,0,0,0,255,8,3,9,1,8,1,0,0,1,1,5,3,3,0,141.0,114.0
8144,c3d336f9aabc9fb6,1ed32eaaba9ffe10,81801f57bd0a7c41,2014-11-07,0,0,0,178,0,0,15,1,15,0,0,0,0,0,8,5,7,1,0.0,176.0
8145,c3d336f9aabc9fb6,81801f57bd0a7c41,1ed32eaaba9ffe10,2014-11-07,1,0,0,178,0,0,16,3,14,2,0,0,2,1,6,2,8,2,2.0,176.0
8146,b1e7100c2ab1ab79,4b4753d19489297f,e7fe5315b1efeb92,2014-11-07,0,1,1,226,2,1,17,11,4,13,0,0,13,10,0,0,4,1,163.0,63.0
8147,b1e7100c2ab1ab79,e7fe5315b1efeb92,4b4753d19489297f,2014-11-07,0,0,0,226,0,0,3,1,3,0,0,0,0,0,0,0,3,1,0.0,63.0
8148,920b8aae22c04f13,00debc804e2b1cd4,d156513a19acf856,2014-11-07,0,0,0,136,3,2,7,0,7,0,0,0,0,0,7,4,0,0,0.0,53.0
8149,920b8aae22c04f13,d156513a19acf856,00debc804e2b1cd4,2014-11-07,1,0,0,136,0,0,7,6,2,5,0,0,5,5,0,0,2,1,2.0,134.0
8150,73954f3895cac499,4f732e58ed907eff,59279a7c978f7da0,2014-11-07,0,0,0,399,1,0,60,13,60,0,0,0,0,0,11,7,49,13,0.0,398.0
8151,73954f3895cac499,59279a7c978f7da0,4f732e58ed907eff,2014-11-07,2,0,0,399,1,0,93,25,90,3,0,0,3,2,12,6,78,23,1.0,396.0
8152,681d77e5d5c0f0ee,1e7483dbff40b84b,e5ecaf884b6da2bc,2014-11-07,0,0,0,186,2,1,8,7,8,0,0,0,0,0,0,0,8,7,0.0,71.0
8153,681d77e5d5c0f0ee,e5ecaf884b6da2bc,1e7483dbff40b84b,2014-11-07,1,0,0,186,0,0,27,14,27,0,0,0,0,0,11,11,16,14,0.0,153.0
8154,3e9f3ce3a01bb97f,03f982ca3735070c,60029bcf496bd707,2014-11-07,0,0,0,589,0,0,72,9,72,0,0,0,0,0,24,13,48,9,0.0,495.0
8155,3e9f3ce3a01bb97f,60029bcf496bd707,03f982ca3735070c,2014-11-07,1,0,0,589,5,1,51,21,43,8,0,0,8,5,6,3,37,16,94.0,495.0
8156,3d741cee0dffe165,00e11b5c8b7bfeeb,2b93ebd9f5417ad2,2014-11-07,1,1,1,357,0,0,41,10,35,6,2,2,4,2,12,8,23,8,12.8,340.0
8157,3d741cee0dffe165,2b93ebd9f5417ad2,00e11b5c8b7bfeeb,2014-11-07,0,0,0,357,2,0,65,10,65,0,0,0,0,0,12,6,53,10,0.0,333.2
8158,3a7d76e3c0b503c3,2284092f8b63273b,bdcbb976816fd256,2014-11-07,0,0,0,267,2,0,46,20,46,0,0,0,0,0,5,3,41,20,0.0,260.6
8159,3a7d76e3c0b503c3,bdcbb976816fd256,2284092f8b63273b,2014-11-07,0,1,1,267,2,1,48,19,47,1,1,1,0,0,5,5,42,19,6.4,216.0
8160,2faa7b48b4d51cab,a845f0735bc67405,d403b1a6f278c95e,2014-11-07,0,1,1,412,2,1,63,17,60,3,0,0,3,3,11,9,49,14,42.0,356.0
8161,2faa7b48b4d51cab,d403b1a6f278c95e,a845f0735bc67405,2014-11-07,0,0,0,412,0,0,30,7,30,0,0,0,0,0,12,7,18,7,0.0,342.0
8162,13c4251fb451f440,92b62174c175ce19,e1147d3d2dabe1ce,2014-11-07,0,0,0,463,3,0,61,21,56,5,0,0,5,3,9,7,47,18,23.0,309.7
8163,13c4251fb451f440,e1147d3d2dabe1ce,92b62174c175ce19,2014-11-07,2,0,0,463,2,1,104,35,83,21,3,3,18,9,15,11,68,26,107.3,302.0
8164,0f0473dde4b873ca,54578e5927adea53,d2bc285ead803db0,2014-11-07,0,1,0,618,2,2,142,52,137,5,0,0,5,4,29,22,108,48,17.1,530.7
8165,0f0473dde4b873ca,d2bc285ead803db0,54578e5927adea53,2014-11-07,1,0,0,618,2,1,143,43,142,1,0,0,1,1,26,24,116,42,22.3,533.9
8166,ffd3e3d37cba32da,7413b80dbb0f8f9f,92a9aa9c93192871,2014-10-25,0,1,0,900,0,0,82,16,82,0,0,0,0,0,12,10,70,16,0.0,856.1
8167,ffd3e3d37cba32da,92a9aa9c93192871,7413b80dbb0f8f9f,2014-10-25,0,0,0,900,14,1,154,25,152,2,0,0,2,1,41,22,111,24,17.9,417.0
8168,d1b2ce8ee57307c0,84b3e7d38f2d2ec5,ed74afc8b5b47a61,2014-10-25,1,0,0,760,4,2,146,58,95,51,1,1,50,32,10,6,85,26,154.8,558.0
8169,d1b2ce8ee57307c0,ed74afc8b5b47a61,84b3e7d38f2d2ec5,2014-10-25,0,0,0,760,1,0,77,13,69,8,1,0,7,2,21,11,48,11,32.0,569.2
8170,a90fde18a088f99b,0b64d0fed453ef7f,5aedf14771ca82d2,2014-10-25,1,0,0,208,0,0,19,2,15,4,1,1,3,1,5,3,10,1,14.4,156.0
8171,a90fde18a088f99b,5aedf14771ca82d2,0b64d0fed453ef7f,2014-10-25,0,1,1,208,2,1,35,11,22,13,0,0,13,8,3,2,19,3,34.0,159.6
8172,852223ee1a2d0a74,08af939f41b5a57b,f53d4f21d1b5f2dc,2014-10-25,0,0,0,900,6,3,68,19,49,19,2,2,17,8,18,11,31,11,249.6,427.0
8173,852223ee1a2d0a74,f53d4f21d1b5f2dc,08af939f41b5a57b,2014-10-25,0,0,0,900,1,0,85,11,85,0,0,0,0,0,14,10,71,11,0.0,614.4
8174,7099374e91f9283b,b5b684eac99ae0a3,d0f3959b4a9747e6,2014-10-25,0,0,0,1500,8,1,194,50,193,1,1,0,0,0,44,27,149,50,21.5,1314.3
8175,7099374e91f9283b,d0f3959b4a9747e6,b5b684eac99ae0a3,2014-10-25,1,0,0,1500,0,0,269,80,258,11,0,0,11,10,32,22,226,70,56.7,1411.5
8176,502d7cb01921170f,7cdd3e5d3aa9cb39,bc8f6b42767e28df,2014-10-25,0,1,1,486,5,2,24,10,12,12,0,0,12,7,2,1,10,3,240.0,156.0
8177,502d7cb01921170f,bc8f6b42767e28df,7cdd3e5d3aa9cb39,2014-10-25,0,0,0,486,1,1,26,3,23,3,0,0,3,2,8,2,15,1,70.0,176.0
8178,4cc9ef5e68009fd4,5331b25a60417ffb,7abe471b61725980,2014-10-25,0,3,1,256,1,1,11,1,11,0,0,0,0,0,0,0,11,1,0.0,79.0
8179,4cc9ef5e68009fd4,7abe471b61725980,5331b25a60417ffb,2014-10-25,0,0,0,256,0,0,8,0,8,0,0,0,0,0,3,1,5,0,0.0,253.0
8180,432e57033ceecee0,71002dbc1743b9a7,8fd808923cffff82,2014-10-25,0,1,0,900,5,3,63,25,37,26,0,0,26,16,10,4,27,9,281.5,316.5
8181,432e57033ceecee0,8fd808923cffff82,71002dbc1743b9a7,2014-10-25,0,1,0,900,8,5,102,21,69,33,5,4,28,9,28,17,41,12,269.5,226.5
8182,2bfb60face19904d,1fb80f46d3c105d9,523f6ad11dbe9b53,2014-10-25,1,0,0,546,0,0,46,20,18,28,5,4,23,18,4,4,14,2,99.4,121.69999999999999
8183,2bfb60face19904d,523f6ad11dbe9b53,1fb80f46d3c105d9,2014-10-25,0,0,0,546,3,3,46,18,19,27,5,5,22,13,10,10,9,5,321.3,89.6
8184,2a44035824303dee,23024fdfc966410a,de45aaae23dfa392,2014-10-25,0,2,1,297,1,1,13,4,10,3,0,0,3,3,4,3,6,1,129.6,81.0
8185,2a44035824303dee,de45aaae23dfa392,23024fdfc966410a,2014-10-25,0,0,0,297,0,0,13,4,13,0,0,0,0,0,1,0,12,4,0.0,167.4
8186,06854105c3503075,7ff97850e8c32bda,902ab9197b83d0db,2014-10-25,0,0,0,900,0,0,46,5,46,0,0,0,0,0,5,4,41,5,0.0,437.2
8187,06854105c3503075,902ab9197b83d0db,7ff97850e8c32bda,2014-10-25,0,0,0,900,18,9,145,38,109,36,7,6,29,25,8,5,101,13,446.8,416.0
8188,da26301ae3e7a9b1,5b5307450405abf0,fd55393021a8c255,2014-10-04,1,0,0,1500,1,1,315,81,303,12,0,0,12,7,104,87,199,74,9.6,1464.0
8189,da26301ae3e7a9b1,fd55393021a8c255,5b5307450405abf0,2014-10-04,0,0,0,1500,4,1,107,39,107,0,0,0,0,0,20,14,87,39,0.0,1469.4
8190,ca16e203eb2bde60,150ff4cc642270b9,3f52ce18fb98008f,2014-10-04,1,0,0,191,0,0,51,25,42,9,0,0,9,7,9,6,33,18,6.6,180.0
8191,ca16e203eb2bde60,3f52ce18fb98008f,150ff4cc642270b9,2014-10-04,0,0,0,191,0,0,29,8,29,0,0,0,0,0,6,3,23,8,0.0,174.4
8192,88933cf1edd83034,5f99b2bafb10305f,6bf5a7d3e081ade2,2014-10-04,0,0,0,900,12,6,103,28,90,13,2,2,11,9,22,12,68,19,134.6,724.0
8193,88933cf1edd83034,6bf5a7d3e081ade2,5f99b2bafb10305f,2014-10-04,0,0,0,900,1,0,91,10,91,0,0,0,0,0,42,30,49,10,0.0,765.4
8194,7e25199be406dd7b,34f88592c0ab7a54,da1d8d76404bb6b5,2014-10-04,0,0,0,900,7,3,106,18,100,6,1,1,5,5,30,24,70,13,78.6,507.0
8195,7e25199be406dd7b,da1d8d76404bb6b5,34f88592c0ab7a54,2014-10-04,0,0,0,900,6,4,40,10,40,0,0,0,0,0,6,6,34,10,0.0,671.4
8196,75a88258eb967e0c,aceffa19749c4dc0,b406da701c479076,2014-10-04,1,0,0,261,0,0,67,34,61,6,0,0,6,5,7,6,54,29,2.8,254.0
8197,75a88258eb967e0c,b406da701c479076,aceffa19749c4dc0,2014-10-04,0,0,0,261,0,0,30,9,30,0,0,0,0,0,6,3,24,9,0.0,258.2
8198,6c62796d9b7e94a0,4e06913c91da5200,8abf70f79e9e27c2,2014-10-04,0,0,0,900,2,1,98,30,93,5,1,1,4,3,44,43,49,27,16.0,702.0
8199,6c62796d9b7e94a0,8abf70f79e9e27c2,4e06913c91da5200,2014-10-04,0,0,0,900,19,0,47,6,47,0,0,0,0,0,10,9,37,6,0.0,633.0
8200,699a70c8fb3c0273,99df7d0a2a08a8a8,e9a3aeb207578eea,2014-10-04,1,0,0,118,0,0,20,9,12,8,0,0,8,7,5,4,7,2,6.0,112.0
8201,699a70c8fb3c0273,e9a3aeb207578eea,99df7d0a2a08a8a8,2014-10-04,0,0,0,118,0,0,6,2,6,0,0,0,0,0,0,0,6,2,0.0,112.0
8202,64542fe846b9aea9,0749d968e932df53,cbd5d3cdd862e90e,2014-10-04,0,0,0,688,0,0,136,18,136,0,0,0,0,0,32,24,104,18,0.0,672.0
8203,64542fe846b9aea9,cbd5d3cdd862e90e,0749d968e932df53,2014-10-04,1,0,0,688,3,1,111,35,103,8,0,0,8,7,17,12,86,28,16.0,668.0
8204,63e21ff20866b8fb,7a39bbac8cc0fa70,99c7610aa74995d3,2014-10-04,0,0,0,900,1,0,97,28,95,2,0,0,2,0,16,10,79,28,2.7,892.0
8205,63e21ff20866b8fb,99c7610aa74995d3,7a39bbac8cc0fa70,2014-10-04,0,0,0,900,14,1,103,14,103,0,0,0,0,0,45,41,58,14,0.0,747.3
8206,5ed0027812582ad9,39cc64bf0a269db9,cfaf010d5b389c09,2014-10-04,0,0,0,79,0,0,12,4,12,0,0,0,0,0,3,3,9,4,0.0,77.0
8207,5ed0027812582ad9,cfaf010d5b389c09,39cc64bf0a269db9,2014-10-04,1,0,0,79,1,0,15,4,10,5,0,0,5,3,3,2,7,1,2.0,77.0
8208,5e07077e84fc45cd,49858bf46dabf6fb,e64b96c07d7ce999,2014-10-04,0,0,0,900,4,2,115,49,113,2,0,0,2,0,19,17,94,49,37.0,752.0
8209,5e07077e84fc45cd,e64b96c07d7ce999,49858bf46dabf6fb,2014-10-04,0,0,0,900,8,2,147,22,147,0,0,0,0,0,29,21,118,22,0.0,821.0
8210,562d3261ca7bdf01,8b5f9ea38184ded3,d06f8869449ba7bd,2014-10-04,0,0,0,900,4,0,156,41,156,0,0,0,0,0,30,29,126,41,0.0,493.0
8211,562d3261ca7bdf01,d06f8869449ba7bd,8b5f9ea38184ded3,2014-10-04,0,0,0,900,9,0,107,24,107,0,0,0,0,0,24,20,83,24,0.0,894.0
8212,5563d6de0b4c4d65,06827d70c53ff0d9,0e21976afc92e4d1,2014-10-04,1,0,0,900,1,0,51,16,49,2,0,0,2,2,29,26,20,14,10.8,638.8
8213,5563d6de0b4c4d65,0e21976afc92e4d1,06827d70c53ff0d9,2014-10-04,0,0,0,900,6,3,34,10,31,3,0,0,3,2,15,13,16,8,110.2,301.2
8214,4e981b587c1012dd,4ac1ecf8ce59ef23,e5010b1b94ca5755,2014-10-04,1,0,0,900,16,6,50,21,34,16,1,1,15,10,11,7,23,11,334.5,320.0
8215,4e981b587c1012dd,e5010b1b94ca5755,4ac1ecf8ce59ef23,2014-10-04,0,0,0,900,1,1,84,44,47,37,0,0,37,24,7,7,40,20,141.0,344.5
8216,4664432c0d592411,8f0d576beba1cfcd,ff6a1f63c254127e,2014-10-04,0,0,0,63,0,0,6,0,6,0,0,0,0,0,1,0,5,0,0.0,56.0
8217,4664432c0d592411,ff6a1f63c254127e,8f0d576beba1cfcd,2014-10-04,2,0,0,63,0,0,12,4,7,5,0,0,5,2,0,0,7,2,2.0,61.0
8218,2d1f8ee74824f983,33e00249ef08d3a4,55ee431411ccf07a,2014-10-04,0,0,0,502,1,1,52,3,50,2,0,0,2,1,30,21,20,2,10.0,346.4
8219,2d1f8ee74824f983,55ee431411ccf07a,33e00249ef08d3a4,2014-10-04,0,1,1,502,5,2,48,22,43,5,0,0,5,3,10,9,33,19,115.6,307.0
8220,2d13778322a8af82,72c4b253d2f5ebf2,b8592b4a383696cd,2014-10-04,0,0,0,126,2,0,6,1,6,0,0,0,0,0,2,2,4,1,0.0,97.5
8221,2d13778322a8af82,b8592b4a383696cd,72c4b253d2f5ebf2,2014-10-04,0,1,1,126,2,1,17,5,15,2,0,0,2,1,1,0,14,4,28.5,69.0
8222,24ac3d1bee1610ef,40093d1d2d78394e,5f87a5c00b3d17ed,2014-10-04,0,1,0,900,4,2,91,15,89,2,0,0,2,0,18,7,71,15,55.0,314.0
8223,24ac3d1bee1610ef,5f87a5c00b3d17ed,40093d1d2d78394e,2014-10-04,0,1,0,900,3,3,86,22,84,2,0,0,2,2,15,11,69,20,531.0,314.0
8224,23692b9936363da3,5c2ce761399dc9c5,8f5c8850b2484173,2014-10-04,0,0,0,61,0,0,7,3,7,0,0,0,0,0,0,0,7,3,0.0,56.0
8225,23692b9936363da3,8f5c8850b2484173,5c2ce761399dc9c5,2014-10-04,1,0,0,61,0,0,10,8,7,3,0,0,3,3,1,1,6,5,5.0,56.0
8226,20af0f55d226f320,3e61082025db8137,c03a5022f8439f2a,2014-10-04,0,0,0,900,1,0,94,6,93,1,0,0,1,0,18,11,75,6,7.0,851.0
8227,20af0f55d226f320,c03a5022f8439f2a,3e61082025db8137,2014-10-04,0,0,0,900,7,4,83,18,83,0,0,0,0,0,19,17,64,18,0.0,434.0
8228,1cad3dc6d7eccdfb,12f1b140e248bdb9,6bd02119599741a4,2014-10-04,0,0,0,39,1,0,2,0,2,0,0,0,0,0,1,1,1,0,0.0,29.0
8229,1cad3dc6d7eccdfb,6bd02119599741a4,12f1b140e248bdb9,2014-10-04,0,1,0,39,0,0,2,0,2,0,0,0,0,0,2,2,0,0,0.0,39.0
8230,17bb1e62772ac5af,56c9acc4e86046a2,6e7c758f5cdec01a,2014-10-04,0,1,0,900,5,2,85,30,44,41,9,6,32,20,14,14,30,10,269.0,208.5
8231,17bb1e62772ac5af,6e7c758f5cdec01a,56c9acc4e86046a2,2014-10-04,0,0,0,900,6,3,45,13,36,9,2,2,7,6,13,11,23,7,317.5,243.0
8232,06fab49a307ff3d2,2f13e4020cea5b38,5ef0088c1b19beeb,2014-10-04,0,0,0,900,6,2,133,39,131,2,0,0,2,1,39,36,92,38,2.7,859.0
8233,06fab49a307ff3d2,5ef0088c1b19beeb,2f13e4020cea5b38,2014-10-04,0,0,0,900,8,2,128,26,128,0,0,0,0,0,23,13,105,26,0.0,838.3
8234,fceab09944a65840,4a28cb716c19157a,9fa3bd637edd9aa2,2014-09-27,1,0,0,900,0,0,134,46,125,9,1,1,8,3,24,17,101,43,19.5,861.0
8235,fceab09944a65840,9fa3bd637edd9aa2,4a28cb716c19157a,2014-09-27,0,0,0,900,8,0,123,9,123,0,0,0,0,0,71,44,52,9,0.0,773.5
8236,fc45644c62643c71,32ba186f4b0e3267,fc31f896cde2bc2e,2014-09-27,0,0,0,900,5,1,94,21,90,4,0,0,4,4,41,28,49,17,35.8,703.0
8237,fc45644c62643c71,fc31f896cde2bc2e,32ba186f4b0e3267,2014-09-27,0,0,0,900,4,2,66,19,66,0,0,0,0,0,26,23,40,19,0.0,618.2
8238,b1b82605646eb850,3ecd936bd8814108,80fa8218c99f9c58,2014-09-27,1,3,0,681,3,3,60,31,13,47,6,4,41,28,5,5,8,3,356.3,92.1
8239,b1b82605646eb850,80fa8218c99f9c58,3ecd936bd8814108,2014-09-27,0,0,0,681,2,1,37,19,5,32,1,1,31,19,2,2,3,0,171.9,136.7
8240,a49706a6edb0c5c3,700a674c042b7a96,cc6f9d1e89f3449a,2014-09-27,1,0,0,596,2,1,118,35,111,7,0,0,7,4,15,14,96,31,35.4,423.8
8241,a49706a6edb0c5c3,cc6f9d1e89f3449a,700a674c042b7a96,2014-09-27,0,1,1,596,6,2,52,5,51,1,1,0,0,0,8,6,43,5,10.2,468.6
8242,9c0721bd410e7a0e,53ec9cb470e1a4ea,ee9ebceabfd16fa7,2014-09-27,0,2,0,900,0,0,80,13,75,5,0,0,5,3,20,17,55,10,1.8,562.2
8243,9c0721bd410e7a0e,ee9ebceabfd16fa7,53ec9cb470e1a4ea,2014-09-27,0,0,0,900,9,4,157,53,111,46,7,5,39,26,19,16,92,27,330.8,373.2
8244,79c2461046e17eba,8a304bfd6bf04a57,b2e3aca4cd363477,2014-09-27,0,2,1,449,1,1,43,12,29,14,4,3,10,7,15,12,14,5,159.0,165.0
8245,79c2461046e17eba,b2e3aca4cd363477,8a304bfd6bf04a57,2014-09-27,0,0,0,449,1,0,27,1,27,0,0,0,0,0,8,5,19,1,0.0,287.0
8246,72656e864ca1c972,10f3ba6cd2f44a97,48e093ea1f43a053,2014-09-27,1,0,0,61,2,2,35,26,9,26,0,0,26,22,0,0,9,4,22.0,39.0
8247,72656e864ca1c972,48e093ea1f43a053,10f3ba6cd2f44a97,2014-09-27,0,0,0,61,0,0,10,2,10,0,0,0,0,0,1,0,9,2,0.0,39.0
8248,6bcea00473e43a59,029eaff01e6bb8f0,f4c49976c75c5ab2,2014-09-27,0,0,0,106,0,0,19,3,19,0,0,0,0,0,8,7,11,3,0.0,103.0
8249,6bcea00473e43a59,f4c49976c75c5ab2,029eaff01e6bb8f0,2014-09-27,1,0,0,106,0,0,29,8,25,4,0,0,4,4,4,1,21,4,3.0,103.0
8250,65f4d4f44e6e73f7,47b9e0e7703a4868,8f6a18831a120817,2014-09-27,1,0,0,900,4,2,157,42,155,2,2,2,0,0,36,25,119,42,20.0,720.0
8251,65f4d4f44e6e73f7,8f6a18831a120817,47b9e0e7703a4868,2014-09-27,0,0,0,900,5,0,145,44,145,0,0,0,0,0,28,14,117,44,0.0,778.0
8252,64eb4ae171613218,1d00756835ca67c9,33a331684283900f,2014-09-27,1,0,0,900,2,0,166,34,155,11,1,1,10,5,61,53,94,29,37.9,783.0
8253,64eb4ae171613218,33a331684283900f,1d00756835ca67c9,2014-09-27,0,0,0,900,5,0,138,36,138,0,0,0,0,0,27,12,111,36,0.0,825.1
8254,3e3db8c37096c260,3c660c90d48fc80d,f77c68bb4be8516d,2014-09-27,0,1,0,658,6,0,86,17,86,0,0,0,0,0,28,13,58,17,0.0,576.8
8255,3e3db8c37096c260,f77c68bb4be8516d,3c660c90d48fc80d,2014-09-27,2,0,0,658,4,3,80,28,66,14,1,1,13,8,17,10,49,20,80.2,532.0
8256,ef3c1a2ac6510d26,3f7c14c7eca7195d,eef9b891edbd4604,2014-09-20,0,0,0,480,6,1,60,16,60,0,0,0,0,0,6,4,54,16,0.0,461.0
8257,ef3c1a2ac6510d26,eef9b891edbd4604,3f7c14c7eca7195d,2014-09-20,1,0,0,480,0,0,91,28,91,0,0,0,0,0,6,4,85,28,0.0,478.0
8258,de2dad48d95305d7,203c957eac95dd87,276c60b14b571dd4,2014-09-20,1,0,0,78,0,0,13,10,6,7,0,0,7,7,0,0,6,3,8.4,66.0
8259,de2dad48d95305d7,276c60b14b571dd4,203c957eac95dd87,2014-09-20,0,0,0,78,2,0,3,0,3,0,0,0,0,0,3,1,0,0,0.0,67.6
8260,c2a36e996bba3a4a,0d0351c20169a499,98aa60cf58071fd6,2014-09-20,0,0,0,228,0,0,25,4,25,0,0,0,0,0,9,9,16,4,0.0,174.2
8261,c2a36e996bba3a4a,98aa60cf58071fd6,0d0351c20169a499,2014-09-20,1,0,0,228,0,0,43,22,32,11,1,1,10,8,8,8,24,14,53.8,91.0
8262,b516beb27416e492,7aa3d6964eff4877,f3a078277b3b8ff4,2014-09-20,0,0,0,900,0,0,78,14,78,0,0,0,0,0,18,10,60,14,0.0,833.9
8263,b516beb27416e492,f3a078277b3b8ff4,7aa3d6964eff4877,2014-09-20,0,2,0,900,4,2,69,29,68,1,0,0,1,1,7,3,61,28,30.1,448.0
8264,a4398b9257a93d78,64788ee44b062ded,a7897d200692ab64,2014-09-20,0,0,0,900,9,3,61,20,46,15,1,1,14,10,2,1,44,10,305.3,358.4
8265,a4398b9257a93d78,a7897d200692ab64,64788ee44b062ded,2014-09-20,0,2,0,900,0,0,66,15,63,3,0,0,3,3,10,6,53,12,195.6,268.7
8266,7690e946d9d81f51,44470bfd9483c7ad,b8aef0faf4ce9b31,2014-09-20,0,1,1,398,1,1,78,20,78,0,0,0,0,0,18,12,60,20,0.0,350.0
8267,7690e946d9d81f51,b8aef0faf4ce9b31,44470bfd9483c7ad,2014-09-20,0,0,0,398,0,0,91,18,91,0,0,0,0,0,27,18,64,18,0.0,398.0
8268,5ff0c4c6006f0873,08e908ed6d18d6a0,3be081c29bf734d9,2014-09-20,1,0,0,92,1,0,23,7,15,8,0,0,8,6,6,3,9,1,5.0,87.0
8269,5ff0c4c6006f0873,3be081c29bf734d9,08e908ed6d18d6a0,2014-09-20,0,0,0,92,0,0,4,0,4,0,0,0,0,0,1,1,3,0,0.0,87.0
8270,3dd55cca2358a511,1f4b04a926ef1287,c4af2feb4b58bc3b,2014-09-20,1,1,1,454,1,0,73,11,72,1,0,0,1,1,6,2,66,10,3.0,382.7
8271,3dd55cca2358a511,c4af2feb4b58bc3b,1f4b04a926ef1287,2014-09-20,0,0,0,454,4,1,29,10,28,1,0,0,1,1,2,2,26,9,59.3,273.0
8272,36d9d7e331e6b589,b96619b3acd7d9da,f9ae6914f604aa9f,2014-09-20,0,0,0,900,4,1,116,33,112,4,2,1,2,1,27,21,85,32,17.6,716.5
8273,36d9d7e331e6b589,f9ae6914f604aa9f,b96619b3acd7d9da,2014-09-20,0,0,0,900,19,3,47,7,45,2,0,0,2,0,19,9,26,7,20.5,646.4
8274,284e05afc9479620,193b9d1858bc4df3,4a1329cc8eb0928a,2014-09-20,0,0,0,900,0,0,236,75,236,0,0,0,0,0,35,24,201,75,0.0,791.3
8275,284e05afc9479620,4a1329cc8eb0928a,193b9d1858bc4df3,2014-09-20,0,0,0,900,13,3,240,128,239,1,0,0,1,1,8,4,231,127,3.7,745.0
8276,26cd506de4221057,303a05a7aa3ff761,71df36d6d8cf0d74,2014-09-20,2,0,0,900,0,0,105,31,101,4,0,0,4,4,35,28,66,27,31.7,665.5
8277,26cd506de4221057,71df36d6d8cf0d74,303a05a7aa3ff761,2014-09-20,0,0,0,900,10,1,92,16,90,2,0,0,2,2,22,20,68,14,36.5,503.3
8278,1e797ccd275a98d0,2650e2f846a30f64,b0550072e5f0afa7,2014-09-20,0,0,0,900,0,0,101,24,92,9,0,0,9,5,24,18,68,19,6.4,421.1
8279,1e797ccd275a98d0,b0550072e5f0afa7,2650e2f846a30f64,2014-09-20,0,0,0,900,5,2,119,51,61,58,2,2,56,29,4,4,57,22,466.9,418.6
8280,ebb9eeac1faf73ed,6c7e25571490aa3b,dbea8c1cb327ab3d,2014-09-13,1,0,0,451,2,1,63,32,26,37,7,7,30,29,4,4,22,3,307.4,127.0
8281,ebb9eeac1faf73ed,dbea8c1cb327ab3d,6c7e25571490aa3b,2014-09-13,0,0,0,451,7,2,20,2,20,0,0,0,0,0,10,6,10,2,0.0,143.60000000000002
8282,e79e3ee088b76d46,159da492e000afbf,a8283a4f415e1eb9,2014-09-13,0,1,0,900,8,4,40,15,40,0,0,0,0,0,15,11,25,15,0.0,411.7
8283,e79e3ee088b76d46,a8283a4f415e1eb9,159da492e000afbf,2014-09-13,0,0,0,900,2,0,54,16,48,6,2,2,4,2,20,18,28,14,79.3,662.0
8284,972b0643185b2570,30a09e43f15f1d75,ab850a77a0fa487d,2014-09-13,0,0,0,900,7,0,111,25,111,0,0,0,0,0,16,11,95,25,0.0,527.2
8285,972b0643185b2570,ab850a77a0fa487d,30a09e43f15f1d75,2014-09-13,1,0,0,900,2,1,159,46,146,13,2,2,11,10,22,15,124,36,213.8,604.0
8286,7580c93fec606442,36207c58e854cae5,fa37628269132d1a,2014-09-13,0,0,0,269,2,1,11,4,8,3,1,1,2,2,2,2,6,2,43.5,208.0
8287,7580c93fec606442,fa37628269132d1a,36207c58e854cae5,2014-09-13,0,2,1,269,0,0,20,8,15,5,0,0,5,5,2,0,13,3,3.0,222.5
8288,72d2ab073f4120a4,83fd97284f4bb4a4,9c65736747ca92ec,2014-09-13,1,0,0,900,0,0,101,27,97,4,0,0,4,2,21,16,76,25,22.2,499.7
8289,72d2ab073f4120a4,9c65736747ca92ec,83fd97284f4bb4a4,2014-09-13,0,0,0,900,4,2,98,23,82,16,1,1,15,14,22,12,60,9,350.3,461.8
8290,6f19f24780c4f23f,94527830000ab715,ffc3e6daaa6da0b7,2014-09-13,0,2,1,424,6,3,28,8,28,0,0,0,0,0,5,5,23,8,0.0,70.0
8291,6f19f24780c4f23f,ffc3e6daaa6da0b7,94527830000ab715,2014-09-13,0,0,0,424,0,0,20,4,14,6,3,3,3,3,2,2,12,1,275.0,149.0
8292,61c9bbeb2806534b,3738e68d2261e60f,8349d55cdecd393a,2014-09-13,1,0,0,179,0,0,33,8,29,4,0,0,4,4,6,5,23,4,1.7,176.0
8293,61c9bbeb2806534b,8349d55cdecd393a,3738e68d2261e60f,2014-09-13,0,0,0,179,0,0,13,2,13,0,0,0,0,0,6,4,7,2,0.0,177.3
8294,36c2ce10809f17b3,2f95a3c6d58b2aad,f50d95223751e6ca,2014-09-13,0,0,0,900,4,2,52,11,45,7,2,1,5,4,21,15,24,7,91.0,297.0
8295,36c2ce10809f17b3,f50d95223751e6ca,2f95a3c6d58b2aad,2014-09-13,0,0,0,900,12,6,41,13,20,21,1,1,20,10,0,0,20,3,473.0,291.0
8296,2798c746fe93502a,16b89be2f5c16fba,6a1901c62ab3870f,2014-09-13,0,0,0,273,1,0,13,5,9,4,0,0,4,2,1,1,8,3,0.0,12.0
8297,2798c746fe93502a,6a1901c62ab3870f,16b89be2f5c16fba,2014-09-13,0,2,1,273,1,1,24,14,4,20,5,5,15,13,0,0,4,1,261.0,12.0
8298,246f38c7855a6400,75e5fec9f72910ef,a3be148af5c7b088,2014-09-13,0,0,0,900,11,5,74,22,74,0,0,0,0,0,13,8,61,22,0.0,561.0
8299,246f38c7855a6400,a3be148af5c7b088,75e5fec9f72910ef,2014-09-13,0,0,0,900,0,0,113,11,113,0,0,0,0,0,65,41,48,11,0.0,802.0
8300,033e4538b9014f91,32c03df3c9760069,6d1bffff14897645,2014-09-13,0,0,0,80,0,0,24,4,24,0,0,0,0,0,4,4,20,4,0.0,79.3
8301,033e4538b9014f91,6d1bffff14897645,32c03df3c9760069,2014-09-13,1,0,0,80,0,0,26,10,24,2,0,0,2,1,2,0,22,9,0.7,79.0
8302,fd4d5685c2e207b5,ba280572acfba13f,d3df1add9d9a7efb,2014-09-05,1,0,0,41,0,0,11,7,3,8,0,0,8,5,0,0,3,2,7.0,34.0
8303,fd4d5685c2e207b5,d3df1add9d9a7efb,ba280572acfba13f,2014-09-05,0,0,0,41,0,0,1,1,1,0,0,0,0,0,0,0,1,1,0.0,34.0
8304,c9733393385105cb,3bad7ef643840f67,c58f51dedb310998,2014-09-05,1,0,0,434,7,2,41,17,31,10,1,1,9,6,3,3,28,11,117.1,270.0
8305,c9733393385105cb,c58f51dedb310998,3bad7ef643840f67,2014-09-05,0,0,0,434,4,1,57,14,57,0,0,0,0,0,17,16,40,14,0.0,234.9
8306,98e21492b6bc15d3,0dba4df5f34d5ff0,6c2030e0a143a94b,2014-09-05,0,0,0,900,12,2,73,6,73,0,0,0,0,0,37,30,36,6,0.0,736.0
8307,98e21492b6bc15d3,6c2030e0a143a94b,0dba4df5f34d5ff0,2014-09-05,0,0,0,900,1,0,112,39,112,0,0,0,0,0,30,28,82,39,0.0,735.0
8308,839c8cd7b1a32c7c,92437c6775b3f7d1,9fa568ad2bf2cb0b,2014-09-05,0,3,1,347,0,0,12,2,12,0,0,0,0,0,6,2,6,2,0.0,76.0
8309,839c8cd7b1a32c7c,9fa568ad2bf2cb0b,92437c6775b3f7d1,2014-09-05,0,0,0,347,3,3,18,6,16,2,1,1,1,1,6,6,10,5,271.0,76.0
8310,80faf0c138d20999,232c582f29f8f65e,7a703c565ccaa18f,2014-09-05,0,0,0,870,0,0,56,23,56,0,0,0,0,0,3,3,53,23,0.0,436.7
8311,80faf0c138d20999,7a703c565ccaa18f,232c582f29f8f65e,2014-09-05,0,1,1,870,10,4,56,15,45,11,7,7,4,4,12,10,33,11,419.3,222.0
8312,7ba4a04673307cc9,4bd6b4800070b069,bd5403efbaa445c0,2014-09-05,0,7,0,900,7,4,36,12,29,7,0,0,7,6,3,1,26,6,420.0,171.8
8313,7ba4a04673307cc9,bd5403efbaa445c0,4bd6b4800070b069,2014-09-05,0,0,0,900,0,0,48,19,31,17,2,1,15,6,8,4,23,13,128.2,299.0
8314,603b0b1fa3ab8f20,3a524c6700addc24,55f446032177b119,2014-09-05,0,0,0,900,1,0,111,19,108,3,1,1,2,2,36,21,72,17,56.0,538.4
8315,603b0b1fa3ab8f20,55f446032177b119,3a524c6700addc24,2014-09-05,0,1,0,900,4,3,123,40,88,35,3,2,32,21,3,3,85,19,249.6,516.0
8316,1c980547431ddcef,59279a7c978f7da0,a20d7dfaba74c067,2014-09-05,1,0,0,746,0,0,221,67,220,1,0,0,1,1,38,26,182,66,1.5,740.0
8317,1c980547431ddcef,a20d7dfaba74c067,59279a7c978f7da0,2014-09-05,0,0,0,746,5,0,177,51,177,0,0,0,0,0,9,6,168,51,0.0,734.5
8318,1520290d28b75b53,b4ad3a06ee4d660c,bd58d34e39b7b12a,2014-09-05,0,0,0,139,1,0,21,5,21,0,0,0,0,0,15,15,6,5,0.0,124.0
8319,1520290d28b75b53,bd58d34e39b7b12a,b4ad3a06ee4d660c,2014-09-05,1,0,0,139,0,0,27,15,22,5,0,0,5,5,2,2,20,10,13.0,126.0
8320,e8c16b26a4bfe163,a4e85a58fbce64b2,c849740a3ff51931,2014-08-30,0,0,0,1340,5,0,197,53,197,0,0,0,0,0,13,9,184,53,0.0,1308.0
8321,e8c16b26a4bfe163,c849740a3ff51931,a4e85a58fbce64b2,2014-08-30,1,0,0,1340,3,2,454,113,450,4,0,0,4,1,54,38,396,112,32.0,1228.0
8322,c303b8a07d0d06d2,7e208569469c8bc8,c727c7d31c50c4cf,2014-08-30,0,0,0,557,3,0,29,7,29,0,0,0,0,0,6,3,23,7,0.0,236.2
8323,c303b8a07d0d06d2,c727c7d31c50c4cf,7e208569469c8bc8,2014-08-30,1,0,0,557,6,5,64,2,11,53,50,49,3,2,9,9,2,0,319.8,207.0
8324,bd83e4a6f216230f,9450848a71d53776,b1a3e0aca758b322,2014-08-30,0,0,0,900,0,0,40,7,40,0,0,0,0,0,16,13,24,7,0.0,418.5
8325,bd83e4a6f216230f,b1a3e0aca758b322,9450848a71d53776,2014-08-30,0,1,0,900,12,4,30,10,24,6,0,0,6,6,3,2,21,4,481.5,258.0
8326,ae0b5ab5bc4bb6a7,22a92d7f62195791,d1e7fc58d4225cdf,2014-08-30,0,1,0,900,0,0,80,10,79,1,0,0,1,1,18,13,61,9,1.8,324.0
8327,ae0b5ab5bc4bb6a7,d1e7fc58d4225cdf,22a92d7f62195791,2014-08-30,0,1,0,900,8,2,105,23,95,10,0,0,10,2,3,0,92,21,569.0,329.2
8328,8452ff5ae6316931,673ea7dcc786b1b3,8ef4a91ac694b7ce,2014-08-30,1,0,0,416,0,0,103,50,102,1,0,0,1,1,24,18,78,49,4.2,260.0
8329,8452ff5ae6316931,8ef4a91ac694b7ce,673ea7dcc786b1b3,2014-08-30,0,1,0,416,4,1,30,8,30,0,0,0,0,0,0,0,30,8,0.0,296.8
8330,7cfb05c08ec91525,29af297d9f1de0f8,813550bc53b15fb0,2014-08-30,0,0,0,414,5,0,49,11,49,0,0,0,0,0,15,9,34,11,0.0,275.0
8331,7cfb05c08ec91525,813550bc53b15fb0,29af297d9f1de0f8,2014-08-30,0,2,1,414,0,0,55,16,55,0,0,0,0,0,17,13,38,16,0.0,375.0
8332,788c4bbf925cdf40,064b7dc68d786254,c8097968da5e5f13,2014-08-30,0,0,0,72,0,0,3,0,3,0,0,0,0,0,0,0,3,0,0.0,69.0
8333,788c4bbf925cdf40,c8097968da5e5f13,064b7dc68d786254,2014-08-30,0,1,1,72,1,1,1,0,1,0,0,0,0,0,0,0,1,0,0.0,28.0
8334,1748b2b5aabe23a5,22aa91e402d0fe1f,f53d4f21d1b5f2dc,2014-08-30,0,0,0,413,4,2,58,13,47,11,1,0,10,3,5,5,42,10,92.6,265.0
8335,1748b2b5aabe23a5,f53d4f21d1b5f2dc,22aa91e402d0fe1f,2014-08-30,1,2,0,413,0,0,70,17,61,9,2,2,7,7,12,6,49,10,47.0,273.4
8336,fe1130f34dea28d8,5ea918ea81b7dee2,b9c03e7a4557e542,2014-08-23,0,0,0,900,0,0,67,26,52,15,1,1,14,4,0,0,52,22,161.6,428.5
8337,fe1130f34dea28d8,b9c03e7a4557e542,5ea918ea81b7dee2,2014-08-23,0,0,0,900,4,3,29,6,25,4,0,0,4,3,14,12,11,3,234.5,269.4
8338,e8f6232d12d52b58,4bd6b4800070b069,5fceb45939fc0c8a,2014-08-23,0,1,1,155,1,1,11,2,11,0,0,0,0,0,0,0,11,2,0.0,80.0
8339,e8f6232d12d52b58,5fceb45939fc0c8a,4bd6b4800070b069,2014-08-23,0,1,0,155,0,0,4,1,4,0,0,0,0,0,0,0,4,1,0.0,99.0
8340,e5cf527ed3963a0e,173acb3f920082b8,7c3c48cf54a2848e,2014-08-23,0,0,0,66,0,0,4,1,4,0,0,0,0,0,1,0,3,1,0.0,66.0
8341,e5cf527ed3963a0e,7c3c48cf54a2848e,173acb3f920082b8,2014-08-23,0,1,1,66,1,0,8,5,8,0,0,0,0,0,0,0,8,5,0.0,34.0
8342,d0ee52e17db605ab,4665f9f909cd7214,4b1d46a1b5c0fd11,2014-08-23,0,0,0,257,1,1,46,29,46,0,0,0,0,0,2,2,44,29,0.0,184.9
8343,d0ee52e17db605ab,4b1d46a1b5c0fd11,4665f9f909cd7214,2014-08-23,1,0,0,257,2,0,58,30,49,9,0,0,9,9,5,4,44,21,23.1,221.0
8344,c7765a3255701267,2aa49b3766a59bcd,f5990c11974d8e9c,2014-08-23,1,0,0,72,0,0,15,9,8,7,0,0,7,5,1,1,7,4,0.0,72.0
8345,c7765a3255701267,f5990c11974d8e9c,2aa49b3766a59bcd,2014-08-23,0,0,0,72,2,0,8,0,8,0,0,0,0,0,4,2,4,0,0.0,68.0
8346,bb9c60bc6924f373,484acc7b0f856ce9,bad8be5827ea1bf1,2014-08-23,0,2,1,138,0,0,6,1,4,2,0,0,2,1,3,3,1,0,44.0,20.0
8347,bb9c60bc6924f373,bad8be5827ea1bf1,484acc7b0f856ce9,2014-08-23,0,0,0,138,1,1,5,1,4,1,0,0,1,1,3,3,1,0,74.0,20.0
8348,b2867869d4eb98ce,34c2b3656f88f7ef,b57edace7b647f07,2014-08-23,0,0,0,900,1,0,54,23,43,11,0,0,11,7,15,15,28,16,0.0,380.29999999999995
8349,b2867869d4eb98ce,b57edace7b647f07,34c2b3656f88f7ef,2014-08-23,0,0,0,900,9,6,100,51,43,57,4,4,53,32,11,8,32,19,519.7,125.0
8350,a57b9c636ac198be,2b93ebd9f5417ad2,d4f364dd076bb0e2,2014-08-23,1,0,0,957,0,0,270,68,267,3,0,0,3,2,34,24,233,66,1.8,954.0
8351,a57b9c636ac198be,d4f364dd076bb0e2,2b93ebd9f5417ad2,2014-08-23,0,0,0,957,0,0,110,9,110,0,0,0,0,0,43,29,67,9,0.0,955.2
8352,954362efa4564d60,84b3e7d38f2d2ec5,a2b12c3f3d60ff69,2014-08-23,0,0,0,900,6,3,79,18,69,10,5,4,5,2,18,17,51,16,85.7,363.2
8353,954362efa4564d60,a2b12c3f3d60ff69,84b3e7d38f2d2ec5,2014-08-23,0,0,0,900,7,3,39,4,35,4,1,0,3,1,3,1,32,3,296.8,443.3
8354,7cde85d46dc0bebe,9bcf8603ceb25680,effd9de9937996f8,2014-08-23,0,0,0,61,0,0,4,0,4,0,0,0,0,0,2,2,2,0,0.0,34.1
8355,7cde85d46dc0bebe,effd9de9937996f8,9bcf8603ceb25680,2014-08-23,1,0,0,61,0,0,15,8,8,7,0,0,7,6,5,5,3,2,26.9,11.0
8356,735ed861dee80d25,3591d0d5d382a381,cfb65863d5099327,2014-08-23,0,0,0,320,1,0,51,9,51,0,0,0,0,0,12,9,39,9,0.0,280.2
8357,735ed861dee80d25,cfb65863d5099327,3591d0d5d382a381,2014-08-23,1,0,0,320,1,0,43,11,40,3,1,1,2,0,9,6,31,11,12.8,269.0
8358,63e4cd10ed47f1a8,072a10e85f7d4bff,dcbf01d605681ad1,2014-08-23,0,0,0,900,5,2,36,6,36,0,0,0,0,0,8,5,28,6,0.0,312.6
8359,63e4cd10ed47f1a8,dcbf01d605681ad1,072a10e85f7d4bff,2014-08-23,0,0,0,900,0,0,54,18,33,21,3,2,18,11,6,5,27,7,432.4,447.0
8360,53fe9da9fb8d4f88,08af939f41b5a57b,5331b25a60417ffb,2014-08-23,0,1,1,518,3,2,61,6,61,0,0,0,0,0,29,20,32,6,0.0,447.0
8361,53fe9da9fb8d4f88,5331b25a60417ffb,08af939f41b5a57b,2014-08-23,0,0,0,518,4,1,72,24,72,0,0,0,0,0,13,10,59,24,0.0,378.0
8362,4de8b5898e1a23c8,69e8c632135af48b,dc9572dd6ec74859,2014-08-23,0,0,0,290,0,0,5,0,5,0,0,0,0,0,0,0,5,0,0.0,59.0
8363,4de8b5898e1a23c8,dc9572dd6ec74859,69e8c632135af48b,2014-08-23,1,0,0,290,2,2,17,9,2,15,0,0,15,9,2,2,0,0,231.0,59.0
8364,351532f2fe6804d1,2676b28836a5a836,6a2f7c151031653d,2014-08-23,0,0,0,151,1,0,27,3,27,0,0,0,0,0,9,7,18,3,0.0,147.8
8365,351532f2fe6804d1,6a2f7c151031653d,2676b28836a5a836,2014-08-23,1,0,0,151,0,0,30,11,27,3,0,0,3,1,8,7,19,10,1.2,149.0
8366,2d323659e430bc92,c06d554ce1713fd3,efb9a43415a56d34,2014-08-23,0,1,0,900,8,0,120,27,120,0,0,0,0,0,41,31,79,27,0.0,626.7
8367,2d323659e430bc92,efb9a43415a56d34,c06d554ce1713fd3,2014-08-23,0,0,0,900,2,0,124,38,111,13,2,2,11,9,29,24,82,29,84.3,673.0
8368,2c417643d6de6f04,2c1170b825f58e57,d3c554d6e11fc9d6,2014-08-23,0,1,0,900,3,2,91,13,90,1,0,0,1,0,27,18,63,13,24.6,777.0
8369,2c417643d6de6f04,d3c554d6e11fc9d6,2c1170b825f58e57,2014-08-23,0,0,0,900,4,1,78,4,78,0,0,0,0,0,31,17,47,4,0.0,844.4
8370,20f0129fc4861674,6256b2b1562cb8e1,777dea713da2441d,2014-08-23,1,0,0,900,1,0,221,51,221,0,0,0,0,0,32,26,189,51,0.0,877.0
8371,20f0129fc4861674,777dea713da2441d,6256b2b1562cb8e1,2014-08-23,0,0,0,900,10,4,231,64,231,0,0,0,0,0,41,27,190,64,0.0,842.0
8372,01be9ab42f1fd8e6,5aedf14771ca82d2,b12fc8a41e82d3a2,2014-08-23,0,1,0,900,14,9,67,13,65,2,1,1,1,1,11,8,54,12,131.7,493.0
8373,01be9ab42f1fd8e6,b12fc8a41e82d3a2,5aedf14771ca82d2,2014-08-23,1,0,0,900,0,0,86,16,77,9,2,1,7,4,9,3,68,12,12.0,752.3
8374,0067048aaa2aa2da,494b0bfdbac74502,7b310409440c9102,2014-08-23,0,0,0,900,3,0,50,7,45,5,0,0,5,0,15,8,30,7,108.9,481.1
8375,0067048aaa2aa2da,7b310409440c9102,494b0bfdbac74502,2014-08-23,0,1,0,900,4,2,40,7,34,6,2,1,4,3,13,11,21,4,222.9,308.1
8376,efa3f3c8945cad0a,4f732e58ed907eff,7d96bc577e5178b2,2014-08-16,1,0,0,395,0,0,55,20,51,4,0,0,4,4,10,6,41,16,2.9,387.0
8377,efa3f3c8945cad0a,7d96bc577e5178b2,4f732e58ed907eff,2014-08-16,0,0,0,395,4,2,47,9,47,0,0,0,0,0,7,6,40,9,0.0,319.1
8378,db209b782f35e0e6,50db8711c70196cd,c0ab242c40decc55,2014-08-16,0,0,0,1500,2,2,91,17,90,1,0,0,1,0,16,7,74,17,15.3,911.4
8379,db209b782f35e0e6,c0ab242c40decc55,50db8711c70196cd,2014-08-16,0,1,0,1500,21,9,72,18,57,15,3,2,12,7,12,4,45,11,481.6,874.7
8380,a0e4f43827aa81c4,57ab4d7c0bc09a30,b102c26727306ab6,2014-08-16,0,0,0,900,4,1,69,23,45,24,1,1,23,13,4,1,41,10,247.0,427.4
8381,a0e4f43827aa81c4,b102c26727306ab6,57ab4d7c0bc09a30,2014-08-16,0,0,0,900,4,2,28,10,20,8,0,0,8,4,2,1,18,6,225.6,371.0
8382,99dc6aa635a9cf98,9ba2226646046b63,9eb069062a0cfc13,2014-08-16,0,0,0,900,9,5,129,31,120,9,1,1,8,3,45,35,75,28,53.8,541.0
8383,99dc6aa635a9cf98,9eb069062a0cfc13,9ba2226646046b63,2014-08-16,0,0,0,900,0,0,53,13,49,4,0,0,4,2,14,12,35,11,12.0,828.2
8384,852442b380088fa5,0c6d9ea8306c029e,c80095f6092271a7,2014-08-16,0,0,0,498,1,0,56,17,56,0,0,0,0,0,7,7,49,17,0.0,229.3
8385,852442b380088fa5,c80095f6092271a7,0c6d9ea8306c029e,2014-08-16,2,0,0,498,5,1,28,10,23,5,0,0,5,4,5,4,18,6,11.7,463.0
8386,6989466d287b4a57,8a59d346dc976a10,960d6cae8879ba2b,2014-08-16,0,1,1,267,3,2,31,18,2,29,0,0,29,18,0,0,2,0,232.0,35.0
8387,6989466d287b4a57,960d6cae8879ba2b,8a59d346dc976a10,2014-08-16,0,0,0,267,0,0,2,0,2,0,0,0,0,0,0,0,2,0,0.0,35.0
8388,5df4632f6238e612,cf65d56b0755ed3b,fd5b6598a3b70c0a,2014-08-16,1,0,0,263,0,0,43,15,41,2,0,0,2,2,11,10,30,13,2.3,237.4
8389,5df4632f6238e612,fd5b6598a3b70c0a,cf65d56b0755ed3b,2014-08-16,0,0,0,263,2,1,65,23,61,4,0,0,4,2,5,2,56,21,8.6,217.7
8390,49d8fc8e4aee9b51,6809c31286b08d97,d156513a19acf856,2014-08-16,0,0,0,900,4,0,167,34,167,0,0,0,0,0,62,51,105,34,0.0,809.8
8391,49d8fc8e4aee9b51,d156513a19acf856,6809c31286b08d97,2014-08-16,0,0,0,900,0,0,168,71,165,3,0,0,3,2,18,11,147,69,1.2,874.0
8392,2573a9a722f238f4,2c6e81426dd7573c,ca2efc9d7d523c43,2014-08-16,0,0,0,723,0,0,59,13,59,0,0,0,0,0,12,7,47,13,0.0,425.8
8393,2573a9a722f238f4,ca2efc9d7d523c43,2c6e81426dd7573c,2014-08-16,1,0,0,723,4,3,54,28,24,30,2,2,28,20,4,2,20,8,297.2,406.0
8394,03ba4f9ba7c934ad,729d4bd5a6cd0a97,7be74a12d7352df2,2014-08-16,0,0,0,900,0,0,83,41,49,34,0,0,34,30,7,7,42,11,14.7,357.0
8395,03ba4f9ba7c934ad,7be74a12d7352df2,729d4bd5a6cd0a97,2014-08-16,0,0,0,900,9,5,80,23,61,19,1,1,18,12,20,14,41,11,527.0,247.3
8396,fe6b45e7210bfa8e,1971869b7e054261,def8166ff24bd237,2014-07-26,0,0,0,99,1,0,11,4,11,0,0,0,0,0,2,2,9,4,0.0,99.0
8397,fe6b45e7210bfa8e,def8166ff24bd237,1971869b7e054261,2014-07-26,0,2,0,99,3,1,6,1,6,0,0,0,0,0,2,2,4,1,0.0,27.0
8398,f9e672ec431fed3f,8ce87f7e3a9baed2,c136b2a8852da5bd,2014-07-26,0,0,0,900,0,0,163,20,162,1,0,0,1,0,61,42,101,20,5.7,689.0
8399,f9e672ec431fed3f,c136b2a8852da5bd,8ce87f7e3a9baed2,2014-07-26,0,0,0,900,2,2,73,9,70,3,1,1,2,2,26,20,44,7,6.0,884.3
8400,f29ba17d818d4fac,3d6749c4267da18f,75a6a390fd5dca46,2014-07-26,0,0,0,900,0,0,168,24,168,0,0,0,0,0,40,22,128,24,0.0,752.2
8401,f29ba17d818d4fac,75a6a390fd5dca46,3d6749c4267da18f,2014-07-26,0,0,0,900,14,1,77,8,74,3,0,0,3,2,21,10,53,6,138.8,530.0
8402,677910683d0fd88b,31123249b0bbf52e,f2925e6db404bf1d,2014-07-26,0,0,0,1500,8,2,242,45,242,0,0,0,0,0,60,37,182,45,0.0,1324.7
8403,677910683d0fd88b,f2925e6db404bf1d,31123249b0bbf52e,2014-07-26,0,0,0,1500,2,2,200,64,192,8,0,0,8,5,18,16,174,59,105.3,1263.0
8404,5da651d5867cbdfe,23024fdfc966410a,69a400af4420cd6a,2014-07-26,0,0,0,900,10,2,140,27,140,0,0,0,0,0,26,17,114,27,0.0,661.3
8405,5da651d5867cbdfe,69a400af4420cd6a,23024fdfc966410a,2014-07-26,0,0,0,900,1,0,111,28,109,2,0,0,2,2,17,13,92,26,15.7,719.0
8406,55b3724a98c0469c,9f755fb04cc21499,d188a3b817860ec6,2014-07-26,0,2,0,900,17,4,91,15,87,4,1,1,3,3,17,10,70,12,199.0,546.3
8407,55b3724a98c0469c,d188a3b817860ec6,9f755fb04cc21499,2014-07-26,0,0,0,900,0,0,92,26,85,7,0,0,7,2,12,9,73,24,154.7,480.0
8408,35cdd5e50d30f26e,4b47e71384a9522f,575360be653ad6a6,2014-07-26,0,0,0,900,4,1,210,44,210,0,0,0,0,0,66,41,144,44,0.0,867.0
8409,35cdd5e50d30f26e,575360be653ad6a6,4b47e71384a9522f,2014-07-26,0,0,0,900,3,0,189,35,189,0,0,0,0,0,42,26,147,35,0.0,898.0
8410,2e23e7ab6217c034,b959e8c7fd8390d2,e51e5cb722bd47a8,2014-07-26,0,0,0,900,1,0,85,7,85,0,0,0,0,0,20,15,65,7,0.0,408.2
8411,2e23e7ab6217c034,e51e5cb722bd47a8,b959e8c7fd8390d2,2014-07-26,0,0,0,900,17,10,129,66,66,63,0,0,63,44,9,7,57,22,475.8,326.0
8412,23124e6f3e7aa37d,887961364be5ceb3,a566371ba2ad7152,2014-07-26,0,0,0,900,2,0,141,18,141,0,0,0,0,0,62,41,79,18,0.0,839.6
8413,23124e6f3e7aa37d,a566371ba2ad7152,887961364be5ceb3,2014-07-26,0,0,0,900,5,0,120,25,116,4,0,0,4,3,29,20,87,22,8.4,881.0
8414,1f63949591ad61bd,365fee2da473b177,73e09f837f3b5ecc,2014-07-26,1,0,0,44,0,0,17,8,17,0,0,0,0,0,0,0,17,8,0.0,43.0
8415,1f63949591ad61bd,73e09f837f3b5ecc,365fee2da473b177,2014-07-26,0,0,0,44,0,0,2,0,2,0,0,0,0,0,0,0,2,0,0.0,44.0
8416,17dc833cda860933,47b9e0e7703a4868,5f99b2bafb10305f,2014-07-26,0,2,0,900,4,2,92,35,59,33,5,3,28,17,18,13,41,18,353.6,429.4
8417,17dc833cda860933,5f99b2bafb10305f,47b9e0e7703a4868,2014-07-26,1,1,0,900,3,2,83,6,77,6,1,0,5,2,21,13,56,4,20.6,522.4
8418,1258b6f1cb5eed64,6f242453c91a5af0,c47df9303d318c67,2014-07-26,0,1,1,477,7,2,114,36,114,0,0,0,0,0,15,11,99,36,0.0,347.0
8419,1258b6f1cb5eed64,c47df9303d318c67,6f242453c91a5af0,2014-07-26,0,0,0,477,3,0,79,24,79,0,0,0,0,0,6,4,73,24,0.0,461.0
8420,f6d6b660e1578744,1091d4d957141094,7bc96507e4b38d3b,2014-07-19,1,0,0,297,0,0,70,29,55,15,0,0,15,10,18,13,37,19,36.5,174.2
8421,f6d6b660e1578744,7bc96507e4b38d3b,1091d4d957141094,2014-07-19,1,2,0,297,2,1,39,17,36,3,0,0,3,1,5,4,31,16,10.8,166.5
8422,f3a970c83d8de1db,564c2f5f9eb45d67,99c7610aa74995d3,2014-07-19,1,2,0,513,4,1,65,33,41,24,0,0,24,16,6,5,35,17,116.7,331.3
8423,f3a970c83d8de1db,99c7610aa74995d3,564c2f5f9eb45d67,2014-07-19,0,1,1,513,5,3,40,7,39,1,0,0,1,1,7,4,32,6,40.7,274.3
8424,e554e9910cb83d49,6e7c758f5cdec01a,f65dcb22dada2223,2014-07-19,1,1,1,186,1,0,29,7,22,7,0,0,7,3,7,3,15,4,98.9,73.0
8425,e554e9910cb83d49,f65dcb22dada2223,6e7c758f5cdec01a,2014-07-19,0,1,0,186,0,0,11,2,11,0,0,0,0,0,3,1,8,2,0.0,87.1
8426,c805552171b20b68,8abf70f79e9e27c2,f797f0c57a83353e,2014-07-19,0,0,0,900,5,1,45,13,45,0,0,0,0,0,14,13,31,13,0.0,398.6
8427,c805552171b20b68,f797f0c57a83353e,8abf70f79e9e27c2,2014-07-19,0,2,0,900,5,2,59,17,42,17,4,4,13,12,25,21,17,5,236.4,469.0
8428,b2457e9da89967e2,49a74b9fb2e45fdf,ba043b03eb799063,2014-07-19,1,0,0,900,2,2,148,42,123,25,18,11,7,4,11,7,112,38,105.9,742.5
8429,b2457e9da89967e2,ba043b03eb799063,49a74b9fb2e45fdf,2014-07-19,0,0,0,900,17,2,126,35,125,1,0,0,1,1,6,5,119,34,13.5,713.1
8430,ab3820fa9944bd22,4ba8d454f762005d,fd55393021a8c255,2014-07-19,0,0,0,588,1,0,75,8,75,0,0,0,0,0,19,10,56,8,0.0,516.8
8431,ab3820fa9944bd22,fd55393021a8c255,4ba8d454f762005d,2014-07-19,0,1,1,588,1,1,24,9,22,2,0,0,2,2,4,4,18,7,17.2,545.0
8432,85a58685504c63b4,dfae5da5676e4194,e9a3aeb207578eea,2014-07-19,0,0,0,127,0,0,5,1,5,0,0,0,0,0,0,0,5,1,0.0,124.0
8433,85a58685504c63b4,e9a3aeb207578eea,dfae5da5676e4194,2014-07-19,1,0,0,127,1,1,31,9,30,1,0,0,1,1,7,7,23,8,3.0,124.0
8434,611ccad0fc46ba51,14ff46596ad80609,bc8f6b42767e28df,2014-07-19,1,0,0,521,2,2,83,25,36,47,6,3,41,21,9,6,27,4,178.8,308.0
8435,611ccad0fc46ba51,bc8f6b42767e28df,14ff46596ad80609,2014-07-19,0,0,0,521,7,0,35,5,35,0,0,0,0,0,9,3,26,5,0.0,280.2
8436,1e603e6aa6d1a750,c2e3e67b5911bfb7,f4c49976c75c5ab2,2014-07-19,0,1,0,245,2,0,22,5,21,1,0,0,1,0,6,4,15,5,3.7,81.0
8437,1e603e6aa6d1a750,f4c49976c75c5ab2,c2e3e67b5911bfb7,2014-07-19,1,0,0,245,1,1,49,15,30,19,0,0,19,8,5,3,25,7,142.0,99.3
8438,0836a9bdd8942bb3,701e057d63c124d9,c945adc22c2bfe8f,2014-07-19,0,0,0,900,7,3,119,33,113,6,0,0,6,5,31,23,82,28,33.7,737.0
8439,0836a9bdd8942bb3,c945adc22c2bfe8f,701e057d63c124d9,2014-07-19,0,0,0,900,10,0,97,15,97,0,0,0,0,0,16,7,81,15,0.0,773.3
8440,c8998aa536614a5a,1d00756835ca67c9,d1941565abf50b16,2014-07-16,1,0,0,511,2,0,78,16,77,1,0,0,1,1,34,21,43,15,4.2,485.1
8441,c8998aa536614a5a,d1941565abf50b16,1d00756835ca67c9,2014-07-16,0,0,0,511,6,1,65,12,64,1,0,0,1,1,22,18,42,11,4.9,472.8
8442,c1bc2a42652f685c,9b198c73e3d0d289,a36556bb1565e32d,2014-07-16,0,0,0,507,4,0,86,19,86,0,0,0,0,0,24,16,62,19,0.0,465.9
8443,c1bc2a42652f685c,a36556bb1565e32d,9b198c73e3d0d289,2014-07-16,1,0,0,507,0,0,81,21,73,8,0,0,8,6,7,4,66,15,5.1,500.0
8444,b0271fa12935bf88,50d2f0018bcf9eef,75e5fec9f72910ef,2014-07-16,0,0,0,900,3,0,132,26,132,0,0,0,0,0,38,28,94,26,0.0,661.0
8445,b0271fa12935bf88,75e5fec9f72910ef,50d2f0018bcf9eef,2014-07-16,0,0,0,900,6,4,93,37,83,10,1,1,9,7,10,6,73,30,105.0,627.0
8446,a822be2a017f329e,5b5307450405abf0,8bbc0cfc01bc1ba1,2014-07-16,0,1,1,432,4,3,39,22,16,23,0,0,23,17,2,2,14,5,345.0,87.0
8447,a822be2a017f329e,8bbc0cfc01bc1ba1,5b5307450405abf0,2014-07-16,0,0,0,432,0,0,20,5,19,1,0,0,1,1,7,6,12,4,0.0,87.0
8448,9fc7fcbdb6587265,76984112f697631f,a7ddae0be8b78147,2014-07-16,1,0,0,144,0,0,59,21,59,0,0,0,0,0,16,15,43,21,0.0,143.0
8449,9fc7fcbdb6587265,a7ddae0be8b78147,76984112f697631f,2014-07-16,0,0,0,144,0,0,36,6,36,0,0,0,0,0,11,10,25,6,0.0,144.0
8450,635ee9448fe2ddaf,12f1b140e248bdb9,3e61082025db8137,2014-07-16,0,0,0,300,0,0,3,1,1,2,0,0,2,1,1,1,0,0,55.0,72.1
8451,635ee9448fe2ddaf,3e61082025db8137,12f1b140e248bdb9,2014-07-16,1,0,0,300,0,0,21,8,2,19,3,3,16,8,2,2,0,0,172.9,63.0
8452,5c30f6535a08d598,e5ca2bc2451a5956,ec34349e7dffcde7,2014-07-16,0,0,0,900,0,0,141,21,141,0,0,0,0,0,18,8,123,21,0.0,544.1
8453,5c30f6535a08d598,ec34349e7dffcde7,e5ca2bc2451a5956,2014-07-16,0,2,0,900,6,5,164,49,128,36,6,5,30,20,26,16,102,29,355.9,465.0
8454,4e7c06f8b2b8c24b,64a50dad704d1d49,e5c9de15bb58b1c6,2014-07-16,1,0,0,186,0,0,17,4,17,0,0,0,0,0,6,6,11,4,0.0,182.0
8455,4e7c06f8b2b8c24b,e5c9de15bb58b1c6,64a50dad704d1d49,2014-07-16,0,0,0,186,1,0,27,10,25,2,0,0,2,2,0,0,25,8,1.0,184.0
8456,3c06557ddd86f8e8,c268b2cfebccf652,e18a19001a3f7c7d,2014-07-16,1,0,0,891,4,2,327,84,324,3,0,0,3,2,77,49,247,82,2.7,875.0
8457,3c06557ddd86f8e8,e18a19001a3f7c7d,c268b2cfebccf652,2014-07-16,0,0,0,891,4,1,230,73,230,0,0,0,0,0,28,15,202,73,0.0,833.3
8458,0dff8509f6a861f1,7413b80dbb0f8f9f,c17041f1bb5768d8,2014-07-16,1,0,0,728,1,0,140,36,137,3,0,0,3,3,24,17,113,33,16.0,712.0
8459,0dff8509f6a861f1,c17041f1bb5768d8,7413b80dbb0f8f9f,2014-07-16,0,0,0,728,0,0,159,20,159,0,0,0,0,0,44,22,115,20,0.0,712.0
8460,02a183fa803a33fe,cb696ebfb6598724,f95381efb3051d81,2014-07-16,1,0,0,830,4,4,98,39,46,52,4,4,48,36,27,19,19,3,405.0,316.0
8461,02a183fa803a33fe,f95381efb3051d81,cb696ebfb6598724,2014-07-16,0,0,0,830,0,0,46,9,46,0,0,0,0,0,10,6,36,9,0.0,425.0
8462,e7081f3a0a982f9d,d3df1add9d9a7efb,e7fe5315b1efeb92,2014-07-06,1,0,0,210,2,1,16,4,12,4,0,0,4,3,4,2,8,1,53.1,117.0
8463,e7081f3a0a982f9d,e7fe5315b1efeb92,d3df1add9d9a7efb,2014-07-06,0,0,0,210,0,0,8,0,8,0,0,0,0,0,6,6,2,0,0.0,156.9
8464,de17a01ce8a0c654,9fa568ad2bf2cb0b,f53c1f4ceeed8c08,2014-07-06,0,3,0,900,8,5,37,16,34,3,0,0,3,3,12,8,22,13,56.6,348.9
8465,de17a01ce8a0c654,f53c1f4ceeed8c08,9fa568ad2bf2cb0b,2014-07-06,0,0,0,900,7,2,64,19,41,23,8,8,15,9,16,12,25,10,268.1,400.4
8466,bdcb43bf1daa790b,73c7cfa551289285,f2688492b9a525a3,2014-07-06,0,0,0,856,0,0,66,13,66,0,0,0,0,0,0,0,66,13,0.0,330.6
8467,bdcb43bf1daa790b,f2688492b9a525a3,73c7cfa551289285,2014-07-06,1,0,0,856,3,3,162,76,82,80,5,5,75,53,15,9,67,23,525.4,324.0
8468,a6245f48fc60bc6a,d2a9be6bf2de624c,e3779ef06e98f185,2014-07-06,0,3,0,123,1,1,5,0,5,0,0,0,0,0,1,0,4,0,0.0,33.0
8469,a6245f48fc60bc6a,e3779ef06e98f185,d2a9be6bf2de624c,2014-07-06,0,0,0,123,0,0,0,0,0,0,0,0,0,0,0,0,0,0,0.0,123.0
8470,94371d1af8aab471,5580771f383e141f,ee9ebceabfd16fa7,2014-07-06,0,1,0,900,2,1,100,27,100,0,0,0,0,0,28,21,72,27,0.0,699.9
8471,94371d1af8aab471,ee9ebceabfd16fa7,5580771f383e141f,2014-07-06,0,0,0,900,12,4,110,33,104,6,1,1,5,5,19,15,85,28,160.1,473.0
8472,8fd355e482806ca7,1ed32eaaba9ffe10,d1e1fdcea7c8a90a,2014-07-06,0,0,0,829,0,0,127,24,125,2,0,0,2,2,20,9,105,22,42.0,560.0
8473,8fd355e482806ca7,d1e1fdcea7c8a90a,1ed32eaaba9ffe10,2014-07-06,0,3,1,829,8,2,139,23,135,4,2,1,2,1,24,20,111,22,206.0,581.0
8474,8c5785de472dd9b2,5e4eec08896c9423,7b39035fae7268b8,2014-07-06,1,0,0,61,2,2,37,22,27,10,0,0,10,8,4,2,23,14,8.3,42.0
8475,8c5785de472dd9b2,7b39035fae7268b8,5e4eec08896c9423,2014-07-06,0,0,0,61,0,0,10,1,10,0,0,0,0,0,2,1,8,1,0.0,52.7
8476,2f91307892d163ce,7dcf06c1967801c1,85d0fafb8b75d634,2014-07-06,1,0,0,141,0,0,24,9,24,0,0,0,0,0,0,0,24,9,0.0,138.0
8477,2f91307892d163ce,85d0fafb8b75d634,7dcf06c1967801c1,2014-07-06,0,0,0,141,0,0,51,4,51,0,0,0,0,0,14,9,37,4,0.0,141.0
8478,14a59abb3160ddaa,8cad40a75e5c97f5,e9213f53ddeca978,2014-07-06,1,0,0,71,0,0,42,22,21,21,0,0,21,15,0,0,21,7,16.4,53.0
8479,14a59abb3160ddaa,e9213f53ddeca978,8cad40a75e5c97f5,2014-07-06,0,0,0,71,0,0,10,4,10,0,0,0,0,0,1,1,9,4,0.0,54.6
8480,1117f90ee81e0bbf,87f3bbf52e6c9dc9,b4c96c3d9139bf0e,2014-07-06,0,2,0,900,1,0,51,20,50,1,0,0,1,1,5,4,45,19,5.8,227.29999999999995
8481,1117f90ee81e0bbf,b4c96c3d9139bf0e,87f3bbf52e6c9dc9,2014-07-06,0,3,0,900,7,5,24,11,13,11,0,0,11,6,0,0,13,5,608.7,230.2
8482,f966ed41316504b9,3a8176e15b9887c1,f7a7f7118d4b01b6,2014-07-05,0,0,0,1500,13,5,177,47,168,9,0,0,9,6,41,18,127,41,119.1,1219.9
8483,f966ed41316504b9,f7a7f7118d4b01b6,3a8176e15b9887c1,2014-07-05,0,0,0,1500,0,0,139,39,138,1,0,0,1,0,32,19,106,39,2.1,1361.9
8484,f560035058bdb18b,65578a75fa7900e3,dea070ed4a2a8281,2014-07-05,0,1,0,900,1,1,113,22,109,4,0,0,4,1,33,20,76,21,3.3,868.8
8485,f560035058bdb18b,dea070ed4a2a8281,65578a75fa7900e3,2014-07-05,0,0,0,900,2,0,129,8,125,4,1,1,3,2,57,35,68,6,26.2,837.7
8486,f206143bb9347444,6e0273f9478be71e,7c6e87729e824ef4,2014-07-05,0,2,0,900,10,3,110,46,59,51,6,5,45,31,19,19,40,15,428.6,359.9
8487,f206143bb9347444,7c6e87729e824ef4,6e0273f9478be71e,2014-07-05,0,0,0,900,2,1,65,14,61,4,0,0,4,2,9,8,52,12,19.1,428.4
8488,c576e311ea337a32,05339613bf8e9808,3c0437fbeda06962,2014-07-05,1,0,0,139,0,0,23,7,21,2,0,0,2,1,5,5,16,6,2.0,135.0
8489,c576e311ea337a32,3c0437fbeda06962,05339613bf8e9808,2014-07-05,0,0,0,139,0,0,37,5,37,0,0,0,0,0,9,5,28,5,0.0,120.0
8490,9cba1f0cdf10a8e5,81801f57bd0a7c41,f50d95223751e6ca,2014-07-05,0,0,0,900,2,2,75,9,75,0,0,0,0,0,23,18,52,9,0.0,730.0
8491,9cba1f0cdf10a8e5,f50d95223751e6ca,81801f57bd0a7c41,2014-07-05,0,0,0,900,9,3,72,15,67,5,1,1,4,4,9,8,58,11,139.0,622.0
8492,6445b14dbd24ac25,2284092f8b63273b,d6d5da3c209884bc,2014-07-05,0,0,0,900,1,1,226,49,226,0,0,0,0,0,21,17,205,49,0.0,899.0
8493,6445b14dbd24ac25,d6d5da3c209884bc,2284092f8b63273b,2014-07-05,0,0,0,900,3,0,166,29,166,0,0,0,0,0,31,20,135,29,0.0,900.0
8494,629655f9b898810d,132505067f08c54d,8d9586726252dbf7,2014-07-05,0,0,0,61,0,0,4,1,4,0,0,0,0,0,2,1,2,1,0.0,11.0
8495,629655f9b898810d,8d9586726252dbf7,132505067f08c54d,2014-07-05,1,0,0,61,0,0,18,14,3,15,0,0,15,13,1,1,2,1,50.0,11.0
8496,5da7d95051699adb,4c2d90e335e6df19,8bdac25ce0bb874d,2014-07-05,0,0,0,16,0,0,6,2,6,0,0,0,0,0,0,0,6,2,0.0,12.4
8497,5da7d95051699adb,8bdac25ce0bb874d,4c2d90e335e6df19,2014-07-05,1,0,0,16,1,1,16,13,7,9,0,0,9,9,1,1,6,4,3.6,12.0
8498,2e8058fb2344ae3f,6c2030e0a143a94b,da1d8d76404bb6b5,2014-07-05,0,1,0,900,1,0,85,25,72,13,1,1,12,10,19,16,53,15,1.4,686.1
8499,2e8058fb2344ae3f,da1d8d76404bb6b5,6c2030e0a143a94b,2014-07-05,0,0,0,900,6,4,51,13,44,7,0,0,7,3,15,12,29,10,211.9,353.6
8500,27c34f7a7e1c4d67,78114b7199cef90c,7aa3d6964eff4877,2014-07-05,0,1,1,669,12,5,38,16,28,10,0,0,10,8,7,4,21,8,213.7,251.9
8501,27c34f7a7e1c4d67,7aa3d6964eff4877,78114b7199cef90c,2014-07-05,0,0,0,669,0,0,45,10,40,5,0,0,5,1,13,10,27,9,11.1,424.3
8502,f3fb4be38377e1e9,a4de54ea806fb525,a7de976620f2ed13,2014-06-28,0,2,1,137,1,1,3,1,3,0,0,0,0,0,1,1,2,1,0.0,32.0
8503,f3fb4be38377e1e9,a7de976620f2ed13,a4de54ea806fb525,2014-06-28,0,0,0,137,0,0,3,0,3,0,0,0,0,0,0,0,3,0,0.0,137.0
8504,ee532a38a0b93127,193b9d1858bc4df3,d7adfcfdf7c6c1f8,2014-06-28,1,0,0,214,0,0,18,11,6,12,0,0,12,8,1,1,5,3,104.3,101.0
8505,ee532a38a0b93127,d7adfcfdf7c6c1f8,193b9d1858bc4df3,2014-06-28,0,3,0,214,2,0,9,0,9,0,0,0,0,0,1,1,8,0,0.0,88.7
8506,eb13a9d04dca676e,1e7483dbff40b84b,d5b7fac960e58920,2014-06-28,1,0,0,295,3,1,30,12,29,1,0,0,1,0,3,3,26,12,11.3,193.0
8507,eb13a9d04dca676e,d5b7fac960e58920,1e7483dbff40b84b,2014-06-28,0,0,0,295,1,1,35,3,35,0,0,0,0,0,14,11,21,3,0.0,226.7
8508,cbf36e02c68e7719,2e25c1d983c26311,f53d4f21d1b5f2dc,2014-06-28,0,0,0,38,0,0,3,0,3,0,0,0,0,0,2,2,1,0,0.0,23.0
8509,cbf36e02c68e7719,f53d4f21d1b5f2dc,2e25c1d983c26311,2014-06-28,0,1,1,38,1,1,10,4,7,3,0,0,3,2,4,3,3,2,5.0,28.0
8510,bfcabf1ab823942f,a8e6a69796280f17,f5431394fb284bb9,2014-06-28,1,1,1,274,2,2,27,15,13,14,0,0,14,12,4,2,9,3,150.9,80.0
8511,bfcabf1ab823942f,f5431394fb284bb9,a8e6a69796280f17,2014-06-28,0,0,0,274,1,0,10,1,10,0,0,0,0,0,6,5,4,1,0.0,84.1
8512,a4759c52378f9d1a,07225ba28ae309b6,ef7fa30364cbe7f2,2014-06-28,0,2,1,572,5,3,38,10,31,7,3,3,4,4,12,11,19,6,41.7,179.1
8513,a4759c52378f9d1a,ef7fa30364cbe7f2,07225ba28ae309b6,2014-06-28,0,0,0,572,4,3,27,7,20,7,0,0,7,3,6,4,14,4,249.9,173.3
8514,9afda67fdb4d7c07,8e8e4487c621aa1c,c06a9b48d4132c8e,2014-06-28,0,2,0,900,10,3,37,17,22,15,3,3,12,9,3,2,19,8,291.8,222.8
8515,9afda67fdb4d7c07,c06a9b48d4132c8e,8e8e4487c621aa1c,2014-06-28,1,0,0,900,0,0,67,31,28,39,3,3,36,20,1,1,27,11,288.2,305.2
8516,7d26a6b4b6845e1b,92b62174c175ce19,fae67903c4fe636b,2014-06-28,0,0,0,900,1,1,78,27,71,7,0,0,7,4,17,13,54,23,128.6,320.3
8517,7d26a6b4b6845e1b,fae67903c4fe636b,92b62174c175ce19,2014-06-28,0,0,0,900,8,3,32,15,21,11,0,0,11,10,1,1,20,5,432.7,299.4
8518,7962611f2adbacc0,60029bcf496bd707,91ea901c458e95dd,2014-06-28,0,0,0,900,5,0,25,8,21,4,0,0,4,4,5,3,16,4,18.7,599.4
8519,7962611f2adbacc0,91ea901c458e95dd,60029bcf496bd707,2014-06-28,0,0,0,900,4,1,58,16,42,16,7,7,9,8,23,20,19,8,258.6,186.3
8520,70e49c90d012de66,36207c58e854cae5,a845f0735bc67405,2014-06-28,0,1,0,796,1,0,15,8,15,0,0,0,0,0,3,3,12,8,0.0,249.5
8521,70e49c90d012de66,a845f0735bc67405,36207c58e854cae5,2014-06-28,0,1,1,796,11,4,85,51,32,53,1,1,52,45,8,8,24,6,527.5,169.0
8522,612333aaff795989,98c23cb6da5b3352,c727c7d31c50c4cf,2014-06-28,0,1,1,138,4,1,22,6,22,0,0,0,0,0,4,4,18,6,0.0,96.0
8523,612333aaff795989,c727c7d31c50c4cf,98c23cb6da5b3352,2014-06-28,0,0,0,138,1,0,14,5,14,0,0,0,0,0,1,1,13,5,0.0,121.0
8524,4eae10815ebe78e3,700a674c042b7a96,ffc3e6daaa6da0b7,2014-06-28,1,0,0,38,0,0,8,2,7,1,0,0,1,0,2,1,5,2,1.3,34.0
8525,4eae10815ebe78e3,ffc3e6daaa6da0b7,700a674c042b7a96,2014-06-28,0,0,0,38,0,0,11,5,11,0,0,0,0,0,2,2,9,5,0.0,36.7
8526,47cabf79c3340581,0c9c0a43d3f3f49d,993d385f5a475375,2014-06-28,0,0,0,900,9,3,166,25,166,0,0,0,0,0,67,53,99,25,0.0,722.0
8527,47cabf79c3340581,993d385f5a475375,0c9c0a43d3f3f49d,2014-06-28,0,0,0,900,0,0,229,28,229,0,0,0,0,0,23,14,206,28,0.0,900.0
8528,46cfb41b00cb5ad8,18968f97ad34f15c,d247691a6c0e9034,2014-06-28,0,0,0,1500,8,2,228,41,227,1,0,0,1,0,38,24,189,41,24.1,1307.0
8529,46cfb41b00cb5ad8,d247691a6c0e9034,18968f97ad34f15c,2014-06-28,0,0,0,1500,0,0,219,57,219,0,0,0,0,0,48,30,171,57,0.0,1461.9
8530,2c8d1f5bb73a812b,3974fa35c917af1d,ed209f6618c82e41,2014-06-28,0,1,0,900,11,2,94,10,94,0,0,0,0,0,32,23,62,10,0.0,571.0
8531,2c8d1f5bb73a812b,ed209f6618c82e41,3974fa35c917af1d,2014-06-28,0,0,0,900,5,2,74,17,74,0,0,0,0,0,19,14,55,17,0.0,686.0
8532,2bb2a2652fe38809,84b3e7d38f2d2ec5,a4dc47001f202bcd,2014-06-28,1,0,0,452,2,2,55,29,55,0,0,0,0,0,1,1,54,29,0.0,192.0
8533,2bb2a2652fe38809,a4dc47001f202bcd,84b3e7d38f2d2ec5,2014-06-28,0,2,0,452,3,1,14,0,12,2,2,2,0,0,4,3,8,0,222.0,230.0
8534,2977a9b5c30d89c1,54578e5927adea53,57887765f831e228,2014-06-28,0,2,0,900,15,4,50,12,48,2,1,1,1,1,17,14,31,11,71.2,473.0
8535,2977a9b5c30d89c1,57887765f831e228,54578e5927adea53,2014-06-28,0,0,0,900,2,1,81,15,81,0,0,0,0,0,25,21,56,15,0.0,775.8
8536,25a28456f684503e,cb52f9490c2dc069,fcd448a2fe1a23cc,2014-06-28,1,2,0,900,4,0,228,70,228,0,0,0,0,0,45,39,183,70,0.0,649.0
8537,25a28456f684503e,fcd448a2fe1a23cc,cb52f9490c2dc069,2014-06-28,0,0,0,900,1,0,164,55,164,0,0,0,0,0,42,38,122,55,0.0,894.0
8538,1f65f03f1225e061,b7ad576b8ae115e6,e1147d3d2dabe1ce,2014-06-28,0,0,0,900,2,0,146,25,146,0,0,0,0,0,31,22,115,25,0.0,815.7
8539,1f65f03f1225e061,e1147d3d2dabe1ce,b7ad576b8ae115e6,2014-06-28,0,0,0,900,1,1,183,46,181,2,0,0,2,1,20,20,161,45,47.3,758.0
8540,12bf24fa110513d0,8a70ceb3edbe757b,dbc17725b887860a,2014-06-28,1,0,0,900,1,0,67,12,64,3,0,0,3,3,8,4,56,9,16.5,622.5
8541,12bf24fa110513d0,dbc17725b887860a,8a70ceb3edbe757b,2014-06-28,0,0,0,900,4,2,61,6,58,3,1,1,2,2,21,13,37,4,244.5,557.5
8542,0dab467898de22c6,8b5f9ea38184ded3,8c0580d4fff106c1,2014-06-28,0,0,0,900,6,2,128,27,128,0,0,0,0,0,16,9,112,27,0.0,636.2
8543,0dab467898de22c6,8c0580d4fff106c1,8b5f9ea38184ded3,2014-06-28,0,0,0,900,0,0,174,46,172,2,0,0,2,2,29,21,143,44,6.8,822.0
8544,f3ebce624bb154ae,3738e68d2261e60f,89a407032911e27e,2014-06-14,0,0,0,900,1,0,55,6,55,0,0,0,0,0,12,6,43,6,0.0,556.4
8545,f3ebce624bb154ae,89a407032911e27e,3738e68d2261e60f,2014-06-14,0,0,0,900,5,1,88,23,56,32,4,4,28,8,7,3,49,15,153.6,708.0
8546,de65739f00350c58,cbd5d3cdd862e90e,effd9de9937996f8,2014-06-14,0,0,0,900,2,1,150,29,146,4,0,0,4,2,35,20,111,27,148.8,714.0
8547,de65739f00350c58,effd9de9937996f8,cbd5d3cdd862e90e,2014-06-14,0,0,0,900,2,0,81,10,81,0,0,0,0,0,20,16,61,10,0.0,666.2
8548,db747a157e1f264b,50db8711c70196cd,bc3ec52ef70fc155,2014-06-14,1,1,0,430,4,2,34,7,33,1,0,0,1,1,8,7,25,6,24.0,310.0
8549,db747a157e1f264b,bc3ec52ef70fc155,50db8711c70196cd,2014-06-14,0,0,0,430,1,0,29,4,29,0,0,0,0,0,14,11,15,4,0.0,345.0
8550,b72c19b80fb47ba4,5c1ca0c72b599a3c,c0ab242c40decc55,2014-06-14,0,0,0,900,0,0,37,10,36,1,0,0,1,0,3,0,33,10,5.2,513.4
8551,b72c19b80fb47ba4,c0ab242c40decc55,5c1ca0c72b599a3c,2014-06-14,0,0,0,900,16,7,94,22,62,32,15,13,17,13,18,18,44,9,355.6,394.8
8552,a84d032d7d217427,633a45d131192ffe,9a2d3567abc02e34,2014-06-14,0,0,0,721,9,4,91,22,88,3,0,0,3,1,12,7,76,21,63.0,548.1
8553,a84d032d7d217427,9a2d3567abc02e34,633a45d131192ffe,2014-06-14,2,0,0,721,1,0,107,32,97,10,0,0,10,5,5,2,92,27,67.9,563.0
8554,933660cfab154f1a,3dd92ff9fb0412b3,8a304bfd6bf04a57,2014-06-14,0,0,0,1500,12,2,122,9,122,0,0,0,0,0,43,27,79,9,0.0,1008.1
8555,933660cfab154f1a,8a304bfd6bf04a57,3dd92ff9fb0412b3,2014-06-14,0,0,0,1500,4,0,215,51,214,1,0,0,1,1,106,82,108,50,0.9,1414.0
8556,7767149280471f2a,71df36d6d8cf0d74,7e47047d0971d566,2014-06-14,0,1,1,172,3,1,10,1,9,1,0,0,1,0,4,4,5,1,112.0,60.0
8557,7767149280471f2a,7e47047d0971d566,71df36d6d8cf0d74,2014-06-14,0,1,0,172,0,0,4,3,4,0,0,0,0,0,0,0,4,3,0.0,60.0
8558,5fe5c8cb69d8825e,b4eeac608fc82f88,bc7230f231701d66,2014-06-14,0,0,0,900,8,5,132,38,126,6,0,0,6,3,34,22,92,35,117.4,417.4
8559,5fe5c8cb69d8825e,bc7230f231701d66,b4eeac608fc82f88,2014-06-14,0,0,0,900,4,0,121,17,112,9,2,2,7,5,27,23,85,12,71.6,607.6
8560,594ce25b9e16c7ba,46a2f24feb258ae0,dcbf01d605681ad1,2014-06-14,0,0,0,900,2,0,275,85,275,0,0,0,0,0,29,19,246,85,0.0,899.0
8561,594ce25b9e16c7ba,dcbf01d605681ad1,46a2f24feb258ae0,2014-06-14,0,0,0,900,3,0,270,57,270,0,0,0,0,0,21,10,249,57,0.0,775.0
8562,357ba2f1da89031b,1d36f1ac66cf689d,4ac1ecf8ce59ef23,2014-06-14,0,1,0,297,0,0,12,2,9,3,3,2,0,0,3,2,6,2,19.8,43.0
8563,357ba2f1da89031b,4ac1ecf8ce59ef23,1d36f1ac66cf689d,2014-06-14,1,0,0,297,3,2,24,9,5,19,2,1,17,8,0,0,5,1,221.0,56.2
8564,2d7ead5ad0952423,173acb3f920082b8,64788ee44b062ded,2014-06-14,0,0,0,900,1,1,20,2,19,1,0,0,1,1,0,0,19,1,21.0,288.70000000000005
8565,2d7ead5ad0952423,64788ee44b062ded,173acb3f920082b8,2014-06-14,0,1,0,900,4,3,37,19,11,26,1,1,25,15,2,1,9,4,590.3,266.0
8566,dbc35626d0f0576b,92437c6775b3f7d1,99506df1af6c8b3b,2014-06-07,0,0,0,600,2,0,54,3,54,0,0,0,0,0,19,5,35,3,0.0,545.0
8567,dbc35626d0f0576b,99506df1af6c8b3b,92437c6775b3f7d1,2014-06-07,1,0,0,600,1,1,63,14,55,8,2,1,6,3,17,12,38,11,53.0,547.0
8568,d02ac0447fb2a7a0,0b64d0fed453ef7f,8a9c6c4301f6d088,2014-06-07,0,0,0,900,15,10,97,29,89,8,2,2,6,4,13,9,76,25,109.5,452.4
8569,d02ac0447fb2a7a0,8a9c6c4301f6d088,0b64d0fed453ef7f,2014-06-07,1,0,0,900,2,0,143,36,139,4,0,0,4,2,18,11,121,34,9.6,718.5
8570,b97d2f97d109cfc8,6a2f7c151031653d,e5d03e4d966126bd,2014-06-07,1,3,0,516,2,2,68,24,58,10,0,0,10,9,16,12,42,15,86.2,329.4
8571,b97d2f97d109cfc8,e5d03e4d966126bd,6a2f7c151031653d,2014-06-07,0,0,0,516,3,3,64,21,61,3,0,0,3,2,8,3,53,19,74.6,255.8
8572,8d7ea177efadc718,4f732e58ed907eff,82e7929bf6c2b689,2014-06-07,1,0,0,900,1,1,122,27,120,2,0,0,2,1,34,24,86,26,1.2,894.0
8573,8d7ea177efadc718,82e7929bf6c2b689,4f732e58ed907eff,2014-06-07,0,0,0,900,1,0,134,18,134,0,0,0,0,0,28,15,106,18,0.0,896.8
8574,753004dcc9c53eb6,2676b28836a5a836,9b7694d064a8a0ad,2014-06-07,1,2,1,976,3,1,70,11,67,3,1,1,2,2,24,14,43,9,64.9,722.9
8575,753004dcc9c53eb6,9b7694d064a8a0ad,2676b28836a5a836,2014-06-07,0,0,0,976,10,6,77,11,68,9,0,0,9,2,13,7,55,9,80.1,733.1
8576,6ff8fff0fe2a3cd9,5f04e3d58d9ce982,a3be148af5c7b088,2014-06-07,0,0,0,751,1,1,79,15,79,0,0,0,0,0,16,12,63,15,0.0,514.8
8577,6ff8fff0fe2a3cd9,a3be148af5c7b088,5f04e3d58d9ce982,2014-06-07,0,1,1,751,11,4,113,25,89,24,4,3,20,14,39,28,50,11,193.2,421.0
8578,6eee347f75f223f0,3623bd267a2eef2e,de75d1c45a39e221,2014-06-07,0,0,0,900,6,1,114,27,111,3,0,0,3,2,23,16,88,25,60.8,819.0
8579,6eee347f75f223f0,de75d1c45a39e221,3623bd267a2eef2e,2014-06-07,0,0,0,900,0,0,161,28,161,0,0,0,0,0,41,26,120,28,0.0,835.2
8580,6597b770486021b8,5431dccc09118234,fb8a3025ae722e64,2014-06-07,0,0,0,900,7,2,102,43,83,19,0,0,19,17,16,13,67,26,287.0,444.8
8581,6597b770486021b8,fb8a3025ae722e64,5431dccc09118234,2014-06-07,0,0,0,900,1,0,94,19,90,4,0,0,4,1,23,18,67,18,32.2,476.0
8582,5eb07bffdc8b7acf,33e00249ef08d3a4,53ec9cb470e1a4ea,2014-06-07,0,0,0,767,2,0,75,16,74,1,0,0,1,0,40,33,34,16,4.9,377.6
8583,5eb07bffdc8b7acf,53ec9cb470e1a4ea,33e00249ef08d3a4,2014-06-07,1,0,0,767,5,3,83,28,61,22,4,4,18,12,16,14,45,16,241.4,378.1
8584,410e3163827d6d3b,5ef0088c1b19beeb,af62f99eb7606308,2014-06-07,0,2,1,412,4,2,35,5,35,0,0,0,0,0,3,2,32,5,0.0,253.0
8585,410e3163827d6d3b,af62f99eb7606308,5ef0088c1b19beeb,2014-06-07,0,0,0,412,2,1,42,7,42,0,0,0,0,0,7,3,35,7,0.0,319.0
8586,0c2a634606639d71,3a12a2f096a6d975,e51e5cb722bd47a8,2014-06-07,0,0,0,448,0,0,22,3,22,0,0,0,0,0,1,0,21,3,0.0,231.1
8587,0c2a634606639d71,e51e5cb722bd47a8,3a12a2f096a6d975,2014-06-07,1,1,0,448,5,3,55,29,19,36,2,2,34,23,2,1,17,6,216.9,213.0
8588,f9109d1e7c4ff9aa,427b5953ac8e3a27,d06f8869449ba7bd,2014-05-31,1,0,0,900,3,2,73,27,34,39,2,2,37,23,1,0,33,4,488.0,368.0
8589,f9109d1e7c4ff9aa,d06f8869449ba7bd,427b5953ac8e3a27,2014-05-31,0,0,0,900,2,1,43,8,41,2,0,0,2,1,23,14,18,7,44.0,324.0
8590,f132535656f28648,6bd02119599741a4,b57edace7b647f07,2014-05-31,1,1,0,167,2,2,43,23,37,6,0,0,6,6,4,1,33,17,23.2,136.0
8591,f132535656f28648,b57edace7b647f07,6bd02119599741a4,2014-05-31,0,0,0,167,0,0,27,2,27,0,0,0,0,0,6,5,21,2,0.0,127.8
8592,e886e22d31bc96c1,1fcfc3709fe58151,9310418684bc896f,2014-05-31,0,0,0,900,5,3,101,18,93,8,6,6,2,2,26,23,67,16,424.9,422.0
8593,e886e22d31bc96c1,9310418684bc896f,1fcfc3709fe58151,2014-05-31,0,0,0,900,0,0,84,11,84,0,0,0,0,0,15,10,69,11,0.0,475.1
8594,e64310b89b54db3f,aa6e591c2a2cdecd,fb79582c410d049e,2014-05-31,2,1,1,366,0,0,101,27,89,12,0,0,12,9,8,6,81,18,50.0,291.0
8595,e64310b89b54db3f,fb79582c410d049e,aa6e591c2a2cdecd,2014-05-31,0,0,0,366,1,0,52,6,52,0,0,0,0,0,13,11,39,6,0.0,316.0
8596,c556a9d615f11483,40ff198adda94b9f,6c7020b859c7a3ce,2014-05-31,0,0,0,592,2,0,131,22,124,7,1,0,6,5,39,32,85,17,75.6,484.0
8597,c556a9d615f11483,6c7020b859c7a3ce,40ff198adda94b9f,2014-05-31,1,0,0,592,0,0,170,65,170,0,0,0,0,0,21,14,149,65,0.0,516.4
8598,c16b1dc7577fc31c,30a09e43f15f1d75,7a39bbac8cc0fa70,2014-05-31,0,0,0,900,7,1,110,23,110,0,0,0,0,0,24,19,86,23,0.0,846.0
8599,c16b1dc7577fc31c,7a39bbac8cc0fa70,30a09e43f15f1d75,2014-05-31,0,0,0,900,7,1,62,15,62,0,0,0,0,0,17,9,45,15,0.0,660.0
8600,c16454a3205506c6,4bcb6eb12b4ad4aa,52e76bb4b3e852f3,2014-05-31,0,0,0,900,1,0,47,4,41,6,3,3,3,3,29,14,12,1,120.0,431.6
8601,c16454a3205506c6,52e76bb4b3e852f3,4bcb6eb12b4ad4aa,2014-05-31,0,1,0,900,6,5,70,12,55,15,3,1,12,4,6,6,49,8,348.4,269.0
8602,bd0497a410822291,d317a5e2b3f88c5f,d53482bef23235ba,2014-05-31,1,1,1,625,3,2,39,12,23,16,1,1,15,8,9,6,14,4,305.3,167.0
8603,bd0497a410822291,d53482bef23235ba,d317a5e2b3f88c5f,2014-05-31,0,0,0,625,1,0,21,1,21,0,0,0,0,0,10,7,11,1,0.0,314.7
8604,ab27a211bcb9550b,9147679e1a4ad4a3,ab943cd2c3c17825,2014-05-31,0,0,0,20,0,0,4,1,4,0,0,0,0,0,2,2,2,1,0.0,18.9
8605,ab27a211bcb9550b,ab943cd2c3c17825,9147679e1a4ad4a3,2014-05-31,1,0,0,20,0,0,10,3,7,3,0,0,3,2,5,4,2,1,1.1,17.0
8606,a104c62f69ce47de,960d6cae8879ba2b,b71ce838b01f2cad,2014-05-31,0,0,0,900,1,1,126,20,125,1,0,0,1,1,42,31,83,19,17.0,747.0
8607,a104c62f69ce47de,b71ce838b01f2cad,960d6cae8879ba2b,2014-05-31,0,1,0,900,6,2,73,16,73,0,0,0,0,0,24,14,49,16,0.0,779.0
8608,5d7c91acbcddda2f,179f1948dc234f1f,232c582f29f8f65e,2014-05-31,0,0,0,237,6,0,9,2,9,0,0,0,0,0,1,1,8,2,0.0,143.2
8609,5d7c91acbcddda2f,232c582f29f8f65e,179f1948dc234f1f,2014-05-31,0,2,1,237,0,0,29,13,13,16,1,1,15,8,4,4,9,5,81.8,145.0
8610,5b6405eeb6757637,0e21976afc92e4d1,4e06913c91da5200,2014-05-31,0,1,1,599,5,3,31,6,28,3,0,0,3,2,14,11,14,4,105.5,212.0
8611,5b6405eeb6757637,4e06913c91da5200,0e21976afc92e4d1,2014-05-31,0,0,0,599,2,0,25,10,25,0,0,0,0,0,5,5,20,10,0.0,377.5
8612,47bdfab3cdcdddfd,4a1329cc8eb0928a,b6c4451cb13c9303,2014-05-31,1,0,0,900,2,1,117,47,116,1,0,0,1,1,15,13,101,46,24.5,494.2
8613,47bdfab3cdcdddfd,b6c4451cb13c9303,4a1329cc8eb0928a,2014-05-31,0,0,0,900,5,1,116,23,113,3,3,3,0,0,28,18,85,23,258.8,530.5
8614,4041e280dc113323,52ba464d9068d871,b406da701c479076,2014-05-31,0,1,1,861,1,1,172,39,172,0,0,0,0,0,48,26,124,39,0.0,823.0
8615,4041e280dc113323,b406da701c479076,52ba464d9068d871,2014-05-31,0,0,0,861,4,0,139,29,139,0,0,0,0,0,36,25,103,29,0.0,705.0
8616,3618e0e165190576,0d8011111be000b2,172c2135e70f87b7,2014-05-31,0,0,0,900,3,1,161,35,157,4,1,0,3,1,25,13,132,34,23.4,847.0
8617,3618e0e165190576,172c2135e70f87b7,0d8011111be000b2,2014-05-31,0,0,0,900,1,0,187,23,185,2,0,0,2,0,54,21,131,23,12.0,846.6
8618,2baa02e0df86b566,202b0467521c9d6f,369e1ce458ef50a6,2014-05-31,0,0,0,900,9,1,84,20,76,8,0,0,8,5,7,6,69,15,80.0,708.3
8619,2baa02e0df86b566,369e1ce458ef50a6,202b0467521c9d6f,2014-05-31,0,0,0,900,0,0,117,36,116,1,0,0,1,1,14,11,102,35,1.7,815.0
8620,2133f8798f089140,2f95a3c6d58b2aad,8bb6f4479685bbcc,2014-05-31,1,0,0,25,0,0,10,4,6,4,0,0,4,3,2,1,4,1,3.0,22.0
8621,2133f8798f089140,8bb6f4479685bbcc,2f95a3c6d58b2aad,2014-05-31,0,0,0,25,0,0,4,3,4,0,0,0,0,0,1,1,3,3,0.0,22.0
8622,16216dcec4a48768,7ea1f74cef32f906,a20d7dfaba74c067,2014-05-31,1,0,0,900,0,0,161,26,154,7,1,1,6,4,67,36,87,22,29.4,858.0
8623,16216dcec4a48768,a20d7dfaba74c067,7ea1f74cef32f906,2014-05-31,0,0,0,900,4,0,104,14,104,0,0,0,0,0,33,23,71,14,0.0,762.6
8624,0ecbb881c74a63f5,3591d0d5d382a381,5d7bdab5e03e3216,2014-05-31,0,1,0,900,4,1,86,18,86,0,0,0,0,0,18,11,68,18,0.0,637.3
8625,0ecbb881c74a63f5,5d7bdab5e03e3216,3591d0d5d382a381,2014-05-31,1,0,0,900,4,3,79,22,70,9,2,1,7,4,28,21,42,18,176.7,527.0
8626,0b1af005a5f25561,39cc64bf0a269db9,5fceb45939fc0c8a,2014-05-31,0,2,1,255,0,0,12,3,8,4,0,0,4,2,4,2,4,1,26.0,148.8
8627,0b1af005a5f25561,5fceb45939fc0c8a,39cc64bf0a269db9,2014-05-31,0,0,0,255,7,2,11,4,9,2,0,0,2,2,3,3,6,2,67.2,61.0
8628,09f9849d363433a7,1fb80f46d3c105d9,d28dee5c705991df,2014-05-31,0,0,0,35,0,0,8,2,8,0,0,0,0,0,1,0,7,2,0.0,31.0
8629,09f9849d363433a7,d28dee5c705991df,1fb80f46d3c105d9,2014-05-31,1,0,0,35,0,0,14,6,10,4,0,0,4,3,2,2,8,3,4.0,31.0
8630,042fee3d05e105fa,2816ced060a21be3,519e4fe37ce9ff75,2014-05-31,0,0,0,900,6,2,105,42,105,0,0,0,0,0,9,8,96,42,0.0,570.4
8631,042fee3d05e105fa,519e4fe37ce9ff75,2816ced060a21be3,2014-05-31,0,0,0,900,4,0,127,31,122,5,0,0,5,5,27,18,95,26,74.6,721.0
8632,f9a59f7c67fbce01,48e093ea1f43a053,7ea4a9f07df33a45,2014-05-24,1,0,0,900,3,0,135,33,103,32,2,1,30,16,1,1,102,17,463.1,393.7
8633,f9a59f7c67fbce01,7ea4a9f07df33a45,48e093ea1f43a053,2014-05-24,0,1,0,900,4,3,104,31,101,3,0,0,3,2,11,10,90,29,14.3,393.9
8634,ee0075e188e87e86,32be4b7f7de1c905,fc60ecf0671b9489,2014-05-24,0,0,0,900,0,0,59,21,58,1,0,0,1,0,8,4,50,21,7.0,482.3
8635,ee0075e188e87e86,fc60ecf0671b9489,32be4b7f7de1c905,2014-05-24,0,2,0,900,6,4,88,20,86,2,0,0,2,1,12,6,74,19,410.7,277.0
8636,edcb573f1462846e,2c99576fefe53c7c,c849740a3ff51931,2014-05-24,0,0,0,1346,0,0,273,42,273,0,0,0,0,0,47,22,226,42,0.0,1141.6
8637,edcb573f1462846e,c849740a3ff51931,2c99576fefe53c7c,2014-05-24,2,2,0,1346,3,0,309,99,279,30,0,0,30,19,49,41,230,80,204.4,1128.0
8638,c3e3d5ef06a45616,d81ac739417d7f53,f2925e6db404bf1d,2014-05-24,0,0,0,786,3,2,89,22,86,3,0,0,3,2,8,7,78,20,11.5,699.7
8639,c3e3d5ef06a45616,f2925e6db404bf1d,d81ac739417d7f53,2014-05-24,1,0,0,786,1,0,155,57,136,19,1,1,18,11,13,10,123,46,40.3,704.5
8640,b56fd6eb7d0b6083,49f4b511932f71e9,e64b96c07d7ce999,2014-05-24,0,2,0,900,8,3,121,29,112,9,1,1,8,5,20,11,92,24,90.4,543.9
8641,b56fd6eb7d0b6083,e64b96c07d7ce999,49f4b511932f71e9,2014-05-24,0,0,0,900,6,2,156,46,129,27,3,3,24,13,20,12,109,33,145.1,594.6
8642,8d98ccae1057815e,34c2b3656f88f7ef,b8aef0faf4ce9b31,2014-05-24,0,1,0,900,0,0,40,5,32,8,4,4,4,2,13,9,19,3,38.9,321.8
8643,8d98ccae1057815e,b8aef0faf4ce9b31,34c2b3656f88f7ef,2014-05-24,0,1,0,900,8,5,68,28,37,31,3,2,28,19,12,7,25,9,510.2,252.1
8644,4ead27d52c14697a,59279a7c978f7da0,c76ec2bc3a57666a,2014-05-24,0,2,0,357,1,1,19,10,8,11,0,0,11,7,3,3,5,3,271.0,76.0
8645,4ead27d52c14697a,c76ec2bc3a57666a,59279a7c978f7da0,2014-05-24,0,1,1,357,0,0,21,3,20,1,0,0,1,0,9,5,11,3,10.0,76.0
8646,2f6b63e8ec62e3ca,1ccf4e7caff270df,d967f0128c323de6,2014-05-24,0,0,0,833,1,0,18,1,16,2,0,0,2,1,5,5,11,0,1.6,153.0
8647,2f6b63e8ec62e3ca,d967f0128c323de6,1ccf4e7caff270df,2014-05-24,0,2,1,833,3,3,80,35,17,63,16,15,47,31,0,0,17,4,676.0,155.4
8648,1789d630e31e9c77,a8283a4f415e1eb9,c58f51dedb310998,2014-05-24,0,1,0,900,0,0,34,7,34,0,0,0,0,0,7,6,27,7,0.0,395.0
8649,1789d630e31e9c77,c58f51dedb310998,a8283a4f415e1eb9,2014-05-24,0,0,0,900,7,2,70,14,49,21,0,0,21,8,7,5,42,6,505.0,371.0
8650,164eb9071caf3fe8,8f6a18831a120817,a54fc2d6fc224dc3,2014-05-24,1,0,0,300,0,0,51,12,45,6,2,2,4,1,13,8,32,11,75.3,149.3
8651,164eb9071caf3fe8,a54fc2d6fc224dc3,8f6a18831a120817,2014-05-24,0,0,0,300,1,1,30,6,26,4,0,0,4,2,5,1,21,4,12.7,189.7
8652,11d2b546c8533c0f,6bf5a7d3e081ade2,c77a953488e5607d,2014-05-24,0,0,0,900,0,0,77,16,76,1,0,0,1,1,14,8,62,15,1.0,665.4
8653,11d2b546c8533c0f,c77a953488e5607d,6bf5a7d3e081ade2,2014-05-24,0,0,0,900,11,8,113,22,88,25,5,5,20,14,40,30,48,8,228.6,387.0
8654,002c1562708ac307,22a92d7f62195791,44470bfd9483c7ad,2014-05-24,1,1,0,246,2,1,67,35,67,0,0,0,0,0,4,3,63,35,0.0,209.0
8655,002c1562708ac307,44470bfd9483c7ad,22a92d7f62195791,2014-05-24,0,0,0,246,0,0,44,17,44,0,0,0,0,0,7,5,37,17,0.0,223.0
8656,f8cceeabeb2afd4d,31123249b0bbf52e,5866fc86183a9fb8,2014-05-10,1,4,0,731,5,5,166,101,118,48,5,4,43,33,17,13,101,68,113.5,346.2
8657,f8cceeabeb2afd4d,5866fc86183a9fb8,31123249b0bbf52e,2014-05-10,1,1,0,731,3,0,54,17,45,9,1,1,8,8,13,7,32,9,157.8,389.5
8658,d6e4d0d62a96a948,f3a853544e4413c4,ff6a1f63c254127e,2014-05-10,0,0,0,236,5,0,10,1,10,0,0,0,0,0,3,1,7,1,0.0,234.0
8659,d6e4d0d62a96a948,ff6a1f63c254127e,f3a853544e4413c4,2014-05-10,2,0,0,236,0,0,21,6,21,0,0,0,0,0,0,0,21,6,0.0,235.0
8660,9a8fedc4fa968bbd,4ba8d454f762005d,7cdd3e5d3aa9cb39,2014-05-10,0,1,0,900,3,3,83,17,58,25,2,2,23,11,12,9,46,6,327.5,260.0
8661,9a8fedc4fa968bbd,7cdd3e5d3aa9cb39,4ba8d454f762005d,2014-05-10,0,2,0,900,9,1,38,21,23,15,0,0,15,15,2,2,21,6,247.0,325.5
8662,8ea70cfd5d3aa5ee,98aa60cf58071fd6,bffeb123b21c9aad,2014-05-10,1,0,0,900,2,2,147,51,109,38,6,4,32,20,19,10,90,31,150.2,720.0
8663,8ea70cfd5d3aa5ee,bffeb123b21c9aad,98aa60cf58071fd6,2014-05-10,0,2,0,900,2,1,105,16,104,1,0,0,1,0,25,10,79,16,14.0,693.8
8664,7d947be4c15ebe36,b2e3aca4cd363477,d2bc285ead803db0,2014-05-10,0,4,0,900,2,2,124,23,120,4,0,0,4,1,56,41,64,22,13.5,661.8
8665,7d947be4c15ebe36,d2bc285ead803db0,b2e3aca4cd363477,2014-05-10,0,0,0,900,10,1,97,20,88,9,0,0,9,6,27,22,61,14,110.2,433.5
8666,687b9b2c11667531,6fb1ba67bef41b37,cc6f9d1e89f3449a,2014-05-10,0,0,0,900,16,4,99,23,89,10,6,4,4,3,28,25,61,20,126.8,335.2
8667,687b9b2c11667531,cc6f9d1e89f3449a,6fb1ba67bef41b37,2014-05-10,0,1,0,900,2,1,52,20,50,2,0,0,2,0,11,8,39,20,6.8,691.2
8668,4ceadad9c2dd0a87,60029bcf496bd707,7e208569469c8bc8,2014-05-10,1,0,0,140,1,1,7,5,1,6,0,0,6,5,0,0,1,0,101.0,39.0
8669,4ceadad9c2dd0a87,7e208569469c8bc8,60029bcf496bd707,2014-05-10,0,2,0,140,0,0,3,0,3,0,0,0,0,0,2,0,1,0,0.0,33.0
8670,3ee1a3216cf66b95,5f99b2bafb10305f,99bd87a300079ed9,2014-05-10,1,0,0,201,0,0,45,21,22,23,1,1,22,17,8,2,14,4,13.0,188.0
8671,3ee1a3216cf66b95,99bd87a300079ed9,5f99b2bafb10305f,2014-05-10,0,0,0,201,0,0,21,1,21,0,0,0,0,0,7,5,14,1,0.0,188.0
8672,2d14f73c374f2875,05560764359161e4,9450848a71d53776,2014-05-10,1,0,0,227,0,0,44,9,43,1,0,0,1,1,14,6,29,8,15.2,151.0
8673,2d14f73c374f2875,9450848a71d53776,05560764359161e4,2014-05-10,0,0,0,227,0,0,30,8,30,0,0,0,0,0,9,8,21,8,0.0,211.8
8674,2b6c2cdccb2cc659,1ad381c8994c4e5b,9b198c73e3d0d289,2014-05-10,0,0,0,161,0,0,14,2,14,0,0,0,0,0,3,2,11,2,0.0,143.0
8675,2b6c2cdccb2cc659,9b198c73e3d0d289,1ad381c8994c4e5b,2014-05-10,1,0,0,161,6,0,26,10,20,6,2,2,4,4,8,8,12,6,18.0,119.0
8676,289004336bd71d34,06f36cf4bd97ec77,0dba4df5f34d5ff0,2014-05-10,0,0,0,900,4,1,87,22,80,7,0,0,7,6,33,29,47,16,34.6,552.5
8677,289004336bd71d34,0dba4df5f34d5ff0,06f36cf4bd97ec77,2014-05-10,0,0,0,900,6,1,73,15,57,16,1,1,15,7,31,19,26,8,169.5,579.4
8678,23e96ddeb14b5936,528c24b99fbaab79,fc9a9559a05f2704,2014-05-10,1,0,0,277,3,0,20,3,20,0,0,0,0,0,9,8,11,3,0.0,275.0
8679,23e96ddeb14b5936,fc9a9559a05f2704,528c24b99fbaab79,2014-05-10,0,0,0,277,0,0,56,3,56,0,0,0,0,0,3,3,53,3,0.0,277.0
8680,107079f548338ac3,4b47e71384a9522f,84b3e7d38f2d2ec5,2014-05-10,0,1,0,900,4,3,66,18,56,10,2,2,8,5,18,10,38,13,30.0,790.9
8681,107079f548338ac3,84b3e7d38f2d2ec5,4b47e71384a9522f,2014-05-10,0,0,0,900,9,4,77,14,75,2,0,0,2,1,25,15,50,13,49.1,551.0
8682,e4fcad8261083dbf,98f6da59d765ec94,d1e7fc58d4225cdf,2014-04-26,0,0,0,321,4,2,21,3,14,7,6,6,1,1,4,4,10,2,101.1,191.0
8683,e4fcad8261083dbf,d1e7fc58d4225cdf,98f6da59d765ec94,2014-04-26,1,0,0,321,3,0,21,3,21,0,0,0,0,0,15,13,6,3,0.0,161.9
8684,e332aec001b34f50,07f72a2a7591b409,7ff97850e8c32bda,2014-04-26,0,2,0,1500,6,3,236,88,231,5,0,0,5,2,57,50,174,86,32.5,1149.0
8685,e332aec001b34f50,7ff97850e8c32bda,07f72a2a7591b409,2014-04-26,0,0,0,1500,5,0,192,34,192,0,0,0,0,0,38,19,154,34,0.0,1467.5
8686,c3455ba522bb37eb,673ea7dcc786b1b3,a7ddae0be8b78147,2014-04-26,0,0,0,900,0,0,186,50,186,0,0,0,0,0,58,41,128,50,0.0,691.0
8687,c3455ba522bb37eb,a7ddae0be8b78147,673ea7dcc786b1b3,2014-04-26,0,0,0,900,6,1,130,36,130,0,0,0,0,0,22,18,108,36,0.0,888.0
8688,9b10db4499b211b7,00e11b5c8b7bfeeb,c80095f6092271a7,2014-04-26,0,2,1,128,0,0,4,0,1,3,3,3,0,0,1,1,0,0,95.0,33.0
8689,9b10db4499b211b7,c80095f6092271a7,00e11b5c8b7bfeeb,2014-04-26,0,0,0,128,1,0,2,0,2,0,0,0,0,0,2,1,0,0,0.0,29.0
8690,9a1d57966d8a17a4,365fee2da473b177,902ab9197b83d0db,2014-04-26,0,0,0,900,1,0,132,31,127,5,0,0,5,3,19,14,108,28,6.8,874.3
8691,9a1d57966d8a17a4,902ab9197b83d0db,365fee2da473b177,2014-04-26,0,0,0,900,8,0,127,9,125,2,0,0,2,2,32,12,93,7,10.7,861.2
8692,82f00e723ed5f6ea,39330403ad27c2bb,55f446032177b119,2014-04-26,0,0,0,411,3,2,35,6,34,1,0,0,1,0,15,8,19,6,5.1,375.0
8693,82f00e723ed5f6ea,55f446032177b119,39330403ad27c2bb,2014-04-26,1,0,0,411,0,0,49,16,49,0,0,0,0,0,4,3,45,16,0.0,401.9
8694,5b0cc074c657ebd4,150ff4cc642270b9,8fd808923cffff82,2014-04-26,0,2,1,819,0,0,149,31,149,0,0,0,0,0,27,16,122,31,0.0,819.0
8695,5b0cc074c657ebd4,8fd808923cffff82,150ff4cc642270b9,2014-04-26,0,0,0,819,12,3,139,18,139,0,0,0,0,0,40,26,99,18,0.0,627.0
8696,553a788a44b8e794,80eacd4da0617c57,c96d9178c9ed9e62,2014-04-26,0,1,1,248,0,0,23,4,23,0,0,0,0,0,7,5,16,4,0.0,155.0
8697,553a788a44b8e794,c96d9178c9ed9e62,80eacd4da0617c57,2014-04-26,0,0,0,248,3,3,21,10,21,0,0,0,0,0,6,6,15,10,0.0,172.0
8698,484cf23d5110ca04,813550bc53b15fb0,d1941565abf50b16,2014-04-26,0,0,0,198,0,0,27,7,27,0,0,0,0,0,8,2,19,7,0.0,174.0
8699,484cf23d5110ca04,d1941565abf50b16,813550bc53b15fb0,2014-04-26,0,1,1,198,1,0,19,2,19,0,0,0,0,0,5,3,14,2,0.0,169.0
8700,23861a2085ea34a3,3be081c29bf734d9,c295de4e10acd4c9,2014-04-26,0,0,0,900,0,0,240,88,240,0,0,0,0,0,55,42,185,88,0.0,651.6
8701,23861a2085ea34a3,c295de4e10acd4c9,3be081c29bf734d9,2014-04-26,0,0,0,900,2,1,217,61,214,3,3,3,0,0,53,43,161,61,16.4,829.0
8702,f8c9a597f719d75c,47b9e0e7703a4868,50d2f0018bcf9eef,2014-04-19,0,0,0,900,1,1,95,45,94,1,0,0,1,1,27,24,67,44,9.0,703.0
8703,f8c9a597f719d75c,50d2f0018bcf9eef,47b9e0e7703a4868,2014-04-19,0,0,0,900,14,2,100,7,100,0,0,0,0,0,35,25,65,7,0.0,556.0
8704,f5445d367e7dbb2b,0c6d9ea8306c029e,f77c68bb4be8516d,2014-04-19,0,0,0,900,3,0,70,9,70,0,0,0,0,0,18,12,52,9,0.0,803.1
8705,f5445d367e7dbb2b,f77c68bb4be8516d,0c6d9ea8306c029e,2014-04-19,0,0,0,900,12,7,48,14,47,1,0,0,1,1,21,17,26,13,28.9,495.0
8706,e446c5e4a8b8d189,51a0c09cbe9b8472,b96619b3acd7d9da,2014-04-19,0,0,0,900,7,5,34,4,30,4,2,2,2,2,16,12,14,2,141.8,257.9
8707,e446c5e4a8b8d189,b96619b3acd7d9da,51a0c09cbe9b8472,2014-04-19,0,2,0,900,7,1,57,20,42,15,2,2,13,13,14,5,28,7,252.1,405.2
8708,b36362f5db72abee,a4de54ea806fb525,f53c1f4ceeed8c08,2014-04-19,0,2,0,900,8,5,27,9,21,6,0,0,6,5,6,3,15,4,166.2,429.7
8709,b36362f5db72abee,f53c1f4ceeed8c08,a4de54ea806fb525,2014-04-19,0,0,0,900,4,2,80,14,66,14,8,8,6,4,29,24,37,10,110.3,410.8
8710,a9660625bab5d4a3,3236bf606fe9fa5b,492b202d2064e7a9,2014-04-19,0,0,0,1500,1,0,156,36,147,9,0,0,9,9,32,24,115,27,33.2,1391.2
8711,a9660625bab5d4a3,492b202d2064e7a9,3236bf606fe9fa5b,2014-04-19,0,0,0,1500,6,2,196,82,194,2,0,0,2,2,42,39,152,80,60.8,1162.8
8712,a283975bf9355757,2c6e81426dd7573c,d3df1add9d9a7efb,2014-04-19,0,0,0,263,3,1,6,1,3,3,2,2,1,1,2,2,1,0,111.0,52.900000000000006
8713,a283975bf9355757,d3df1add9d9a7efb,2c6e81426dd7573c,2014-04-19,1,0,0,263,1,1,27,22,2,25,0,0,25,20,0,0,2,2,99.1,45.0
8714,9d1722fb8b83a92a,032cc3922d871c7f,6a2f7c151031653d,2014-04-19,0,0,0,900,12,6,97,24,76,21,5,5,16,13,9,7,67,11,493.1,309.8
8715,9d1722fb8b83a92a,6a2f7c151031653d,032cc3922d871c7f,2014-04-19,0,0,0,900,1,0,56,11,55,1,0,0,1,1,17,9,38,10,3.2,393.9
8716,7fe2f0213d641540,0c5c66ddd1886b83,2284092f8b63273b,2014-04-19,1,0,0,44,0,0,26,13,21,5,0,0,5,5,4,3,17,8,1.4,41.0
8717,7fe2f0213d641540,2284092f8b63273b,0c5c66ddd1886b83,2014-04-19,0,0,0,44,0,0,11,1,11,0,0,0,0,0,3,2,8,1,0.0,42.6
8718,73f72edb86c82eef,2aa49b3766a59bcd,575360be653ad6a6,2014-04-19,0,0,0,900,4,4,84,25,73,11,3,2,8,6,20,19,53,19,176.0,664.0
8719,73f72edb86c82eef,575360be653ad6a6,2aa49b3766a59bcd,2014-04-19,0,1,0,900,1,0,93,10,91,2,0,0,2,1,25,11,66,9,44.0,680.0
8720,70e0e57a6755e31e,4bd6b4800070b069,cbd3e590a85b18c5,2014-04-19,0,0,0,900,4,0,85,17,82,3,0,0,3,3,2,2,80,14,23.2,602.8
8721,70e0e57a6755e31e,cbd3e590a85b18c5,4bd6b4800070b069,2014-04-19,0,0,0,900,4,2,90,25,81,9,0,0,9,7,5,2,76,18,204.2,581.8
8722,4e3ccffe18641d9c,1d00756835ca67c9,64a50dad704d1d49,2014-04-19,1,2,1,195,1,0,20,6,20,0,0,0,0,0,5,5,15,6,0.0,174.0
8723,4e3ccffe18641d9c,64a50dad704d1d49,1d00756835ca67c9,2014-04-19,0,0,0,195,0,0,54,17,54,0,0,0,0,0,16,11,38,17,0.0,195.0
8724,3808db1e982cb103,c17041f1bb5768d8,d0a5ef38a7778ac2,2014-04-19,1,0,0,88,0,0,30,12,24,6,0,0,6,6,8,8,16,6,3.0,85.0
8725,3808db1e982cb103,d0a5ef38a7778ac2,c17041f1bb5768d8,2014-04-19,0,0,0,88,0,0,23,5,23,0,0,0,0,0,6,5,17,5,0.0,85.0
8726,220aa11288e919c6,31ee470ef5dc8d7f,fd5b6598a3b70c0a,2014-04-19,0,0,0,900,1,0,236,45,236,0,0,0,0,0,80,71,156,45,0.0,896.0
8727,220aa11288e919c6,fd5b6598a3b70c0a,31ee470ef5dc8d7f,2014-04-19,0,0,0,900,8,0,335,55,335,0,0,0,0,0,52,35,283,55,0.0,853.0
8728,f0b117394e52996b,bc3ec52ef70fc155,cb52f9490c2dc069,2014-04-16,1,0,0,267,1,1,32,12,29,3,0,0,3,3,10,8,19,9,6.9,230.0
8729,f0b117394e52996b,cb52f9490c2dc069,bc3ec52ef70fc155,2014-04-16,0,0,0,267,1,0,25,6,25,0,0,0,0,0,12,9,13,6,0.0,97.1
8730,e532ef88b8cb26d2,303a05a7aa3ff761,d5b7fac960e58920,2014-04-16,0,0,0,900,9,5,122,50,105,17,3,3,14,13,26,18,79,37,151.3,277.0
8731,e532ef88b8cb26d2,d5b7fac960e58920,303a05a7aa3ff761,2014-04-16,0,2,0,900,1,0,49,3,49,0,0,0,0,0,17,9,32,3,0.0,670.7
8732,d2519c169f3039ee,b8592b4a383696cd,c10eb2f12c489f6d,2014-04-16,0,5,0,900,3,2,98,22,86,12,4,4,8,5,24,21,62,17,86.8,635.3
8733,d2519c169f3039ee,c10eb2f12c489f6d,b8592b4a383696cd,2014-04-16,0,0,0,900,10,0,69,12,66,3,0,0,3,0,5,3,61,12,76.7,404.2
8734,a7aac5f6b470ddaa,1971869b7e054261,cf9d24e4bd0cf2ce,2014-04-16,0,0,0,900,2,1,177,43,176,1,0,0,1,1,18,14,158,42,3.4,832.0
8735,a7aac5f6b470ddaa,cf9d24e4bd0cf2ce,1971869b7e054261,2014-04-16,0,0,0,900,13,3,171,45,171,0,0,0,0,0,35,25,136,45,0.0,522.6
8736,3e6b5cb3c37bef3b,029eaff01e6bb8f0,3f52ce18fb98008f,2014-04-16,1,1,0,342,1,0,89,37,87,2,1,1,1,1,10,7,77,36,5.5,298.0
8737,3e6b5cb3c37bef3b,3f52ce18fb98008f,029eaff01e6bb8f0,2014-04-16,0,0,0,342,1,0,66,19,66,0,0,0,0,0,9,5,57,19,0.0,324.5
8738,3a5b53d1123d9f7e,2b93ebd9f5417ad2,3c660c90d48fc80d,2014-04-16,0,0,0,1500,0,0,137,35,137,0,0,0,0,0,9,5,128,35,0.0,986.3
8739,3a5b53d1123d9f7e,3c660c90d48fc80d,2b93ebd9f5417ad2,2014-04-16,0,0,0,1500,11,5,106,32,89,17,1,1,16,8,27,18,62,24,510.7,779.0
8740,3427667c1a265fe5,3c0437fbeda06962,fe91d254db77a7fc,2014-04-16,0,0,0,900,2,2,109,43,61,48,3,2,45,33,11,8,50,10,401.4,351.0
8741,3427667c1a265fe5,fe91d254db77a7fc,3c0437fbeda06962,2014-04-16,0,0,0,900,6,3,31,3,27,4,1,1,3,1,5,3,22,2,64.0,354.6
8742,3406cf3e28e30d1b,501b07aec9b8fc2d,b7ffa72aa148599a,2014-04-16,0,0,0,30,0,0,8,1,8,0,0,0,0,0,5,4,3,1,0.0,27.0
8743,3406cf3e28e30d1b,b7ffa72aa148599a,501b07aec9b8fc2d,2014-04-16,1,0,0,30,0,0,11,3,8,3,0,0,3,2,7,4,1,1,3.0,27.0
8744,2e8d68b14dde981e,36df8e119aec6175,76984112f697631f,2014-04-16,0,0,0,900,1,1,370,106,364,6,2,2,4,4,109,94,255,102,8.6,741.0
8745,2e8d68b14dde981e,76984112f697631f,36df8e119aec6175,2014-04-16,0,0,0,900,5,0,243,50,243,0,0,0,0,0,37,29,206,50,0.0,763.4
8746,273f9520d75f3dac,34f88592c0ab7a54,ec2d13a87d3d9541,2014-04-16,1,0,0,581,3,3,103,57,51,52,3,2,49,39,18,14,33,18,195.2,337.0
8747,273f9520d75f3dac,ec2d13a87d3d9541,34f88592c0ab7a54,2014-04-16,0,0,0,581,4,2,31,9,31,0,0,0,0,0,8,4,23,9,0.0,184.8
8748,1a6e7e7c98886198,7339d340aa2889cb,9fa3bd637edd9aa2,2014-04-16,0,0,0,900,0,0,85,20,75,10,0,0,10,9,43,30,32,11,11.3,577.1
8749,1a6e7e7c98886198,9fa3bd637edd9aa2,7339d340aa2889cb,2014-04-16,0,0,0,900,9,3,61,22,35,26,3,3,23,19,13,8,22,3,296.9,454.7
8750,0dd560fbcae2244f,55ee431411ccf07a,c03a5022f8439f2a,2014-04-16,0,0,0,900,9,2,116,30,116,0,0,0,0,0,20,15,96,30,0.0,833.9
8751,0dd560fbcae2244f,c03a5022f8439f2a,55ee431411ccf07a,2014-04-16,0,0,0,900,0,0,174,30,173,1,1,1,0,0,46,40,127,30,1.1,886.0
8752,01c67a3990800dc3,1e7483dbff40b84b,49858bf46dabf6fb,2014-04-16,0,0,0,900,1,0,32,3,32,0,0,0,0,0,5,1,27,3,0.0,375.6
8753,01c67a3990800dc3,49858bf46dabf6fb,1e7483dbff40b84b,2014-04-16,0,0,0,900,4,4,75,24,35,40,15,14,25,16,17,10,18,8,522.4,260.0
8754,f7fac3df5c6dc91f,f2ad06f1007c481a,fe5a9547479396ab,2014-04-11,0,0,0,900,3,1,101,33,85,16,3,2,13,8,28,23,57,25,67.3,568.9
8755,f7fac3df5c6dc91f,fe5a9547479396ab,f2ad06f1007c481a,2014-04-11,1,0,0,900,5,2,93,20,79,14,1,1,13,9,22,15,57,11,150.1,446.7
8756,f524520a7fe0a8b8,470fedbc8563ac47,91ea901c458e95dd,2014-04-11,0,0,0,900,0,0,15,5,12,3,0,0,3,2,5,5,7,3,3.8,129.29999999999995
8757,f524520a7fe0a8b8,91ea901c458e95dd,470fedbc8563ac47,2014-04-11,0,0,0,900,5,3,51,17,15,36,13,13,23,17,4,4,11,0,765.7,109.2
8758,ceac6997d22f2f3b,94527830000ab715,ffc3e6daaa6da0b7,2014-04-11,0,0,0,39,1,0,8,0,8,0,0,0,0,0,4,3,4,0,0.0,38.0
8759,ceac6997d22f2f3b,ffc3e6daaa6da0b7,94527830000ab715,2014-04-11,0,0,0,39,0,0,6,4,4,2,0,0,2,2,0,0,4,2,1.0,38.0
8760,beed8bc1f800de8f,08af939f41b5a57b,22aa91e402d0fe1f,2014-04-11,0,0,0,260,1,0,20,6,20,0,0,0,0,0,6,3,14,6,0.0,136.3
8761,beed8bc1f800de8f,22aa91e402d0fe1f,08af939f41b5a57b,2014-04-11,2,1,0,260,1,1,51,25,29,22,2,2,20,17,10,7,19,8,93.7,162.0
8762,a523ac02533f8b4d,cfb65863d5099327,f797f0c57a83353e,2014-04-11,1,0,0,45,0,0,8,5,6,2,0,0,2,2,0,0,6,3,4.0,41.0
8763,a523ac02533f8b4d,f797f0c57a83353e,cfb65863d5099327,2014-04-11,0,0,0,45,0,0,10,1,10,0,0,0,0,0,4,2,6,1,0.0,41.0
8764,a2e1e35e4e84e08d,80d918336163b80c,c47df9303d318c67,2014-04-11,0,1,0,900,5,1,51,18,51,0,0,0,0,0,3,1,48,18,0.0,450.1
8765,a2e1e35e4e84e08d,c47df9303d318c67,80d918336163b80c,2014-04-11,1,0,0,900,10,3,68,18,49,19,10,10,9,8,19,19,30,10,283.9,362.0
8766,8c47c4b9503dd5b4,4c7781da8c6cae93,fc31f896cde2bc2e,2014-04-11,0,0,0,900,7,4,97,27,80,17,7,7,10,9,34,30,46,18,211.0,383.9
8767,8c47c4b9503dd5b4,fc31f896cde2bc2e,4c7781da8c6cae93,2014-04-11,1,0,0,900,2,1,53,17,52,1,0,0,1,1,19,18,33,16,7.1,582.0
8768,20d732758337f0a5,3f7c14c7eca7195d,ee9d73f4fee9cbdd,2014-04-11,2,0,0,217,0,0,35,18,34,1,0,0,1,1,2,1,32,17,10.0,207.0
8769,20d732758337f0a5,ee9d73f4fee9cbdd,3f7c14c7eca7195d,2014-04-11,0,0,0,217,0,0,37,12,37,0,0,0,0,0,1,0,36,12,0.0,207.0
8770,fcb3e9f89987d519,8f5c8850b2484173,e51fcd9cd84c0b93,2014-03-23,0,0,0,900,0,0,91,16,86,5,0,0,5,0,12,10,74,16,40.0,670.0
8771,fcb3e9f89987d519,e51fcd9cd84c0b93,8f5c8850b2484173,2014-03-23,1,0,0,900,11,3,67,26,60,7,0,0,7,6,9,9,51,20,150.0,560.0
8772,eae8d2c30c0bb499,5d7bdab5e03e3216,dbc17725b887860a,2014-03-23,1,0,0,39,0,0,16,12,7,9,0,0,9,7,0,0,7,5,8.0,31.0
8773,eae8d2c30c0bb499,dbc17725b887860a,5d7bdab5e03e3216,2014-03-23,0,0,0,39,0,0,8,3,8,0,0,0,0,0,0,0,8,3,0.0,31.0
8774,a5827bfce19e63ea,0b64d0fed453ef7f,b102c26727306ab6,2014-03-23,0,0,0,187,0,0,24,5,24,0,0,0,0,0,1,1,23,5,0.0,164.5
8775,a5827bfce19e63ea,b102c26727306ab6,0b64d0fed453ef7f,2014-03-23,0,1,1,187,4,1,23,7,21,2,0,0,2,1,3,2,18,6,22.5,142.0
8776,995f0dcdcd5fe43c,b71ce838b01f2cad,d188a3b817860ec6,2014-03-23,1,0,0,77,0,0,8,3,8,0,0,0,0,0,0,0,8,3,0.0,76.0
8777,995f0dcdcd5fe43c,d188a3b817860ec6,b71ce838b01f2cad,2014-03-23,0,0,0,77,0,0,22,5,21,1,0,0,1,1,10,6,11,4,0.0,77.0
8778,98cea844501261a9,1fb80f46d3c105d9,fcd448a2fe1a23cc,2014-03-23,0,0,0,900,0,0,217,100,215,2,0,0,2,1,49,32,166,99,4.2,681.3
8779,98cea844501261a9,fcd448a2fe1a23cc,1fb80f46d3c105d9,2014-03-23,0,0,0,900,12,3,92,13,76,16,10,10,6,2,14,10,62,11,197.7,549.8
8780,981e2f5a8e46a1f1,140745cbbcb023ac,1ccf4e7caff270df,2014-03-23,2,0,0,691,2,1,96,31,76,20,0,0,20,13,22,17,54,18,164.0,483.7
8781,981e2f5a8e46a1f1,1ccf4e7caff270df,140745cbbcb023ac,2014-03-23,1,0,0,691,2,0,60,16,56,4,0,0,4,4,9,7,47,12,2.3,519.0
8782,8f120352072bd5ed,9f755fb04cc21499,fa37628269132d1a,2014-03-23,0,0,0,159,2,0,22,5,22,0,0,0,0,0,9,6,13,5,0.0,152.0
8783,8f120352072bd5ed,fa37628269132d1a,9f755fb04cc21499,2014-03-23,1,0,0,159,0,0,23,4,22,1,0,0,1,0,2,1,20,4,3.0,141.0
8784,8e87b33bea7c5da9,523f6ad11dbe9b53,b69f24c500d783e7,2014-03-23,0,0,0,900,8,1,77,21,65,12,0,0,12,8,26,23,39,13,145.7,469.3
8785,8e87b33bea7c5da9,b69f24c500d783e7,523f6ad11dbe9b53,2014-03-23,0,0,0,900,8,3,67,11,57,10,3,2,7,4,29,23,28,7,78.7,573.3
8786,671048cd1933855a,14ff46596ad80609,9c65736747ca92ec,2014-03-23,0,0,0,900,8,0,124,21,124,0,0,0,0,0,30,16,94,21,0.0,389.0
8787,671048cd1933855a,9c65736747ca92ec,14ff46596ad80609,2014-03-23,0,0,0,900,5,0,73,14,73,0,0,0,0,0,17,12,56,14,0.0,894.0
8788,5464d7ccb4177464,6e0273f9478be71e,c1a5d3843596df92,2014-03-23,0,1,1,105,1,1,14,8,4,10,0,0,10,6,1,1,3,2,63.0,42.0
8789,5464d7ccb4177464,c1a5d3843596df92,6e0273f9478be71e,2014-03-23,0,0,0,105,1,1,1,0,1,0,0,0,0,0,0,0,1,0,0.0,12.0
8790,283c0b3b7e425252,bd21a1e3d41c97ee,dea070ed4a2a8281,2014-03-23,0,0,0,53,0,0,1,0,1,0,0,0,0,0,0,0,1,0,0.0,39.0
8791,283c0b3b7e425252,dea070ed4a2a8281,bd21a1e3d41c97ee,2014-03-23,1,0,0,53,0,0,16,6,5,11,0,0,11,6,2,1,3,0,14.0,39.0
8792,d4d4aded862ace46,08e908ed6d18d6a0,82e7929bf6c2b689,2014-03-15,0,0,0,900,3,3,119,35,113,6,1,1,5,3,14,10,99,32,140.2,700.8
8793,d4d4aded862ace46,82e7929bf6c2b689,08e908ed6d18d6a0,2014-03-15,0,2,0,900,0,0,93,10,92,1,0,0,1,1,29,15,63,9,12.2,710.8
8794,cdf58f62e289efec,0941df56f6ac954b,f2925e6db404bf1d,2014-03-15,0,0,0,1500,10,2,397,111,395,2,2,2,0,0,52,45,343,111,17.7,1252.0
8795,cdf58f62e289efec,f2925e6db404bf1d,0941df56f6ac954b,2014-03-15,0,0,0,1500,0,0,331,141,331,0,0,0,0,0,11,9,320,141,0.0,1482.3
8796,ba38b96f39db78c0,effd9de9937996f8,f9f07bb5a43535ed,2014-03-15,1,0,0,420,3,3,29,10,29,0,0,0,0,0,6,4,23,10,0.0,237.0
8797,ba38b96f39db78c0,f9f07bb5a43535ed,effd9de9937996f8,2014-03-15,0,1,0,420,0,0,43,6,43,0,0,0,0,0,11,7,32,6,0.0,417.0
8798,a5f39e8ff1398269,a2b12c3f3d60ff69,ab850a77a0fa487d,2014-03-15,1,0,0,900,11,8,135,53,133,2,0,0,2,0,9,8,124,53,24.8,627.0
8799,a5f39e8ff1398269,ab850a77a0fa487d,a2b12c3f3d60ff69,2014-03-15,0,0,0,900,0,0,160,42,160,0,0,0,0,0,28,16,132,42,0.0,852.2
8800,99170b2f2496e479,6a1901c62ab3870f,fc169c387b4b465d,2014-03-15,0,0,0,900,8,3,158,47,155,3,1,0,2,1,24,19,131,46,21.1,507.1
8801,99170b2f2496e479,fc169c387b4b465d,6a1901c62ab3870f,2014-03-15,0,2,0,900,3,2,167,51,158,9,0,0,9,7,33,31,125,44,12.9,798.9
8802,8f979d206eaec468,0d8011111be000b2,5cafbc97dba2e797,2014-03-15,0,1,1,273,2,1,35,17,18,17,0,0,17,11,6,3,12,6,138.7,118.0
8803,8f979d206eaec468,5cafbc97dba2e797,0d8011111be000b2,2014-03-15,0,0,0,273,1,1,10,1,10,0,0,0,0,0,5,3,5,1,0.0,108.30000000000001
8804,639013929b61e834,6f242453c91a5af0,893d51aaf024eddd,2014-03-15,3,1,0,777,15,6,126,31,91,35,0,0,35,15,30,24,61,16,199.3,307.6
8805,639013929b61e834,893d51aaf024eddd,6f242453c91a5af0,2014-03-15,0,0,0,777,4,0,64,16,63,1,0,0,1,1,24,18,39,15,2.4,490.7
8806,56b57d076f874eb0,5b5307450405abf0,8c0580d4fff106c1,2014-03-15,1,0,0,900,1,0,163,26,160,3,0,0,3,1,30,19,130,25,28.0,750.1
8807,56b57d076f874eb0,8c0580d4fff106c1,5b5307450405abf0,2014-03-15,0,0,0,900,2,1,137,45,135,2,0,0,2,2,17,14,118,43,9.9,783.0
8808,543dca66a449d9d5,1dafccb62a0f98ec,361d49960a196976,2014-03-15,0,0,0,900,14,5,50,14,45,5,1,1,4,2,15,11,30,12,145.3,381.2
8809,543dca66a449d9d5,361d49960a196976,1dafccb62a0f98ec,2014-03-15,0,3,0,900,5,1,44,7,34,10,7,7,3,2,12,10,22,5,53.8,684.7
8810,427a10db0406cfba,db1f2ed63b54b9a7,fe435e440b5de0ff,2014-03-15,0,0,0,900,5,5,56,20,43,13,1,1,12,7,9,6,34,13,208.0,452.0
8811,427a10db0406cfba,fe435e440b5de0ff,db1f2ed63b54b9a7,2014-03-15,0,1,0,900,7,0,72,2,72,0,0,0,0,0,17,2,55,2,0.0,692.0
8812,364ed6aecfc8d16d,44bc27bfa76dcd9e,97a6bbe6e6566a94,2014-03-15,0,0,0,900,9,5,70,11,69,1,0,0,1,1,9,3,60,10,19.5,589.0
8813,364ed6aecfc8d16d,97a6bbe6e6566a94,44bc27bfa76dcd9e,2014-03-15,0,0,0,900,7,2,116,29,109,7,1,1,6,3,37,17,72,26,38.0,717.5
8814,2d050cb1f7d8789a,1091d4d957141094,50db8711c70196cd,2014-03-15,0,0,0,89,0,0,4,0,4,0,0,0,0,0,4,1,0,0,0.0,89.0
8815,2d050cb1f7d8789a,50db8711c70196cd,1091d4d957141094,2014-03-15,0,1,1,89,1,1,1,0,1,0,0,0,0,0,1,1,0,0,0.0,28.0
8816,0175c0d2a98576f1,901cddcbfa079097,9fa568ad2bf2cb0b,2014-03-15,0,1,0,900,0,0,41,3,39,2,0,0,2,0,5,1,34,3,0.0,380.70000000000005
8817,0175c0d2a98576f1,9fa568ad2bf2cb0b,901cddcbfa079097,2014-03-15,0,0,0,900,10,6,103,50,55,48,3,2,45,35,12,9,43,15,519.3,305.0
8818,b5be58e7fa1e7439,49a74b9fb2e45fdf,c945adc22c2bfe8f,2014-03-08,0,0,0,900,1,0,114,41,114,0,0,0,0,0,14,6,100,41,0.0,662.4
8819,b5be58e7fa1e7439,c945adc22c2bfe8f,49a74b9fb2e45fdf,2014-03-08,0,1,0,900,8,4,141,27,123,18,1,1,17,3,24,21,99,24,237.6,438.0
8820,742fcd610f344810,1e1dbd1cc5a7469e,3c6976f8182d9527,2014-03-08,0,0,0,378,0,0,23,4,23,0,0,0,0,0,9,9,14,4,0.0,293.4
8821,742fcd610f344810,3c6976f8182d9527,1e1dbd1cc5a7469e,2014-03-08,1,0,0,378,2,1,43,16,38,5,0,0,5,4,7,5,31,12,84.6,175.0
8822,73f55778c5c55c2f,511e82663651438d,ccd1299e0345e0ce,2014-03-08,0,0,0,900,4,1,146,16,146,0,0,0,0,0,53,32,93,16,0.0,826.0
8823,73f55778c5c55c2f,ccd1299e0345e0ce,511e82663651438d,2014-03-08,0,0,0,900,1,0,103,15,102,1,0,0,1,1,23,7,79,14,0.0,900.0
8824,6242126d8d06a7ca,43563a32c3f10e95,e9a3aeb207578eea,2014-03-08,0,0,0,182,0,0,0,0,0,0,0,0,0,0,0,0,0,0,0.0,182.0
8825,6242126d8d06a7ca,e9a3aeb207578eea,43563a32c3f10e95,2014-03-08,0,2,1,182,1,1,0,0,0,0,0,0,0,0,0,0,0,0,0.0,73.0
8826,54845ec0646a9bee,c06d554ce1713fd3,dbea8c1cb327ab3d,2014-03-08,0,5,0,900,1,0,34,9,20,14,0,0,14,7,11,9,9,2,154.0,178.70000000000005
8827,54845ec0646a9bee,dbea8c1cb327ab3d,c06d554ce1713fd3,2014-03-08,0,1,0,900,3,0,37,7,11,26,5,2,21,7,3,3,8,0,512.3,214.0
8828,4911fcfb1b28faa5,34e552520a934063,6f7c616b98e18c29,2014-03-08,0,0,0,900,0,0,75,26,75,0,0,0,0,0,15,15,60,26,0.0,726.0
8829,4911fcfb1b28faa5,6f7c616b98e18c29,34e552520a934063,2014-03-08,0,0,0,900,15,3,73,23,71,2,0,0,2,2,18,13,53,21,106.0,582.0
8830,443791a8c6790cf0,b72a60a0cadff408,ba043b03eb799063,2014-03-08,0,1,0,73,0,0,4,1,4,0,0,0,0,0,1,1,3,1,0.0,68.0
8831,443791a8c6790cf0,ba043b03eb799063,b72a60a0cadff408,2014-03-08,0,0,0,73,2,0,4,2,4,0,0,0,0,0,1,1,3,2,0.0,32.0
8832,406154260435c65a,172c2135e70f87b7,a9bcf8717dd12532,2014-03-08,1,0,0,264,0,0,117,32,117,0,0,0,0,0,17,13,100,32,0.0,263.0
8833,406154260435c65a,a9bcf8717dd12532,172c2135e70f87b7,2014-03-08,0,0,0,264,0,0,56,15,56,0,0,0,0,0,12,10,44,15,0.0,262.0
8834,0b3c3d363c82835f,16690d100f995f8f,fd55393021a8c255,2014-03-08,0,0,0,276,0,0,16,1,16,0,0,0,0,0,7,5,9,1,0.0,89.0
8835,0b3c3d363c82835f,fd55393021a8c255,16690d100f995f8f,2014-03-08,0,1,1,276,1,1,20,15,2,18,0,0,18,14,1,1,1,1,185.0,91.0
8836,e38d7761a92e1bf9,28f3c2258a1d8874,9bcf8603ceb25680,2014-03-01,0,0,0,662,6,1,97,13,91,6,0,0,6,2,28,14,63,11,58.7,357.1
8837,e38d7761a92e1bf9,9bcf8603ceb25680,28f3c2258a1d8874,2014-03-01,2,0,0,662,3,1,81,22,58,23,1,1,22,7,4,4,54,15,79.9,471.3
8838,c53a5dca56870ea5,a00ec21cfbba17b6,c4af2feb4b58bc3b,2014-03-01,3,0,0,900,1,1,130,63,94,36,0,0,36,23,19,14,75,40,111.4,416.1
8839,c53a5dca56870ea5,c4af2feb4b58bc3b,a00ec21cfbba17b6,2014-03-01,0,0,0,900,7,3,55,28,39,16,1,1,15,13,2,2,37,15,189.9,325.6
8840,82448697e7a44028,ba280572acfba13f,ca2efc9d7d523c43,2014-03-01,1,0,0,299,0,0,62,20,62,0,0,0,0,0,5,4,57,20,0.0,278.0
8841,82448697e7a44028,ca2efc9d7d523c43,ba280572acfba13f,2014-03-01,0,0,0,299,2,0,46,8,46,0,0,0,0,0,8,7,38,8,0.0,272.0
8842,57ab45aa1ebd087e,5755960ebd0b16f6,ef7fa30364cbe7f2,2014-03-01,1,1,0,900,1,0,85,14,80,5,0,0,5,2,28,13,52,12,27.2,771.3
8843,57ab45aa1ebd087e,ef7fa30364cbe7f2,5755960ebd0b16f6,2014-03-01,0,2,0,900,6,4,86,12,85,1,0,0,1,1,28,17,57,11,30.7,534.8
8844,3fa2e753afa0bdbb,80dbeb1dd5b53e64,8bb6f4479685bbcc,2014-03-01,0,0,0,900,5,0,189,11,189,0,0,0,0,0,31,13,158,11,0.0,887.0
8845,3fa2e753afa0bdbb,8bb6f4479685bbcc,80dbeb1dd5b53e64,2014-03-01,0,0,0,900,1,0,311,72,311,0,0,0,0,0,114,70,197,72,0.0,899.0
8846,36d4e8f650539bf0,69e8c632135af48b,d8d7b24d276c8cb0,2014-03-01,1,0,0,300,0,0,45,10,45,0,0,0,0,0,8,3,37,10,0.0,268.0
8847,36d4e8f650539bf0,d8d7b24d276c8cb0,69e8c632135af48b,2014-03-01,0,0,0,300,1,0,12,4,12,0,0,0,0,0,2,1,10,4,0.0,294.0
8848,2ebe2ae9b4812f0a,1ed32eaaba9ffe10,40ff198adda94b9f,2014-03-01,0,2,0,900,9,1,34,6,32,2,0,0,2,2,6,6,26,4,5.0,590.5
8849,2ebe2ae9b4812f0a,40ff198adda94b9f,1ed32eaaba9ffe10,2014-03-01,0,0,0,900,10,4,88,22,70,18,12,10,6,5,21,17,49,17,259.5,275.0
8850,0fea1cff62e26b46,7b310409440c9102,efb9a43415a56d34,2014-03-01,0,2,0,900,10,4,25,4,23,2,0,0,2,1,10,6,13,3,139.3,416.1
8851,0fea1cff62e26b46,efb9a43415a56d34,7b310409440c9102,2014-03-01,0,0,0,900,0,0,79,14,58,21,6,3,15,7,26,14,32,7,274.9,328.7
8852,faaa7340f4ede814,2f13e4020cea5b38,6bd02119599741a4,2014-02-22,0,0,0,900,3,3,206,73,188,18,0,0,18,12,36,27,152,61,101.5,776.0
8853,faaa7340f4ede814,6bd02119599741a4,2f13e4020cea5b38,2014-02-22,0,1,0,900,1,0,100,6,100,0,0,0,0,0,44,27,56,6,0.0,798.5
8854,dc28c6e66f333d2a,15b1b21cd743d652,99bd87a300079ed9,2014-02-22,0,0,0,84,0,0,6,0,6,0,0,0,0,0,3,1,3,0,0.0,60.0
8855,dc28c6e66f333d2a,99bd87a300079ed9,15b1b21cd743d652,2014-02-22,1,0,0,84,0,0,27,19,6,21,0,0,21,16,0,0,6,3,24.0,60.0
8856,b1a033020bd6d3f3,d967f0128c323de6,e51e5cb722bd47a8,2014-02-22,1,0,0,79,0,0,37,16,24,13,0,0,13,9,2,2,22,7,6.2,70.0
8857,b1a033020bd6d3f3,e51e5cb722bd47a8,d967f0128c323de6,2014-02-22,0,0,0,79,3,0,22,5,22,0,0,0,0,0,4,3,18,5,0.0,72.8
8858,ab0d6346b7938a7f,4a28cb716c19157a,e1147d3d2dabe1ce,2014-02-22,1,0,0,223,0,0,80,28,72,8,0,0,8,7,17,10,55,21,3.7,216.0
8859,ab0d6346b7938a7f,e1147d3d2dabe1ce,4a28cb716c19157a,2014-02-22,0,0,0,223,0,0,66,17,66,0,0,0,0,0,2,2,64,17,0.0,219.3
8860,9988ff4d4197663b,8f2939f5fd9cca1e,f5990c11974d8e9c,2014-02-22,0,1,0,843,4,0,89,21,89,0,0,0,0,0,19,17,70,21,0.0,594.0
8861,9988ff4d4197663b,f5990c11974d8e9c,8f2939f5fd9cca1e,2014-02-22,1,1,0,843,4,4,101,44,78,23,1,1,22,20,13,11,65,24,103.0,646.0
8862,654127f5b9140be2,7be74a12d7352df2,8bdac25ce0bb874d,2014-02-22,0,0,0,66,0,0,20,8,20,0,0,0,0,0,6,5,14,8,0.0,66.0
8863,654127f5b9140be2,8bdac25ce0bb874d,7be74a12d7352df2,2014-02-22,1,0,0,66,0,0,23,4,23,0,0,0,0,0,11,10,12,4,0.0,22.0
8864,41727d51af72b1d5,700a674c042b7a96,cb696ebfb6598724,2014-02-22,0,1,0,900,6,4,53,9,49,4,0,0,4,2,17,9,32,7,28.3,585.5
8865,41727d51af72b1d5,cb696ebfb6598724,700a674c042b7a96,2014-02-22,0,3,0,900,5,3,89,23,76,13,1,1,12,9,31,22,45,14,123.5,396.7
8866,36630b8c820db52b,4c2d90e335e6df19,f72465a784c1b084,2014-02-22,0,0,0,900,3,2,113,25,105,8,0,0,8,6,49,28,56,19,106.2,608.0
8867,36630b8c820db52b,f72465a784c1b084,4c2d90e335e6df19,2014-02-22,0,0,0,900,0,0,111,39,111,0,0,0,0,0,14,8,97,39,0.0,724.8
8868,328ae84bf2af537e,3e61082025db8137,b406da701c479076,2014-02-22,0,0,0,900,1,0,83,13,83,0,0,0,0,0,19,13,64,13,0.0,763.7
8869,328ae84bf2af537e,b406da701c479076,3e61082025db8137,2014-02-22,0,0,0,900,2,2,62,13,60,2,0,0,2,1,23,15,37,12,90.3,629.0
8870,29657325bfc1d590,427b5953ac8e3a27,cbd5d3cdd862e90e,2014-02-22,0,0,0,900,22,2,120,37,95,25,6,6,19,15,11,8,84,22,301.0,594.3
8871,29657325bfc1d590,cbd5d3cdd862e90e,427b5953ac8e3a27,2014-02-22,0,0,0,900,0,0,213,62,209,4,0,0,4,1,16,13,193,61,4.7,592.0
8872,1a8b815679bc89b8,57ab4d7c0bc09a30,f65dcb22dada2223,2014-02-22,0,0,0,900,7,5,66,20,58,8,0,0,8,7,16,14,42,13,261.6,543.0
8873,1a8b815679bc89b8,f65dcb22dada2223,57ab4d7c0bc09a30,2014-02-22,0,0,0,900,0,0,67,7,62,5,1,1,4,2,17,11,45,5,30.0,548.4
8874,ffbc12e4f821ec68,3591d0d5d382a381,7a703c565ccaa18f,2014-02-15,0,0,0,900,1,0,71,14,71,0,0,0,0,0,12,5,59,14,0.0,495.2
8875,ffbc12e4f821ec68,7a703c565ccaa18f,3591d0d5d382a381,2014-02-15,0,3,0,900,4,2,47,10,38,9,0,0,9,6,8,6,30,4,390.8,379.0
8876,ea60fdcfd423a15e,5580771f383e141f,a8283a4f415e1eb9,2014-02-15,0,0,0,900,2,0,126,21,126,0,0,0,0,0,44,32,82,21,0.0,815.7
8877,ea60fdcfd423a15e,a8283a4f415e1eb9,5580771f383e141f,2014-02-15,0,0,0,900,4,1,148,23,139,9,9,9,0,0,29,23,110,23,48.3,782.0
8878,dadde3eb4e5f43b4,276c60b14b571dd4,5866fc86183a9fb8,2014-02-15,0,0,0,52,2,0,0,0,0,0,0,0,0,0,0,0,0,0,0.0,51.1
8879,dadde3eb4e5f43b4,5866fc86183a9fb8,276c60b14b571dd4,2014-02-15,1,0,0,52,0,0,18,14,4,14,1,1,13,13,3,3,1,1,0.9,51.0
8880,d0e084b6345c5af0,8b5f9ea38184ded3,d221ee27afc7a60e,2014-02-15,0,0,0,900,5,2,103,36,88,15,0,0,15,11,17,9,71,25,255.5,300.2
8881,d0e084b6345c5af0,d221ee27afc7a60e,8b5f9ea38184ded3,2014-02-15,1,0,0,900,2,1,69,17,48,21,2,1,19,10,10,6,38,7,122.8,492.5
8882,cfefbf79340d3346,a36556bb1565e32d,ff4c3ab594c7fac3,2014-02-15,0,1,0,900,0,0,174,55,173,1,0,0,1,0,17,12,156,55,2.3,832.1
8883,cfefbf79340d3346,ff4c3ab594c7fac3,a36556bb1565e32d,2014-02-15,0,1,0,900,10,1,100,12,98,2,0,0,2,1,35,14,63,11,26.9,695.7
8884,b96e1222eb1a0faf,07225ba28ae309b6,b6c4451cb13c9303,2014-02-15,0,2,1,760,8,3,43,9,35,8,5,4,3,3,10,10,25,6,128.3,265.5
8885,b96e1222eb1a0faf,b6c4451cb13c9303,07225ba28ae309b6,2014-02-15,0,0,0,760,2,1,49,16,42,7,1,1,6,3,6,4,36,13,125.5,362.7
8886,aa11f2375ee2118f,232c582f29f8f65e,f7a7f7118d4b01b6,2014-02-15,0,0,0,1500,3,0,106,19,98,8,2,1,6,4,24,16,74,15,51.0,1255.5
8887,aa11f2375ee2118f,f7a7f7118d4b01b6,232c582f29f8f65e,2014-02-15,0,0,0,1500,2,1,101,16,98,3,0,0,3,3,26,12,72,13,142.5,1259.0
8888,8619c3cde7dd4e15,4a1329cc8eb0928a,71002dbc1743b9a7,2014-02-15,0,0,0,900,6,3,108,15,103,5,1,0,4,1,40,29,63,14,34.0,642.1
8889,8619c3cde7dd4e15,71002dbc1743b9a7,4a1329cc8eb0928a,2014-02-15,1,1,0,900,3,1,97,24,88,9,6,3,3,1,19,12,69,23,46.9,689.0
8890,816119e4d9d983b1,3a314d9fa7c6825d,aceffa19749c4dc0,2014-02-15,0,0,0,900,0,0,97,13,97,0,0,0,0,0,27,14,70,13,0.0,882.4
8891,816119e4d9d983b1,aceffa19749c4dc0,3a314d9fa7c6825d,2014-02-15,0,0,0,900,6,3,95,25,86,9,0,0,9,2,17,10,69,23,17.6,857.0
8892,496a169f4c9becec,7c6e87729e824ef4,ff6a1f63c254127e,2014-02-15,0,0,0,900,7,4,87,31,67,20,2,1,18,12,24,18,43,19,183.4,471.0
8893,496a169f4c9becec,ff6a1f63c254127e,7c6e87729e824ef4,2014-02-15,0,0,0,900,1,1,71,27,43,28,2,1,26,13,5,4,38,14,108.0,581.6
8894,420114bb94080b3c,19db7ac26308178f,a20d7dfaba74c067,2014-02-15,0,1,0,900,9,0,159,42,159,0,0,0,0,0,31,21,128,42,0.0,777.4
8895,420114bb94080b3c,a20d7dfaba74c067,19db7ac26308178f,2014-02-15,0,1,0,900,1,1,170,56,165,5,0,0,5,3,19,12,146,53,4.6,889.0
8896,01d4d1d8bcb014cf,2f95a3c6d58b2aad,5aedf14771ca82d2,2014-02-15,1,0,0,900,3,2,76,38,39,37,1,1,36,23,6,3,33,15,195.6,342.6
8897,01d4d1d8bcb014cf,5aedf14771ca82d2,2f95a3c6d58b2aad,2014-02-15,0,0,0,900,7,3,61,16,42,19,2,1,17,10,12,6,30,6,335.4,298.4
8898,fe936088ec4dcb0d,a54fc2d6fc224dc3,e14b5aa06eea9653,2014-02-01,0,1,0,452,0,0,96,34,92,4,0,0,4,2,4,2,88,32,15.0,302.0
8899,fe936088ec4dcb0d,e14b5aa06eea9653,a54fc2d6fc224dc3,2014-02-01,1,0,0,452,3,0,79,17,79,0,0,0,0,0,4,1,75,17,0.0,428.0
8900,c145e4b6206d4c18,6809c31286b08d97,f8fe2053d73d7bcf,2014-02-01,0,0,0,900,0,0,149,20,146,3,0,0,3,2,43,30,103,18,1.0,770.5
8901,c145e4b6206d4c18,f8fe2053d73d7bcf,6809c31286b08d97,2014-02-01,0,0,0,900,11,5,75,16,68,7,7,7,0,0,10,8,58,16,125.5,648.0
8902,bc9dd73e0a982c08,5331b25a60417ffb,7ea1f74cef32f906,2014-02-01,0,1,0,900,8,1,42,2,42,0,0,0,0,0,16,16,26,2,0.0,528.9
8903,bc9dd73e0a982c08,7ea1f74cef32f906,5331b25a60417ffb,2014-02-01,0,1,0,900,0,0,73,8,72,1,0,0,1,1,47,38,25,7,9.1,772.0
8904,b9be2e52d02886e2,c21a036b4e012f1c,cd7763bcadb5d4c8,2014-02-01,0,0,0,900,0,0,129,30,129,0,0,0,0,0,52,31,77,30,0.0,899.0
8905,b9be2e52d02886e2,cd7763bcadb5d4c8,c21a036b4e012f1c,2014-02-01,0,0,0,900,11,2,134,23,134,0,0,0,0,0,31,17,103,23,0.0,800.0
8906,b705fb146638d859,8a9c6c4301f6d088,b2e3aca4cd363477,2014-02-01,0,0,0,900,14,5,110,18,109,1,0,0,1,0,25,15,84,18,22.6,449.0
8907,b705fb146638d859,b2e3aca4cd363477,8a9c6c4301f6d088,2014-02-01,0,0,0,900,0,0,203,51,195,8,3,3,5,3,30,19,165,48,0.0,877.4
8908,b51163f358495b41,59279a7c978f7da0,ee9ebceabfd16fa7,2014-02-01,1,1,0,900,1,0,122,41,120,2,0,0,2,2,16,8,104,39,108.0,583.7
8909,b51163f358495b41,ee9ebceabfd16fa7,59279a7c978f7da0,2014-02-01,0,2,0,900,8,1,142,32,127,15,2,1,13,10,9,6,118,22,208.3,542.0
8910,a851348faa460c2d,3dd92ff9fb0412b3,c268b2cfebccf652,2014-02-01,0,1,0,900,12,6,92,30,62,30,4,3,26,15,16,16,46,15,281.5,452.3
8911,a851348faa460c2d,c268b2cfebccf652,3dd92ff9fb0412b3,2014-02-01,0,2,0,900,0,0,54,5,47,7,5,4,2,2,23,18,24,3,6.7,597.5
8912,a3b37f8ea171b962,3974fa35c917af1d,d0f3959b4a9747e6,2014-02-01,0,0,0,1500,6,1,146,17,125,21,0,0,21,8,54,24,71,9,184.5,1176.2
8913,a3b37f8ea171b962,d0f3959b4a9747e6,3974fa35c917af1d,2014-02-01,0,2,0,1500,2,2,119,29,117,2,0,0,2,0,46,33,71,29,77.8,1004.5
8914,7a91b26b3e231fff,7a39bbac8cc0fa70,84b3e7d38f2d2ec5,2014-02-01,0,0,0,900,8,2,76,12,74,2,2,2,0,0,26,20,48,12,38.9,764.0
8915,7a91b26b3e231fff,84b3e7d38f2d2ec5,7a39bbac8cc0fa70,2014-02-01,0,0,0,900,7,1,218,47,218,0,0,0,0,0,33,24,185,47,0.0,698.1
8916,651bdd9e17a58c5d,1ff9589f9065a9ed,b4ad3a06ee4d660c,2014-02-01,0,1,0,900,3,1,23,0,23,0,0,0,0,0,6,3,17,0,0.0,410.6
8917,651bdd9e17a58c5d,b4ad3a06ee4d660c,1ff9589f9065a9ed,2014-02-01,1,0,0,900,0,0,74,40,26,48,12,12,36,30,10,10,16,10,460.4,382.0
8918,4c9047d1c1bc1e29,2c99576fefe53c7c,78114b7199cef90c,2014-02-01,1,0,0,222,0,0,46,13,41,5,0,0,5,2,8,4,33,11,4.1,208.0
8919,4c9047d1c1bc1e29,78114b7199cef90c,2c99576fefe53c7c,2014-02-01,0,0,0,222,2,0,31,3,31,0,0,0,0,0,9,5,22,3,0.0,217.9
8920,131732f248cd2829,92b62174c175ce19,993d385f5a475375,2014-02-01,1,0,0,900,3,2,200,51,195,5,0,0,5,3,25,21,170,48,50.7,829.0
8921,131732f248cd2829,993d385f5a475375,92b62174c175ce19,2014-02-01,0,0,0,900,1,0,225,45,224,1,0,0,1,0,30,24,194,45,0.0,849.3
8922,ea0f7fe570c1533f,6c7e25571490aa3b,b7ad576b8ae115e6,2014-01-25,0,0,0,900,14,2,177,29,176,1,0,0,1,0,49,32,127,29,8.4,799.0
8923,ea0f7fe570c1533f,b7ad576b8ae115e6,6c7e25571490aa3b,2014-01-25,0,1,0,900,4,2,105,26,105,0,0,0,0,0,34,25,71,26,0.0,739.6
8924,e53c8a20819f9be6,03f982ca3735070c,1091d4d957141094,2014-01-25,0,0,0,25,0,0,5,0,5,0,0,0,0,0,1,1,4,0,0.0,22.0
8925,e53c8a20819f9be6,1091d4d957141094,03f982ca3735070c,2014-01-25,1,0,0,25,0,0,16,5,11,5,0,0,5,3,7,6,4,2,3.0,22.0
8926,df7cf7ef41eccbe6,915c8d39d4a0e7d1,f95381efb3051d81,2014-01-25,0,0,0,900,0,0,144,34,144,0,0,0,0,0,9,6,135,34,0.0,898.4
8927,df7cf7ef41eccbe6,f95381efb3051d81,915c8d39d4a0e7d1,2014-01-25,1,0,0,900,0,0,234,56,232,2,0,0,2,0,37,23,195,56,1.6,896.0
8928,ca8e482388e7ac82,1d00756835ca67c9,7dcf06c1967801c1,2014-01-25,1,0,0,280,1,1,37,2,37,0,0,0,0,0,23,14,14,2,0.0,274.0
8929,ca8e482388e7ac82,7dcf06c1967801c1,1d00756835ca67c9,2014-01-25,0,0,0,280,0,0,29,11,29,0,0,0,0,0,3,2,26,11,0.0,280.0
8930,97ad3419f2029ba1,b4eeac608fc82f88,fc9a9559a05f2704,2014-01-25,0,0,0,556,0,0,109,20,109,0,0,0,0,0,25,13,84,20,0.0,489.2
8931,97ad3419f2029ba1,fc9a9559a05f2704,b4eeac608fc82f88,2014-01-25,1,0,0,556,1,0,138,42,89,49,0,0,49,27,17,12,72,15,66.8,481.0
8932,80cb366cd1e54aec,32be4b7f7de1c905,3623bd267a2eef2e,2014-01-25,0,1,0,900,3,2,35,10,27,8,0,0,8,6,3,2,24,4,543.0,357.0
8933,80cb366cd1e54aec,3623bd267a2eef2e,32be4b7f7de1c905,2014-01-25,0,0,0,900,3,1,35,2,35,0,0,0,0,0,18,10,17,2,0.0,154.0
8934,7fda79ba69b06c0b,2676b28836a5a836,a566371ba2ad7152,2014-01-25,0,1,0,1500,4,4,91,16,90,1,0,0,1,1,42,30,48,15,16.7,1052.5
8935,7fda79ba69b06c0b,a566371ba2ad7152,2676b28836a5a836,2014-01-25,0,0,0,1500,11,4,58,5,53,5,0,0,5,0,25,14,28,5,147.5,1011.3
8936,77d82e8a220053ea,270b89c00ef0c55c,d28dee5c705991df,2014-01-25,0,0,0,900,6,1,82,17,82,0,0,0,0,0,24,12,58,17,0.0,774.2
8937,77d82e8a220053ea,d28dee5c705991df,270b89c00ef0c55c,2014-01-25,0,0,0,900,1,1,187,48,158,29,3,3,26,14,15,12,143,34,120.8,775.0
8938,6fdcd1caa0e9d239,18968f97ad34f15c,92a9aa9c93192871,2014-01-25,0,0,0,900,1,1,117,26,114,3,0,0,3,2,27,14,87,24,68.0,832.0
8939,6fdcd1caa0e9d239,92a9aa9c93192871,18968f97ad34f15c,2014-01-25,0,4,0,900,9,0,137,14,137,0,0,0,0,0,15,7,122,14,0.0,758.0
8940,6a7f68feb5c0755d,7aa3d6964eff4877,de75d1c45a39e221,2014-01-25,1,1,1,879,1,1,164,31,160,4,0,0,4,2,43,22,117,29,53.1,781.7
8941,6a7f68feb5c0755d,de75d1c45a39e221,7aa3d6964eff4877,2014-01-25,0,0,0,879,2,1,177,36,176,1,0,0,1,0,25,13,151,36,4.3,812.9
8942,3f1d1bd33a296f26,5f99b2bafb10305f,af90b10c785ced3e,2014-01-25,2,1,0,596,1,1,104,32,102,2,0,0,2,1,18,14,84,31,5.1,510.0
8943,3f1d1bd33a296f26,af90b10c785ced3e,5f99b2bafb10305f,2014-01-25,0,1,0,596,2,0,38,7,38,0,0,0,0,0,6,3,32,7,0.0,588.9
8944,fac335e6aeff29f5,282fa667ff9c51ed,b8aef0faf4ce9b31,2014-01-15,1,1,1,414,0,0,91,27,90,1,0,0,1,1,17,11,73,26,8.3,389.0
8945,fac335e6aeff29f5,b8aef0faf4ce9b31,282fa667ff9c51ed,2014-01-15,0,0,0,414,2,0,56,5,56,0,0,0,0,0,9,9,47,5,0.0,405.7
8946,eea06604a47ea9a8,92437c6775b3f7d1,f53c1f4ceeed8c08,2014-01-15,0,1,0,900,2,0,95,25,81,14,0,0,14,14,29,18,52,11,48.8,589.6
8947,eea06604a47ea9a8,f53c1f4ceeed8c08,92437c6775b3f7d1,2014-01-15,0,0,0,900,10,2,83,22,67,16,3,2,13,9,16,11,51,13,202.4,421.2
8948,c2f70bd2fc1bac73,d2bc285ead803db0,e18a19001a3f7c7d,2014-01-15,0,1,0,900,1,0,245,70,206,39,0,0,39,18,33,22,173,52,54.7,737.6
8949,c2f70bd2fc1bac73,e18a19001a3f7c7d,d2bc285ead803db0,2014-01-15,0,0,0,900,14,9,193,44,185,8,2,1,6,2,29,15,156,42,61.4,630.3
8950,bbb810f50d60b31a,22aa91e402d0fe1f,e56daf7725a0b5ab,2014-01-15,0,1,0,900,7,5,113,36,98,15,0,0,15,8,18,10,80,28,142.5,614.1
8951,bbb810f50d60b31a,e56daf7725a0b5ab,22aa91e402d0fe1f,2014-01-15,0,1,0,900,0,0,76,20,73,3,0,0,3,2,11,5,62,18,0.9,751.5
8952,94608c62dd497366,36fbaa49a09ff997,f797f0c57a83353e,2014-01-15,0,0,0,900,1,1,83,20,83,0,0,0,0,0,12,10,71,20,0.0,767.2
8953,94608c62dd497366,f797f0c57a83353e,36fbaa49a09ff997,2014-01-15,0,1,0,900,8,1,122,27,112,10,0,0,10,6,35,30,77,21,43.8,808.0
8954,8d6392d59e1ca099,0c6d9ea8306c029e,9450848a71d53776,2014-01-15,0,0,0,900,9,2,112,19,112,0,0,0,0,0,48,26,64,19,0.0,709.0
8955,8d6392d59e1ca099,9450848a71d53776,0c6d9ea8306c029e,2014-01-15,0,0,0,900,0,0,113,28,113,0,0,0,0,0,17,11,96,28,0.0,858.0
8956,7e3609b672c7ecf9,b1a3e0aca758b322,f77c68bb4be8516d,2014-01-15,0,0,0,803,5,3,94,20,88,6,0,0,6,2,26,18,62,18,105.6,586.1
8957,7e3609b672c7ecf9,f77c68bb4be8516d,b1a3e0aca758b322,2014-01-15,1,0,0,803,4,0,94,27,67,27,6,5,21,18,34,28,33,9,40.9,644.4
8958,6f3e189c393c0e09,08af939f41b5a57b,98f6da59d765ec94,2014-01-15,1,1,1,105,0,0,21,8,13,8,0,0,8,6,4,1,9,2,38.2,62.0
8959,6f3e189c393c0e09,98f6da59d765ec94,08af939f41b5a57b,2014-01-15,0,0,0,105,1,0,9,2,9,0,0,0,0,0,3,3,6,2,0.0,66.8
8960,55139052f4641670,bc7230f231701d66,c849740a3ff51931,2014-01-15,0,0,0,900,2,0,111,14,111,0,0,0,0,0,42,32,69,14,0.0,833.1
8961,55139052f4641670,c849740a3ff51931,bc7230f231701d66,2014-01-15,0,0,0,900,5,2,232,70,216,16,1,1,15,9,51,46,165,61,66.9,603.0
8962,3b8b70b448b0c604,52ba464d9068d871,c295de4e10acd4c9,2014-01-15,1,0,0,900,4,4,133,52,103,30,4,3,26,18,29,26,74,34,377.2,221.0
8963,3b8b70b448b0c604,c295de4e10acd4c9,52ba464d9068d871,2014-01-15,0,0,0,900,1,0,59,13,58,1,0,0,1,1,11,8,47,12,0.0,522.8
8964,1143d37503a9527d,129537073431e52e,c77a953488e5607d,2014-01-15,0,2,0,900,0,0,72,16,53,19,5,5,14,8,29,23,24,8,19.5,440.2
8965,1143d37503a9527d,c77a953488e5607d,129537073431e52e,2014-01-15,0,1,0,900,12,8,81,20,54,27,5,5,22,12,20,19,34,8,419.8,227.5
8966,0f3e6876516edeaf,00e11b5c8b7bfeeb,05560764359161e4,2014-01-15,1,0,0,151,0,0,19,4,18,1,1,1,0,0,7,7,11,4,4.0,135.0
8967,0f3e6876516edeaf,05560764359161e4,00e11b5c8b7bfeeb,2014-01-15,0,0,0,151,0,0,19,1,19,0,0,0,0,0,4,3,15,1,0.0,147.0
8968,f7bd56e197bab2a6,d1e1fdcea7c8a90a,f50d95223751e6ca,2014-01-04,0,1,0,599,10,2,54,12,51,3,0,0,3,3,9,5,42,9,38.6,343.9
8969,f7bd56e197bab2a6,f50d95223751e6ca,d1e1fdcea7c8a90a,2014-01-04,0,1,1,599,0,0,86,38,60,26,2,2,24,18,3,3,57,20,165.1,306.4
8970,eb82e95ab678f8bc,0d0351c20169a499,fe91d254db77a7fc,2014-01-04,1,0,0,133,1,1,29,9,15,14,0,0,14,3,1,0,14,6,73.1,39.0
8971,eb82e95ab678f8bc,fe91d254db77a7fc,0d0351c20169a499,2014-01-04,0,1,1,133,1,0,9,1,9,0,0,0,0,0,1,0,8,1,0.0,59.900000000000006
8972,e2bb4b8ce5ada2a8,0876d21328cf4a45,b9c03e7a4557e542,2014-01-04,0,2,0,900,0,0,36,15,23,13,1,1,12,11,12,9,11,4,3.4,143.5
8973,e2bb4b8ce5ada2a8,b9c03e7a4557e542,0876d21328cf4a45,2014-01-04,0,0,0,900,7,6,12,7,3,9,0,0,9,7,1,1,2,0,751.5,61.6
8974,ab8722d48a5a447e,16af2d5a6f28bee2,44470bfd9483c7ad,2014-01-04,0,0,0,900,9,0,63,11,62,1,0,0,1,0,18,5,44,11,0.2,671.3
8975,ab8722d48a5a447e,44470bfd9483c7ad,16af2d5a6f28bee2,2014-01-04,0,0,0,900,4,3,48,16,43,5,0,0,5,3,10,7,33,13,227.7,398.8
8976,74edd53297a084b9,2153a7f8396a46cc,71df36d6d8cf0d74,2014-01-04,0,0,0,177,0,0,18,5,18,0,0,0,0,0,5,5,13,5,0.0,177.0
8977,74edd53297a084b9,71df36d6d8cf0d74,2153a7f8396a46cc,2014-01-04,0,0,0,177,3,0,23,9,23,0,0,0,0,0,4,3,19,9,0.0,120.0
8978,4b69545737f1902a,150ff4cc642270b9,db5dc7cb80d7d418,2014-01-04,2,0,0,447,0,0,139,58,134,5,0,0,5,3,20,16,114,55,1.2,431.0
8979,4b69545737f1902a,db5dc7cb80d7d418,150ff4cc642270b9,2014-01-04,0,0,0,447,5,0,121,23,121,0,0,0,0,0,17,10,104,23,0.0,384.8
8980,3ff7d02ef633ee22,0749d968e932df53,203c957eac95dd87,2014-01-04,3,1,0,1500,3,1,202,60,195,7,5,5,2,1,70,55,125,59,294.8,1106.8
8981,3ff7d02ef633ee22,203c957eac95dd87,0749d968e932df53,2014-01-04,0,1,0,1500,0,0,277,92,274,3,0,0,3,2,38,30,236,90,14.2,1186.2
8982,221cb15141299346,10657c60ce349e0f,a7897d200692ab64,2014-01-04,0,0,0,833,6,0,6,0,6,0,0,0,0,0,5,2,1,0,0.0,235.89999999999998
8983,221cb15141299346,a7897d200692ab64,10657c60ce349e0f,2014-01-04,0,4,1,833,2,2,94,59,23,71,1,1,70,56,7,5,16,3,488.1,338.0
8984,181429d8227794cb,8f5c8850b2484173,9a2d3567abc02e34,2014-01-04,0,0,0,900,7,5,87,10,80,7,1,1,6,3,34,22,46,7,80.2,667.4
8985,181429d8227794cb,9a2d3567abc02e34,8f5c8850b2484173,2014-01-04,0,0,0,900,1,0,66,19,62,4,0,0,4,4,10,7,52,15,3.6,811.8
8986,07d1d120dab41893,80d918336163b80c,bd5403efbaa445c0,2014-01-04,0,1,1,350,12,3,36,30,10,26,1,1,25,25,1,1,9,5,248.0,98.5
8987,07d1d120dab41893,bd5403efbaa445c0,80d918336163b80c,2014-01-04,0,0,0,350,0,0,26,14,20,6,0,0,6,6,5,5,15,8,3.5,95.0
8988,f1a9c3187855155c,5f87a5c00b3d17ed,cc6f9d1e89f3449a,2013-12-28,0,0,0,900,2,2,130,28,111,19,0,0,19,14,33,26,78,14,225.5,410.7
8989,f1a9c3187855155c,cc6f9d1e89f3449a,5f87a5c00b3d17ed,2013-12-28,0,0,0,900,3,3,46,12,30,16,0,0,16,7,5,2,25,5,133.3,499.5
8990,b1fd21231f0604e1,511e82663651438d,75e5fec9f72910ef,2013-12-28,1,0,0,392,0,0,85,12,82,3,0,0,3,2,20,10,62,10,1.5,390.0
8991,b1fd21231f0604e1,75e5fec9f72910ef,511e82663651438d,2013-12-28,0,0,0,392,2,0,63,10,63,0,0,0,0,0,4,2,59,10,0.0,331.5
8992,a6e494c82d136172,aec185309b4843d0,fc31f896cde2bc2e,2013-12-28,0,0,0,900,2,1,120,21,120,0,0,0,0,0,37,23,83,21,0.0,724.1
8993,a6e494c82d136172,fc31f896cde2bc2e,aec185309b4843d0,2013-12-28,0,0,0,900,15,3,89,28,80,9,1,1,8,6,23,18,57,22,61.9,549.0
8994,a060b6b0dfe275b7,3236bf606fe9fa5b,ad3f53c454cbbead,2013-12-28,1,0,0,60,0,0,19,12,13,6,0,0,6,6,0,0,13,6,0.0,60.0
8995,a060b6b0dfe275b7,ad3f53c454cbbead,3236bf606fe9fa5b,2013-12-28,0,0,0,60,1,0,7,2,7,0,0,0,0,0,3,3,4,2,0.0,50.0
8996,5e4f358e0bcc2f15,029eaff01e6bb8f0,c2e3e67b5911bfb7,2013-12-28,1,0,0,294,0,0,87,27,77,10,0,0,10,6,22,17,55,21,10.0,258.6
8997,5e4f358e0bcc2f15,c2e3e67b5911bfb7,029eaff01e6bb8f0,2013-12-28,0,0,0,294,2,1,48,10,47,1,0,0,1,1,12,6,35,9,2.4,272.0
8998,49c0071ae52fc83a,ed74afc8b5b47a61,fb8a3025ae722e64,2013-12-28,0,0,0,900,6,3,210,90,208,2,0,0,2,1,46,43,162,89,2.9,832.0
8999,49c0071ae52fc83a,fb8a3025ae722e64,ed74afc8b5b47a61,2013-12-28,0,0,0,900,2,0,240,43,240,0,0,0,0,0,27,18,213,43,0.0,897.1
9000,39be68189f2d5074,7abe471b61725980,d1941565abf50b16,2013-12-28,0,0,0,222,0,0,23,6,21,2,0,0,2,0,5,5,16,6,39.0,141.0
9001,39be68189f2d5074,d1941565abf50b16,7abe471b61725980,2013-12-28,0,1,1,222,1,1,25,3,24,1,0,0,1,0,4,3,20,3,3.0,171.0
9002,315968a74789600a,8bdac25ce0bb874d,b96619b3acd7d9da,2013-12-28,0,3,1,658,8,6,63,24,45,18,2,2,16,14,15,14,30,10,195.7,227.7
9003,315968a74789600a,b96619b3acd7d9da,8bdac25ce0bb874d,2013-12-28,0,0,0,658,3,1,50,20,49,1,0,0,1,1,5,4,44,19,6.3,343.3
9004,2a17686c6b5f334e,1f454354805b6f75,3a8176e15b9887c1,2013-12-28,0,0,0,376,0,0,15,2,13,2,0,0,2,2,8,6,5,0,0.0,129.0
9005,2a17686c6b5f334e,3a8176e15b9887c1,1f454354805b6f75,2013-12-28,1,1,0,376,1,1,44,18,11,33,0,0,33,17,3,2,8,1,247.0,114.0
9006,27635cc4d9fcac98,960d6cae8879ba2b,d0a5ef38a7778ac2,2013-12-28,1,0,0,612,2,2,68,10,63,5,1,0,4,2,26,24,37,8,44.0,324.1
9007,27635cc4d9fcac98,d0a5ef38a7778ac2,960d6cae8879ba2b,2013-12-28,0,0,0,612,1,1,65,13,49,16,3,2,13,7,21,17,28,6,102.9,343.0
9008,11706648d34ff3e8,65578a75fa7900e3,d43a048a880efdff,2013-12-28,1,0,0,300,0,0,46,15,40,6,0,0,6,3,9,5,31,12,4.5,294.0
9009,11706648d34ff3e8,d43a048a880efdff,65578a75fa7900e3,2013-12-28,0,0,0,300,0,0,33,1,33,0,0,0,0,0,16,10,17,1,0.0,295.5
9010,f5fb4435faf1ca04,50d2f0018bcf9eef,887961364be5ceb3,2013-12-14,0,0,0,900,9,2,227,45,212,15,5,3,10,6,34,11,178,39,99.1,690.0
9011,f5fb4435faf1ca04,887961364be5ceb3,50d2f0018bcf9eef,2013-12-14,0,0,0,900,6,3,138,68,136,2,0,0,2,2,19,12,117,66,25.0,650.9
9012,e6663b2c16df6191,80eacd4da0617c57,8a304bfd6bf04a57,2013-12-14,0,0,0,128,0,0,27,1,27,0,0,0,0,0,7,3,20,1,0.0,126.0
9013,e6663b2c16df6191,8a304bfd6bf04a57,80eacd4da0617c57,2013-12-14,1,0,0,128,1,0,14,5,10,4,0,0,4,4,3,2,7,1,2.0,126.0
9014,c1d2ce95229cdbd9,4c7781da8c6cae93,523fa774700d7d3f,2013-12-14,0,1,0,900,7,4,206,40,201,5,0,0,5,3,55,28,146,37,10.5,794.6
9015,c1d2ce95229cdbd9,523fa774700d7d3f,4c7781da8c6cae93,2013-12-14,0,2,0,900,6,4,187,31,181,6,0,0,6,4,45,23,136,27,46.4,742.5
9016,a5c76ead1a2767b6,64a50dad704d1d49,d1e7fc58d4225cdf,2013-12-14,1,1,0,900,1,0,123,16,109,14,2,2,12,6,37,25,72,10,53.0,666.5
9017,a5c76ead1a2767b6,d1e7fc58d4225cdf,64a50dad704d1d49,2013-12-14,0,1,0,900,10,1,125,53,74,51,0,0,51,27,5,2,69,26,180.5,663.0
9018,631f0721b3fc56dc,6fb1ba67bef41b37,b5b684eac99ae0a3,2013-12-14,0,0,0,900,3,0,119,27,117,2,0,0,2,2,20,13,97,25,1.2,789.0
9019,631f0721b3fc56dc,b5b684eac99ae0a3,6fb1ba67bef41b37,2013-12-14,0,1,0,900,10,7,70,24,67,3,0,0,3,1,14,11,53,23,105.0,583.8
9020,5ffccdf4af20dc0d,0b64d0fed453ef7f,57ab4d7c0bc09a30,2013-12-14,0,1,0,900,5,1,81,19,79,2,0,0,2,2,15,12,64,17,31.9,565.5
9021,5ffccdf4af20dc0d,57ab4d7c0bc09a30,0b64d0fed453ef7f,2013-12-14,0,1,0,900,17,6,81,17,79,2,0,0,2,1,17,9,62,16,79.5,709.1
9022,5929c539190c8a07,501b07aec9b8fc2d,7be63795363029e8,2013-12-14,0,1,0,900,2,1,189,17,183,6,1,1,5,2,68,36,115,15,30.0,834.2
9023,5929c539190c8a07,7be63795363029e8,501b07aec9b8fc2d,2013-12-14,0,0,0,900,13,1,90,23,89,1,0,0,1,1,10,8,79,22,20.8,766.0
9024,4618dcef2dc6250f,3b9f723e2720a238,e14b5aa06eea9653,2013-12-14,0,0,0,395,1,0,33,2,33,0,0,0,0,0,11,7,22,2,0.0,272.1
9025,4618dcef2dc6250f,e14b5aa06eea9653,3b9f723e2720a238,2013-12-14,1,0,0,395,6,5,64,29,45,19,6,6,13,11,10,8,35,18,80.9,263.0
9026,319d75c21fbb5d3f,3bad7ef643840f67,86f582852a5b240a,2013-12-14,0,2,0,900,3,3,75,33,41,34,6,6,28,27,5,4,36,6,314.3,467.8
9027,319d75c21fbb5d3f,86f582852a5b240a,3bad7ef643840f67,2013-12-14,0,0,0,900,1,0,92,34,90,2,0,0,2,1,20,18,70,33,16.2,431.7
9028,0f215b143e08f425,6546af7ab545b90c,e18a19001a3f7c7d,2013-12-14,0,0,0,900,10,2,71,17,66,5,1,1,4,4,21,15,45,13,45.0,506.3
9029,0f215b143e08f425,e18a19001a3f7c7d,6546af7ab545b90c,2013-12-14,0,0,0,900,3,3,116,14,100,16,4,1,12,2,20,12,80,12,321.7,473.0
9030,00566b4d89565373,78114b7199cef90c,d0314416a7f26527,2013-12-14,1,1,1,502,2,1,46,20,39,7,0,0,7,7,11,9,28,13,153.1,327.0
9031,00566b4d89565373,d0314416a7f26527,78114b7199cef90c,2013-12-14,0,0,0,502,0,0,27,6,27,0,0,0,0,0,3,3,24,6,0.0,345.9
9032,fe52c91f751e8db6,8349d55cdecd393a,eef9b891edbd4604,2013-12-06,1,0,0,1500,4,0,186,60,163,23,2,1,21,13,44,36,119,47,75.2,1037.4
9033,fe52c91f751e8db6,eef9b891edbd4604,8349d55cdecd393a,2013-12-06,1,0,0,1500,5,2,175,95,164,11,0,0,11,10,8,8,156,85,305.6,1035.8
9034,e982a2648d69fda6,0c5c66ddd1886b83,b13da0b1a3aed3e7,2013-12-06,0,0,0,900,2,0,63,13,62,1,0,0,1,1,26,19,36,12,31.3,556.0
9035,e982a2648d69fda6,b13da0b1a3aed3e7,0c5c66ddd1886b83,2013-12-06,0,1,0,900,6,3,64,10,64,0,0,0,0,0,23,20,41,10,0.0,697.7
9036,e14b4f2c7b36d0b9,54578e5927adea53,9fa568ad2bf2cb0b,2013-12-06,0,0,0,283,0,0,7,1,7,0,0,0,0,0,2,1,5,1,0.0,80.9
9037,e14b4f2c7b36d0b9,9fa568ad2bf2cb0b,54578e5927adea53,2013-12-06,1,0,0,283,3,2,37,22,14,23,2,2,21,17,4,3,10,5,202.1,37.0
9038,bfc321f0b0a7bf40,4b4753d19489297f,c0ab242c40decc55,2013-12-06,0,0,0,900,2,0,37,6,37,0,0,0,0,0,3,3,34,6,0.0,206.79999999999995
9039,bfc321f0b0a7bf40,c0ab242c40decc55,4b4753d19489297f,2013-12-06,0,0,0,900,3,3,100,64,32,68,3,2,65,53,5,4,27,11,693.2,166.0
9040,b951f2d4080ef172,48e093ea1f43a053,80dbeb1dd5b53e64,2013-12-06,0,0,0,900,8,3,402,117,400,2,0,0,2,1,44,35,356,116,17.6,777.0
9041,b951f2d4080ef172,80dbeb1dd5b53e64,48e093ea1f43a053,2013-12-06,0,0,0,900,0,0,287,77,287,0,0,0,0,0,29,23,258,77,0.0,882.4
9042,b568f3700aa2c1f7,140745cbbcb023ac,f5431394fb284bb9,2013-12-06,1,0,0,63,0,0,12,4,11,1,0,0,1,1,5,5,6,3,3.0,60.0
9043,b568f3700aa2c1f7,f5431394fb284bb9,140745cbbcb023ac,2013-12-06,0,0,0,63,0,0,7,1,7,0,0,0,0,0,3,0,4,1,0.0,60.0
9044,adc1b34f6988bd68,00debc804e2b1cd4,92b62174c175ce19,2013-12-06,0,0,0,600,4,2,31,6,31,0,0,0,0,0,11,7,20,6,0.0,349.0
9045,adc1b34f6988bd68,92b62174c175ce19,00debc804e2b1cd4,2013-12-06,1,0,0,600,1,1,58,19,53,5,1,1,4,4,8,7,45,15,105.0,390.0
9046,678eb77df5589eac,4e06913c91da5200,da1d8d76404bb6b5,2013-12-06,0,0,0,900,4,1,46,8,46,0,0,0,0,0,11,9,35,8,0.0,662.0
9047,678eb77df5589eac,da1d8d76404bb6b5,4e06913c91da5200,2013-12-06,0,1,0,900,12,1,24,3,24,0,0,0,0,0,12,9,12,3,0.0,602.0
9048,45e6eec6b35d7dfe,60029bcf496bd707,658c3465581ae46b,2013-12-06,1,0,0,129,1,1,14,10,3,11,2,2,9,9,0,0,3,1,85.0,44.0
9049,45e6eec6b35d7dfe,658c3465581ae46b,60029bcf496bd707,2013-12-06,0,0,0,129,0,0,3,0,3,0,0,0,0,0,2,1,1,0,0.0,44.0
9050,39efb868dbe7e311,673ea7dcc786b1b3,981ab7a0576f76a0,2013-12-06,0,0,0,900,4,1,118,28,118,0,0,0,0,0,47,37,71,28,0.0,704.0
9051,39efb868dbe7e311,981ab7a0576f76a0,673ea7dcc786b1b3,2013-12-06,0,0,0,900,0,0,186,31,186,0,0,0,0,0,30,23,156,31,0.0,896.0
9052,2389557cfa02df78,1ad381c8994c4e5b,a2b12c3f3d60ff69,2013-12-06,0,0,0,43,1,0,3,1,3,0,0,0,0,0,1,0,2,1,0.0,41.0
9053,2389557cfa02df78,a2b12c3f3d60ff69,1ad381c8994c4e5b,2013-12-06,1,0,0,43,0,0,15,9,14,1,0,0,1,1,0,0,14,8,2.0,41.0
9054,fca7fbd0bafc480c,3253b16d38ae087d,ffdeb4fbea09ce75,2013-11-30,1,0,0,299,2,2,76,32,6,70,0,0,70,32,2,1,4,0,259.6,32.0
9055,fca7fbd0bafc480c,ffdeb4fbea09ce75,3253b16d38ae087d,2013-11-30,0,0,0,299,0,0,5,2,5,0,0,0,0,0,3,2,2,2,0.0,37.39999999999998
9056,f0815638f558968d,7d96bc577e5178b2,8355922d564b152c,2013-11-30,0,0,0,158,2,1,15,3,13,2,0,0,2,1,2,2,11,2,32.7,109.0
9057,f0815638f558968d,8355922d564b152c,7d96bc577e5178b2,2013-11-30,1,0,0,158,1,0,55,28,55,0,0,0,0,0,6,5,49,28,0.0,119.3
9058,e9ec16e4e7cfb120,5fceb45939fc0c8a,94527830000ab715,2013-11-30,0,0,0,900,6,4,27,7,10,17,6,5,11,7,5,5,5,0,488.5,239.5
9059,e9ec16e4e7cfb120,94527830000ab715,5fceb45939fc0c8a,2013-11-30,0,4,0,900,3,2,33,12,27,6,0,0,6,6,3,3,24,6,114.5,201.5
9060,c9ebbba18e4e1e84,20999e27ddd94bda,f65dcb22dada2223,2013-11-30,0,1,0,571,0,0,63,15,59,4,0,0,4,2,9,3,50,13,141.0,195.7
9061,c9ebbba18e4e1e84,f65dcb22dada2223,20999e27ddd94bda,2013-11-30,0,5,1,571,2,2,64,20,50,14,2,1,12,6,12,7,38,14,234.3,179.0
9062,b186f4778257ca6d,3f52ce18fb98008f,4a1329cc8eb0928a,2013-11-30,0,0,0,25,0,0,2,1,2,0,0,0,0,0,0,0,2,1,0.0,20.3
9063,b186f4778257ca6d,4a1329cc8eb0928a,3f52ce18fb98008f,2013-11-30,0,0,0,25,1,1,7,5,6,1,0,0,1,1,0,0,6,4,4.7,11.0
9064,a072ec605bebe5a8,113df4fde64735c6,fc60ecf0671b9489,2013-11-30,0,0,0,430,3,0,44,4,44,0,0,0,0,0,23,14,21,4,0.0,382.1
9065,a072ec605bebe5a8,fc60ecf0671b9489,113df4fde64735c6,2013-11-30,0,1,1,430,2,1,50,7,48,2,0,0,2,0,13,8,35,7,28.9,199.0
9066,64e1197b8d5d0706,519e4fe37ce9ff75,ab850a77a0fa487d,2013-11-30,0,0,0,900,11,0,226,34,226,0,0,0,0,0,39,27,187,34,0.0,716.0
9067,64e1197b8d5d0706,ab850a77a0fa487d,519e4fe37ce9ff75,2013-11-30,0,0,0,900,1,0,270,70,270,0,0,0,0,0,44,35,226,70,0.0,848.0
9068,2b5058614b56a898,03f982ca3735070c,91ea901c458e95dd,2013-11-30,2,0,0,900,1,0,71,8,71,0,0,0,0,0,18,10,53,8,0.0,681.4
9069,2b5058614b56a898,91ea901c458e95dd,03f982ca3735070c,2013-11-30,0,0,0,900,2,1,105,23,89,16,2,1,14,7,14,9,75,16,214.6,672.0
9070,2a940fac11da404d,4498b382c65a7faa,fc169c387b4b465d,2013-11-30,0,0,0,900,7,0,194,22,194,0,0,0,0,0,39,20,155,22,0.0,616.1
9071,2a940fac11da404d,fc169c387b4b465d,4498b382c65a7faa,2013-11-30,0,1,0,900,1,1,133,57,109,24,8,5,16,14,20,18,89,43,182.9,618.0
9072,1b7bc992c26ac10f,92b36014314b028b,a7ddae0be8b78147,2013-11-30,0,0,0,900,0,0,147,34,143,4,0,0,4,3,3,0,140,31,140.8,533.3
9073,1b7bc992c26ac10f,a7ddae0be8b78147,92b36014314b028b,2013-11-30,0,3,0,900,2,1,185,80,178,7,0,0,7,7,56,43,122,73,14.7,671.2
9074,e9ed827818e8cadf,06f36cf4bd97ec77,cfb65863d5099327,2013-11-16,0,0,0,900,0,0,37,9,34,3,0,0,3,2,6,5,28,7,13.9,270.70000000000005
9075,e9ed827818e8cadf,cfb65863d5099327,06f36cf4bd97ec77,2013-11-16,0,0,0,900,8,3,35,19,18,17,0,0,17,10,2,1,16,9,555.3,200.1
9076,d8b864e673f53ec2,7bc96507e4b38d3b,fcd448a2fe1a23cc,2013-11-16,0,0,0,382,1,0,90,36,90,0,0,0,0,0,16,15,74,36,0.0,323.6
9077,d8b864e673f53ec2,fcd448a2fe1a23cc,7bc96507e4b38d3b,2013-11-16,1,0,0,382,1,1,82,33,78,4,0,0,4,4,13,10,65,29,42.4,329.0
9078,a4d7e8241422ed41,e5d03e4d966126bd,f3a853544e4413c4,2013-11-16,0,4,0,900,5,4,12,3,8,4,0,0,4,1,2,2,6,2,341.3,71.0
9079,a4d7e8241422ed41,f3a853544e4413c4,e5d03e4d966126bd,2013-11-16,0,0,0,900,0,0,19,6,14,5,2,2,3,3,0,0,14,3,317.0,241.7
9080,9cc0582c703637aa,af62f99eb7606308,bbfca6d5c27d9cd8,2013-11-16,1,0,0,900,8,7,108,25,90,18,5,4,13,10,33,21,57,15,289.1,386.0
9081,9cc0582c703637aa,bbfca6d5c27d9cd8,af62f99eb7606308,2013-11-16,0,0,0,900,0,0,85,13,85,0,0,0,0,0,11,5,74,13,0.0,610.9
9082,9bec9d2d0dd1d7f7,32ba186f4b0e3267,5b5307450405abf0,2013-11-16,0,0,0,900,7,0,114,29,114,0,0,0,0,0,27,13,87,29,0.0,851.4
9083,9bec9d2d0dd1d7f7,5b5307450405abf0,32ba186f4b0e3267,2013-11-16,1,0,0,900,2,2,199,39,191,8,5,5,3,2,45,27,146,37,23.6,838.0
9084,7ff036c99621eb1c,0941df56f6ac954b,6506c1d34da9c013,2013-11-16,0,0,0,1500,4,2,194,58,190,4,0,0,4,4,35,27,155,54,32.0,1163.8
9085,7ff036c99621eb1c,6506c1d34da9c013,0941df56f6ac954b,2013-11-16,0,1,0,1500,6,3,221,47,220,1,1,1,0,0,84,53,136,47,8.2,1296.0
9086,6c1fa30e1dd38c0b,cbd5d3cdd862e90e,f2925e6db404bf1d,2013-11-16,0,1,0,900,6,4,107,21,87,20,2,1,18,7,29,15,58,14,160.9,613.5
9087,6c1fa30e1dd38c0b,f2925e6db404bf1d,cbd5d3cdd862e90e,2013-11-16,1,0,0,900,0,0,102,25,84,18,0,0,18,9,27,19,57,16,101.5,598.1
9088,67222a0d79c83086,1d00756835ca67c9,e5c9de15bb58b1c6,2013-11-16,1,1,1,529,2,1,67,19,53,14,2,2,12,7,18,11,35,12,68.1,388.0
9089,67222a0d79c83086,e5c9de15bb58b1c6,1d00756835ca67c9,2013-11-16,0,0,0,529,4,0,72,12,72,0,0,0,0,0,13,12,59,12,0.0,371.9
9090,55f4c3598797ce6f,901cddcbfa079097,de75d1c45a39e221,2013-11-16,0,0,0,900,8,4,92,23,84,8,0,0,8,4,20,18,64,19,265.6,527.0
9091,55f4c3598797ce6f,de75d1c45a39e221,901cddcbfa079097,2013-11-16,0,3,0,900,4,2,121,54,119,2,0,0,2,2,29,27,90,52,41.0,511.4
9092,3081e6e1bc1235a8,3dd92ff9fb0412b3,c96d9178c9ed9e62,2013-11-16,0,0,0,900,4,1,150,34,148,2,0,0,2,1,12,9,136,33,5.7,842.0
9093,3081e6e1bc1235a8,c96d9178c9ed9e62,3dd92ff9fb0412b3,2013-11-16,0,1,0,900,4,2,158,28,154,4,2,2,2,0,29,18,125,28,24.0,828.3
9094,25cb0e15dfc8deb3,48d1f690b763934c,ee779c43a8926d52,2013-11-16,0,0,0,245,1,0,14,2,14,0,0,0,0,0,3,1,11,2,0.0,31.80000000000001
9095,25cb0e15dfc8deb3,ee779c43a8926d52,48d1f690b763934c,2013-11-16,1,0,0,245,2,1,28,19,4,24,0,0,24,17,1,1,3,2,178.2,52.0
9096,1f5c71dd2a0672ac,dd37fd509af89f15,effd9de9937996f8,2013-11-16,0,0,0,278,0,0,15,1,15,0,0,0,0,0,4,4,11,1,0.0,149.2
9097,1f5c71dd2a0672ac,effd9de9937996f8,dd37fd509af89f15,2013-11-16,2,0,0,278,0,0,34,18,21,13,0,0,13,7,5,4,16,11,68.8,188.0
9098,ee4d086121100177,8a59d346dc976a10,9b198c73e3d0d289,2013-11-09,0,1,1,158,1,1,11,4,10,1,0,0,1,1,3,3,7,3,39.0,65.8
9099,ee4d086121100177,9b198c73e3d0d289,8a59d346dc976a10,2013-11-09,0,0,0,158,0,0,17,3,12,5,3,1,2,2,2,0,10,1,14.2,102.0
9100,e9bc416752cadd29,16690d100f995f8f,c1a5d3843596df92,2013-11-09,1,1,0,211,5,1,20,8,16,4,0,0,4,2,6,6,10,6,39.1,59.8
9101,e9bc416752cadd29,c1a5d3843596df92,16690d100f995f8f,2013-11-09,1,0,0,211,1,1,28,16,18,10,0,0,10,8,2,2,16,8,24.2,125.9
9102,c6c37a9e8990baba,53278852bcd91e11,5c1ca0c72b599a3c,2013-11-09,0,0,0,78,1,0,16,6,16,0,0,0,0,0,5,3,11,6,0.0,27.6
9103,c6c37a9e8990baba,5c1ca0c72b599a3c,53278852bcd91e11,2013-11-09,1,0,0,78,0,0,21,11,19,2,0,0,2,2,5,5,14,9,0.4,75.0
9104,8de959ac3c3eeb85,30a09e43f15f1d75,638cfec7ec559d6e,2013-11-09,0,0,0,130,2,1,13,4,13,0,0,0,0,0,1,1,12,4,0.0,101.6
9105,8de959ac3c3eeb85,638cfec7ec559d6e,30a09e43f15f1d75,2013-11-09,1,0,0,130,0,0,28,7,26,2,0,0,2,2,8,5,18,5,5.4,103.0
9106,5cce3bc28ddb158f,b35ba64b6a2bbcb3,f53c1f4ceeed8c08,2013-11-09,0,2,0,799,6,2,80,13,79,1,0,0,1,1,35,30,44,12,10.7,505.8
9107,5cce3bc28ddb158f,f53c1f4ceeed8c08,b35ba64b6a2bbcb3,2013-11-09,1,0,0,799,7,4,104,28,83,21,7,7,14,14,21,20,62,14,197.2,450.3
9108,389c844a1a56177c,4c7781da8c6cae93,6d1bffff14897645,2013-11-09,1,0,0,900,10,5,170,45,121,49,12,9,37,23,32,21,89,22,347.0,444.8
9109,389c844a1a56177c,6d1bffff14897645,4c7781da8c6cae93,2013-11-09,1,0,0,900,0,0,81,15,78,3,0,0,3,0,20,10,58,15,23.2,522.0
9110,2e042964c6498e7a,18968f97ad34f15c,b71ce838b01f2cad,2013-11-09,1,0,0,40,0,0,3,3,2,1,0,0,1,1,0,0,2,2,2.0,38.0
9111,2e042964c6498e7a,b71ce838b01f2cad,18968f97ad34f15c,2013-11-09,0,0,0,40,0,0,5,1,5,0,0,0,0,0,1,0,4,1,0.0,38.0
9112,2dd0a47f43dfe8f6,5f99b2bafb10305f,7dcf06c1967801c1,2013-11-09,0,0,0,469,1,0,26,1,26,0,0,0,0,0,16,7,10,1,0.0,225.0
9113,2dd0a47f43dfe8f6,7dcf06c1967801c1,5f99b2bafb10305f,2013-11-09,0,1,1,469,1,1,22,11,14,8,1,1,7,5,4,4,10,6,244.0,225.0
9114,2d57ce76f7922ed9,7e47047d0971d566,dbc17725b887860a,2013-11-09,0,0,0,900,5,0,44,11,44,0,0,0,0,0,12,10,32,11,0.0,781.0
9115,2d57ce76f7922ed9,dbc17725b887860a,7e47047d0971d566,2013-11-09,0,0,0,900,4,3,47,10,47,0,0,0,0,0,9,5,38,10,0.0,393.0
9116,1d34e2f80cb91188,0ee783aa00e468f0,1ccf4e7caff270df,2013-11-09,2,0,0,77,0,0,17,12,3,14,0,0,14,9,0,0,3,3,10.5,65.0
9117,1d34e2f80cb91188,1ccf4e7caff270df,0ee783aa00e468f0,2013-11-09,0,0,0,77,0,0,2,1,2,0,0,0,0,0,0,0,2,1,0.0,66.5
9118,0a70601cc9f2426f,b8aef0faf4ce9b31,fa37628269132d1a,2013-11-09,1,0,0,102,1,1,15,11,1,14,0,0,14,11,1,0,0,0,54.0,48.0
9119,0a70601cc9f2426f,fa37628269132d1a,b8aef0faf4ce9b31,2013-11-09,0,0,0,102,2,0,5,3,5,0,0,0,0,0,0,0,5,3,0.0,37.0
9120,ef97cccf28cf00a8,6c2030e0a143a94b,9450848a71d53776,2013-11-06,0,0,0,900,0,0,147,20,147,0,0,0,0,0,65,44,82,20,0.0,789.7
9121,ef97cccf28cf00a8,9450848a71d53776,6c2030e0a143a94b,2013-11-06,0,0,0,900,0,0,121,20,120,1,0,0,1,1,41,26,79,19,3.3,837.0
9122,dc3deae609874677,3c0437fbeda06962,7ea4a9f07df33a45,2013-11-06,0,0,0,440,4,1,61,14,61,0,0,0,0,0,16,9,45,14,0.0,279.5
9123,dc3deae609874677,7ea4a9f07df33a45,3c0437fbeda06962,2013-11-06,1,0,0,440,1,0,73,23,63,10,0,0,10,5,6,4,57,18,21.5,384.0
9124,dbc3afd71525c83d,47b9e0e7703a4868,9b7694d064a8a0ad,2013-11-06,0,0,0,900,2,1,93,12,87,6,0,0,6,1,34,26,53,11,19.8,772.0
9125,dbc3afd71525c83d,9b7694d064a8a0ad,47b9e0e7703a4868,2013-11-06,1,1,0,900,10,2,100,27,98,2,0,0,2,1,14,5,84,26,42.0,712.2
9126,ce30634422a264f9,6f242453c91a5af0,d188a3b817860ec6,2013-11-06,0,4,0,900,10,6,104,35,78,26,0,0,26,18,16,9,62,17,348.8,408.0
9127,ce30634422a264f9,d188a3b817860ec6,6f242453c91a5af0,2013-11-06,0,3,0,900,0,0,77,19,75,2,0,0,2,2,4,4,71,17,9.0,506.2
9128,b35f2071e6dd4b12,bd21a1e3d41c97ee,f77c68bb4be8516d,2013-11-06,0,0,0,699,6,2,75,9,73,2,0,0,2,1,18,9,55,8,16.0,632.2
9129,b35f2071e6dd4b12,f77c68bb4be8516d,bd21a1e3d41c97ee,2013-11-06,1,0,0,699,1,0,104,27,99,5,0,0,5,2,36,23,63,25,18.8,634.0
9130,add991cb839af4ed,1d239d571e342453,80fa8218c99f9c58,2013-11-06,0,0,0,236,0,0,6,0,6,0,0,0,0,0,3,1,3,0,0.0,74.0
9131,add991cb839af4ed,80fa8218c99f9c58,1d239d571e342453,2013-11-06,1,0,0,236,3,1,57,14,5,52,0,0,52,14,4,0,1,0,162.0,74.0
9132,ab18079c7c0040fb,5f04e3d58d9ce982,813550bc53b15fb0,2013-11-06,0,0,0,167,0,0,38,11,38,0,0,0,0,0,12,8,26,11,0.0,163.0
9133,ab18079c7c0040fb,813550bc53b15fb0,5f04e3d58d9ce982,2013-11-06,1,0,0,167,0,0,68,14,65,3,0,0,3,3,18,11,47,11,4.0,163.0
9134,6017ccf5fa09da34,84b3e7d38f2d2ec5,fd5b6598a3b70c0a,2013-11-06,0,0,0,900,3,2,65,11,58,7,0,0,7,3,24,20,34,8,29.0,474.9
9135,6017ccf5fa09da34,fd5b6598a3b70c0a,84b3e7d38f2d2ec5,2013-11-06,0,0,0,900,11,3,70,10,52,18,9,4,9,4,15,14,37,6,284.1,366.0
9136,4c257f69fb974088,4c2d90e335e6df19,51a0c09cbe9b8472,2013-11-06,0,0,0,900,1,1,171,22,170,1,1,1,0,0,45,27,125,22,8.2,709.0
9137,4c257f69fb974088,51a0c09cbe9b8472,4c2d90e335e6df19,2013-11-06,0,0,0,900,1,1,85,21,84,1,0,0,1,0,25,22,59,21,3.0,873.8
9138,2bcb1b0b05e2c739,887961364be5ceb3,8f6a18831a120817,2013-11-06,1,0,0,230,0,0,54,5,54,0,0,0,0,0,25,15,29,5,0.0,230.0
9139,2bcb1b0b05e2c739,8f6a18831a120817,887961364be5ceb3,2013-11-06,0,0,0,230,0,0,64,14,64,0,0,0,0,0,13,8,51,14,0.0,230.0
9140,26e876df6d498657,0dba4df5f34d5ff0,3c660c90d48fc80d,2013-11-06,0,0,0,280,1,0,35,5,35,0,0,0,0,0,14,8,21,5,0.0,278.0
9141,26e876df6d498657,3c660c90d48fc80d,0dba4df5f34d5ff0,2013-11-06,1,0,0,280,0,0,31,7,27,4,0,0,4,4,7,6,20,3,2.0,278.0
9142,20a83369ee44e1d4,36fbaa49a09ff997,b1a3e0aca758b322,2013-11-06,0,0,0,48,0,0,1,0,1,0,0,0,0,0,0,0,1,0,0.0,48.0
9143,20a83369ee44e1d4,b1a3e0aca758b322,36fbaa49a09ff997,2013-11-06,1,1,1,48,0,0,2,1,2,0,0,0,0,0,1,0,1,1,0.0,18.0
9144,0cd79ea89d5931d0,2e25c1d983c26311,c58f51dedb310998,2013-11-06,0,1,0,401,3,2,18,0,18,0,0,0,0,0,9,4,9,0,0.0,210.0
9145,0cd79ea89d5931d0,c58f51dedb310998,2e25c1d983c26311,2013-11-06,0,2,1,401,2,1,19,5,19,0,0,0,0,0,3,2,16,5,0.0,320.0
9146,ce9e10ad39976287,1dafccb62a0f98ec,893d51aaf024eddd,2013-10-26,0,0,0,437,3,0,28,11,28,0,0,0,0,0,6,4,22,11,0.0,367.0
9147,ce9e10ad39976287,893d51aaf024eddd,1dafccb62a0f98ec,2013-10-26,0,2,1,437,4,3,5,4,5,0,0,0,0,0,1,1,4,4,0.0,177.0
9148,c33671cab408184b,1e1dbd1cc5a7469e,bc3ec52ef70fc155,2013-10-26,1,0,0,581,4,0,72,8,72,0,0,0,0,0,46,40,26,8,0.0,486.0
9149,c33671cab408184b,bc3ec52ef70fc155,1e1dbd1cc5a7469e,2013-10-26,0,0,0,581,1,0,54,11,54,0,0,0,0,0,28,25,26,11,0.0,399.0
9150,b25662d83e6d4c3b,4f732e58ed907eff,ccd1299e0345e0ce,2013-10-26,0,0,0,117,0,0,11,0,11,0,0,0,0,0,4,3,7,0,0.0,117.0
9151,b25662d83e6d4c3b,ccd1299e0345e0ce,4f732e58ed907eff,2013-10-26,0,0,0,117,1,0,29,8,29,0,0,0,0,0,3,1,26,8,0.0,113.0
9152,a34dc365302238e8,14ff46596ad80609,53ec9cb470e1a4ea,2013-10-26,0,0,0,900,1,1,246,66,246,0,0,0,0,0,23,15,223,66,0.0,892.0
9153,a34dc365302238e8,53ec9cb470e1a4ea,14ff46596ad80609,2013-10-26,0,0,0,900,1,0,178,35,178,0,0,0,0,0,41,32,137,35,0.0,900.0
9154,6fbd9d599d638106,172c2135e70f87b7,8a70ceb3edbe757b,2013-10-26,2,1,1,432,1,1,108,30,98,10,1,1,9,7,14,8,84,23,32.9,386.0
9155,6fbd9d599d638106,8a70ceb3edbe757b,172c2135e70f87b7,2013-10-26,0,0,0,432,0,0,67,16,67,0,0,0,0,0,13,10,54,16,0.0,399.1
9156,5364d1537fc7d5aa,5dfe71ade71f3a4b,6a1901c62ab3870f,2013-10-26,0,0,0,900,8,1,245,64,245,0,0,0,0,0,30,24,215,64,0.0,855.8
9157,5364d1537fc7d5aa,6a1901c62ab3870f,5dfe71ade71f3a4b,2013-10-26,0,0,0,900,2,1,344,179,343,1,0,0,1,1,30,27,313,178,10.2,798.0
9158,4c0718f12ca664bb,ba043b03eb799063,c268b2cfebccf652,2013-10-26,0,0,0,171,0,0,38,13,38,0,0,0,0,0,1,1,37,13,0.0,168.8
9159,4c0718f12ca664bb,c268b2cfebccf652,ba043b03eb799063,2013-10-26,3,0,0,171,0,0,68,18,63,5,0,0,5,3,23,13,40,15,2.2,167.0
9160,49d065270f57ad99,179f1948dc234f1f,f7a7f7118d4b01b6,2013-10-26,0,0,0,190,0,0,3,0,3,0,0,0,0,0,2,0,1,0,0.0,190.0
9161,49d065270f57ad99,f7a7f7118d4b01b6,179f1948dc234f1f,2013-10-26,1,0,0,190,0,0,10,2,10,0,0,0,0,0,5,3,5,2,0.0,189.0
9162,46c89e7e886cdc5b,34e552520a934063,b7f38813485745da,2013-10-26,0,2,1,257,3,0,23,6,23,0,0,0,0,0,9,8,14,6,0.0,96.0
9163,46c89e7e886cdc5b,b7f38813485745da,34e552520a934063,2013-10-26,0,0,0,257,4,1,9,0,9,0,0,0,0,0,8,7,1,0,0.0,251.0
9164,2a50b91600e87994,7f955f71fa2ce7ac,8b5f9ea38184ded3,2013-10-26,0,0,0,187,1,1,27,17,17,10,0,0,10,7,3,3,14,10,33.6,126.6
9165,2a50b91600e87994,8b5f9ea38184ded3,7f955f71fa2ce7ac,2013-10-26,0,1,1,187,1,1,24,9,23,1,1,1,0,0,2,2,21,9,13.4,46.4
9166,22fdf7a08691db5d,59279a7c978f7da0,a3be148af5c7b088,2013-10-26,0,0,0,900,8,2,197,62,192,5,0,0,5,5,29,23,163,57,66.9,714.0
9167,22fdf7a08691db5d,a3be148af5c7b088,59279a7c978f7da0,2013-10-26,0,0,0,900,9,3,176,40,175,1,0,0,1,1,43,26,132,39,12.0,809.1
9168,0051d7fbb7893d27,282fa667ff9c51ed,b6c4451cb13c9303,2013-10-26,0,1,0,900,0,0,40,17,38,2,2,2,0,0,4,2,34,17,106.8,169.0
9169,0051d7fbb7893d27,b6c4451cb13c9303,282fa667ff9c51ed,2013-10-26,0,0,0,900,6,2,51,14,42,9,1,1,8,3,16,12,26,11,464.0,329.2
9170,fffa21388cdd78b7,5d7bdab5e03e3216,c80095f6092271a7,2013-10-19,0,0,0,900,8,3,118,33,113,5,1,1,4,2,25,23,88,31,45.6,641.4
9171,fffa21388cdd78b7,c80095f6092271a7,5d7bdab5e03e3216,2013-10-19,0,3,0,900,1,0,76,27,74,2,1,1,1,1,16,13,58,26,21.6,735.4
9172,f11ca082c924464c,8fd808923cffff82,c3bd649a9194e50c,2013-10-19,1,0,0,353,1,1,105,47,94,11,1,1,10,8,8,7,86,39,20.0,209.0
9173,f11ca082c924464c,c3bd649a9194e50c,8fd808923cffff82,2013-10-19,0,0,0,353,2,1,45,18,44,1,0,0,1,1,5,5,39,17,104.0,229.0
9174,ed9d7d85a5ae06b1,896c322f56b8be5a,b7ffa72aa148599a,2013-10-19,0,0,0,900,7,1,199,31,199,0,0,0,0,0,23,19,176,31,0.0,874.0
9175,ed9d7d85a5ae06b1,b7ffa72aa148599a,896c322f56b8be5a,2013-10-19,0,0,0,900,0,0,167,26,167,0,0,0,0,0,54,30,113,26,0.0,900.0
9176,ed53922429a19c99,270b89c00ef0c55c,ca2efc9d7d523c43,2013-10-19,1,0,0,93,0,0,16,7,10,6,0,0,6,4,4,1,6,3,3.0,90.0
9177,ed53922429a19c99,ca2efc9d7d523c43,270b89c00ef0c55c,2013-10-19,0,0,0,93,0,0,7,2,7,0,0,0,0,0,0,0,7,2,0.0,90.0
9178,eba86a4ea6128840,99506df1af6c8b3b,bffeb123b21c9aad,2013-10-19,2,0,0,253,1,0,57,20,55,2,0,0,2,2,11,8,44,18,3.0,232.0
9179,eba86a4ea6128840,bffeb123b21c9aad,99506df1af6c8b3b,2013-10-19,0,0,0,253,1,0,37,7,37,0,0,0,0,0,6,3,31,7,0.0,250.0
9180,e7cb40d82d987b9e,3f7c14c7eca7195d,d967f0128c323de6,2013-10-19,0,0,0,900,0,0,82,11,82,0,0,0,0,0,10,6,72,11,0.0,850.2
9181,e7cb40d82d987b9e,d967f0128c323de6,3f7c14c7eca7195d,2013-10-19,0,0,0,900,5,3,148,50,144,4,0,0,4,3,27,24,117,47,48.8,668.0
9182,e1ccf09c055bac01,55f80a8aeffcdb33,98aa60cf58071fd6,2013-10-19,0,1,0,531,1,1,15,5,13,2,0,0,2,2,4,4,9,3,52.2,101.9
9183,e1ccf09c055bac01,98aa60cf58071fd6,55f80a8aeffcdb33,2013-10-19,1,0,0,531,3,1,50,24,16,34,2,1,32,17,5,5,11,7,220.1,245.8
9184,c9eb00b7efdc7559,36df8e119aec6175,f72465a784c1b084,2013-10-19,0,0,0,900,0,0,214,53,214,0,0,0,0,0,43,34,171,53,0.0,829.0
9185,c9eb00b7efdc7559,f72465a784c1b084,36df8e119aec6175,2013-10-19,0,0,0,900,0,0,209,39,209,0,0,0,0,0,33,26,176,39,0.0,815.0
9186,58b7b23b46f4ccd6,22a92d7f62195791,af90b10c785ced3e,2013-10-19,0,1,1,112,0,0,15,3,14,1,1,1,0,0,1,1,13,3,17.0,95.0
9187,58b7b23b46f4ccd6,af90b10c785ced3e,22a92d7f62195791,2013-10-19,0,0,0,112,2,0,8,3,8,0,0,0,0,0,1,1,7,3,0.0,78.0
9188,340d5e6f22ff6ac4,82e7929bf6c2b689,aa5b4eff51bdc7d1,2013-10-19,1,2,0,900,6,1,176,28,175,1,0,0,1,0,31,14,144,28,16.3,846.1
9189,340d5e6f22ff6ac4,aa5b4eff51bdc7d1,82e7929bf6c2b689,2013-10-19,0,0,0,900,1,1,250,83,248,2,1,1,1,1,17,12,231,82,4.9,849.7
9190,2a5fd0e2728967a5,a8e6a69796280f17,db1f2ed63b54b9a7,2013-10-19,0,0,0,108,0,0,10,2,10,0,0,0,0,0,4,2,6,2,0.0,106.9
9191,2a5fd0e2728967a5,db1f2ed63b54b9a7,a8e6a69796280f17,2013-10-19,1,0,0,108,0,0,22,10,19,3,0,0,3,3,0,0,19,7,1.1,105.0
9192,2443d8aa86f0070d,1e327b281ef6a745,8f2939f5fd9cca1e,2013-10-19,1,0,0,180,1,0,26,10,17,9,0,0,9,7,8,5,9,3,2.8,175.0
9193,2443d8aa86f0070d,8f2939f5fd9cca1e,1e327b281ef6a745,2013-10-19,0,0,0,180,3,0,10,0,10,0,0,0,0,0,6,4,4,0,0.0,139.2
9194,0bdc4e7ce6687367,0ff11cc094e887bc,63def5a5662a6917,2013-10-19,1,1,0,1389,13,2,201,96,183,18,0,0,18,13,33,27,150,83,161.2,340.9
9195,0bdc4e7ce6687367,63def5a5662a6917,0ff11cc094e887bc,2013-10-19,0,1,0,1389,1,0,122,36,121,1,0,0,1,1,16,10,105,35,0.1,1225.8
9196,fecf9c7a4e965690,1fb80f46d3c105d9,46baf0f57edfa4df,2013-10-09,0,1,0,900,0,0,168,61,168,0,0,0,0,0,35,26,133,61,0.0,838.2
9197,fecf9c7a4e965690,46baf0f57edfa4df,1fb80f46d3c105d9,2013-10-09,0,0,0,900,4,1,200,37,196,4,1,1,3,2,32,19,164,35,24.8,534.0
9198,e0ca5ac323768da0,236a37d96d476164,8ddf9c51c5fdea75,2013-10-09,0,0,0,31,1,1,5,2,5,0,0,0,0,0,0,0,5,2,0.0,22.0
9199,e0ca5ac323768da0,8ddf9c51c5fdea75,236a37d96d476164,2013-10-09,0,2,1,31,0,0,1,0,1,0,0,0,0,0,0,0,1,0,0.0,27.0
9200,adede42d4c20494c,2924886ee9c4c527,98b80a717b9bda17,2013-10-09,1,0,0,900,0,0,205,48,196,9,0,0,9,5,65,48,131,43,15.6,855.0
9201,adede42d4c20494c,98b80a717b9bda17,2924886ee9c4c527,2013-10-09,0,0,0,900,14,3,181,37,181,0,0,0,0,0,40,33,141,37,0.0,801.4
9202,a41ba2624191bf23,427b5953ac8e3a27,fe435e440b5de0ff,2013-10-09,0,0,0,1500,7,3,75,15,69,6,0,0,6,4,14,9,55,11,106.3,602.1
9203,a41ba2624191bf23,fe435e440b5de0ff,427b5953ac8e3a27,2013-10-09,0,0,0,1500,12,1,112,19,98,14,0,0,14,13,25,16,73,6,578.9,690.7
9204,9ad2dde9c35d3cc4,2f13e4020cea5b38,c849740a3ff51931,2013-10-09,0,1,0,900,6,0,101,21,100,1,0,0,1,1,24,11,76,20,3.8,881.0
9205,9ad2dde9c35d3cc4,c849740a3ff51931,2f13e4020cea5b38,2013-10-09,0,3,0,900,4,2,101,14,101,0,0,0,0,0,22,15,79,14,0.0,728.2
9206,79e7b986601fdd2a,129537073431e52e,cd7763bcadb5d4c8,2013-10-09,0,0,0,234,1,0,28,3,28,0,0,0,0,0,5,4,23,3,0.0,202.5
9207,79e7b986601fdd2a,cd7763bcadb5d4c8,129537073431e52e,2013-10-09,1,0,0,234,2,1,35,13,30,5,0,0,5,5,9,3,21,8,26.5,181.0
9208,676590832dc86748,7c6e87729e824ef4,dbea8c1cb327ab3d,2013-10-09,0,3,0,900,3,3,33,11,23,10,1,1,9,7,9,6,14,4,142.6,275.0
9209,676590832dc86748,dbea8c1cb327ab3d,7c6e87729e824ef4,2013-10-09,0,1,0,900,6,1,51,17,26,25,2,1,23,11,9,3,17,6,354.0,318.4
9210,3fc3179cd800128e,5866fc86183a9fb8,9bcf8603ceb25680,2013-10-09,0,0,0,481,0,0,60,12,59,1,0,0,1,0,22,16,37,12,1.2,352.3
9211,3fc3179cd800128e,9bcf8603ceb25680,5866fc86183a9fb8,2013-10-09,1,0,0,481,4,1,31,10,27,4,0,0,4,3,2,1,25,7,106.7,239.8
9212,3e610c7a2ab31acd,7cdd3e5d3aa9cb39,8f3df4c579cfbb69,2013-10-09,1,1,0,900,6,4,34,17,9,25,0,0,25,15,2,1,7,2,701.0,148.7
9213,3e610c7a2ab31acd,8f3df4c579cfbb69,7cdd3e5d3aa9cb39,2013-10-09,0,1,0,900,1,0,22,4,21,1,0,0,1,1,2,1,19,3,22.3,132.0
9214,3a8baa48c9b30d47,14aa21bc82cac57d,b2e3aca4cd363477,2013-10-09,0,0,0,571,4,2,88,23,86,2,0,0,2,2,16,12,70,21,35.0,410.9
9215,3a8baa48c9b30d47,b2e3aca4cd363477,14aa21bc82cac57d,2013-10-09,1,0,0,571,1,0,124,42,117,7,0,0,7,5,20,12,97,37,20.1,493.0
9216,e37368ff2a7a71f6,5755960ebd0b16f6,5aedf14771ca82d2,2013-09-21,0,0,0,900,0,0,62,8,56,6,3,2,3,2,30,19,26,6,0.0,603.9
9217,e37368ff2a7a71f6,5aedf14771ca82d2,5755960ebd0b16f6,2013-09-21,0,0,0,900,6,4,96,12,75,21,9,6,12,6,15,15,60,6,296.1,477.0
9218,d9834a03626a3c06,05560764359161e4,3591d0d5d382a381,2013-09-21,0,0,0,900,0,0,25,2,25,0,0,0,0,0,6,5,19,2,0.0,150.0
9219,d9834a03626a3c06,3591d0d5d382a381,05560764359161e4,2013-09-21,0,0,0,900,5,5,64,19,30,34,4,4,30,17,6,6,24,2,750.0,150.0
9220,d3f9262901219944,44bc27bfa76dcd9e,c21a036b4e012f1c,2013-09-21,0,0,0,121,0,0,27,3,27,0,0,0,0,0,6,4,21,3,0.0,113.0
9221,d3f9262901219944,c21a036b4e012f1c,44bc27bfa76dcd9e,2013-09-21,1,0,0,121,0,0,39,11,23,16,1,0,15,9,12,9,11,2,8.0,113.0
9222,ca2b48fd007126e0,032cc3922d871c7f,50d2f0018bcf9eef,2013-09-21,0,0,0,900,11,5,130,40,118,12,1,1,11,7,14,13,104,33,246.9,509.0
9223,ca2b48fd007126e0,50d2f0018bcf9eef,032cc3922d871c7f,2013-09-21,0,0,0,900,2,0,157,27,157,0,0,0,0,0,26,17,131,27,0.0,647.1
9224,c3b1653fb5e101e0,1abfb658cd4f8533,470fedbc8563ac47,2013-09-21,0,0,0,798,3,0,99,16,87,12,0,0,12,10,51,40,36,6,88.3,524.4
9225,c3b1653fb5e101e0,470fedbc8563ac47,1abfb658cd4f8533,2013-09-21,1,1,0,798,5,2,73,22,69,4,1,1,3,2,31,26,38,20,45.6,447.7
9226,c0a5eeb0be0049bb,89a407032911e27e,ba280572acfba13f,2013-09-21,0,1,1,246,1,1,30,13,30,0,0,0,0,0,1,1,29,13,0.0,193.0
9227,c0a5eeb0be0049bb,ba280572acfba13f,89a407032911e27e,2013-09-21,0,0,0,246,0,0,11,4,11,0,0,0,0,0,3,3,8,4,0.0,246.0
9228,b3bb90f5a2aa0d7c,08e908ed6d18d6a0,3c921b1a30fdcbdd,2013-09-21,0,0,0,900,6,4,72,8,72,0,0,0,0,0,20,14,52,8,0.0,509.6
9229,b3bb90f5a2aa0d7c,3c921b1a30fdcbdd,08e908ed6d18d6a0,2013-09-21,0,0,0,900,0,0,98,13,86,12,4,3,8,7,21,9,65,6,39.4,854.0
9230,a95be3943ea0f691,4a28cb716c19157a,e5ecaf884b6da2bc,2013-09-21,2,0,0,387,2,2,39,14,34,5,0,0,5,2,11,9,23,12,128.3,231.5
9231,a95be3943ea0f691,e5ecaf884b6da2bc,4a28cb716c19157a,2013-09-21,0,0,0,387,0,0,43,0,42,1,0,0,1,0,22,17,20,0,1.5,246.7
9232,a605d4153c7dbd84,173acb3f920082b8,7aa3d6964eff4877,2013-09-21,1,1,0,900,9,1,115,26,109,6,1,1,5,5,30,20,79,21,68.7,721.6
9233,a605d4153c7dbd84,7aa3d6964eff4877,173acb3f920082b8,2013-09-21,0,0,0,900,0,0,162,82,158,4,0,0,4,4,24,24,134,78,75.4,567.3
9234,5b2cc17158d77f07,5580771f383e141f,e51fcd9cd84c0b93,2013-09-21,0,0,0,900,1,1,73,15,62,11,4,3,7,5,23,20,39,10,33.7,632.9
9235,5b2cc17158d77f07,e51fcd9cd84c0b93,5580771f383e141f,2013-09-21,0,0,0,900,15,7,43,16,40,3,0,0,3,3,5,3,35,13,221.1,350.3
9236,1019f330bdecfc65,2c99576fefe53c7c,fc9a9559a05f2704,2013-09-21,1,0,0,335,1,0,45,16,41,4,0,0,4,3,12,12,29,13,5.0,330.0
9237,1019f330bdecfc65,fc9a9559a05f2704,2c99576fefe53c7c,2013-09-21,0,0,0,335,0,0,53,5,53,0,0,0,0,0,10,6,43,5,0.0,311.0
9238,0d857bd8245f9d31,b8592b4a383696cd,fe91d254db77a7fc,2013-09-21,0,1,1,245,2,1,57,18,54,3,0,0,3,2,13,9,41,16,13.7,204.0
9239,0d857bd8245f9d31,fe91d254db77a7fc,b8592b4a383696cd,2013-09-21,0,1,0,245,0,0,44,3,44,0,0,0,0,0,14,12,30,3,0.0,220.3
9240,0aa5be9d0e75dd42,07f72a2a7591b409,3c6976f8182d9527,2013-09-21,0,0,0,1500,11,1,217,53,217,0,0,0,0,0,102,81,115,53,0.0,1441.0
9241,0aa5be9d0e75dd42,3c6976f8182d9527,07f72a2a7591b409,2013-09-21,0,0,0,1500,8,1,288,63,288,0,0,0,0,0,84,47,204,63,0.0,1481.0
9242,e706a0fca8e82288,52ba464d9068d871,be4076c9e8d791e3,2013-09-04,0,0,0,900,2,1,84,18,69,15,3,2,12,8,41,29,28,10,123.5,497.7
9243,e706a0fca8e82288,be4076c9e8d791e3,52ba464d9068d871,2013-09-04,0,0,0,900,16,1,28,6,26,2,0,0,2,2,7,5,19,4,122.3,409.5
9244,d67dadf630c36f18,0dba4df5f34d5ff0,8abf70f79e9e27c2,2013-09-04,2,1,0,900,2,0,62,29,16,46,5,5,41,26,6,5,10,3,473.7,198.1
9245,d67dadf630c36f18,8abf70f79e9e27c2,0dba4df5f34d5ff0,2013-09-04,0,0,0,900,1,0,17,6,12,5,0,0,5,4,3,3,9,2,217.9,121.30000000000001
9246,bbcb7b5ca439bebb,80eacd4da0617c57,b102c26727306ab6,2013-09-04,1,0,0,187,0,0,52,13,48,4,0,0,4,4,12,7,36,9,3.3,182.0
9247,bbcb7b5ca439bebb,b102c26727306ab6,80eacd4da0617c57,2013-09-04,0,0,0,187,0,0,18,5,18,0,0,0,0,0,3,1,15,5,0.0,183.7
9248,b8e1a9db956e245b,7413b80dbb0f8f9f,915c8d39d4a0e7d1,2013-09-04,1,1,1,70,0,0,20,6,18,2,0,0,2,1,4,4,14,5,26.0,44.0
9249,b8e1a9db956e245b,915c8d39d4a0e7d1,7413b80dbb0f8f9f,2013-09-04,0,0,0,70,0,0,10,2,10,0,0,0,0,0,3,2,7,2,0.0,44.0
9250,95d86cec2a7124b3,0fb1e2694a39a02f,ab850a77a0fa487d,2013-09-04,0,0,0,900,7,1,171,32,171,0,0,0,0,0,49,37,122,32,0.0,863.0
9251,95d86cec2a7124b3,ab850a77a0fa487d,0fb1e2694a39a02f,2013-09-04,0,0,0,900,0,0,281,89,280,1,0,0,1,1,15,10,265,88,0.0,900.0
9252,9166d2f99369c06b,7a703c565ccaa18f,acff437707625fc7,2013-09-04,1,0,0,167,1,0,48,25,38,10,0,0,10,10,5,3,33,15,7.7,140.0
9253,9166d2f99369c06b,acff437707625fc7,7a703c565ccaa18f,2013-09-04,0,0,0,167,0,0,11,1,11,0,0,0,0,0,1,0,10,1,0.0,159.3
9254,8456a02bd3621837,7ff97850e8c32bda,c0ab242c40decc55,2013-09-04,1,0,0,175,4,1,24,13,12,12,0,0,12,9,1,1,11,4,47.1,124.0
9255,8456a02bd3621837,c0ab242c40decc55,7ff97850e8c32bda,2013-09-04,0,1,0,175,1,0,27,9,27,0,0,0,0,0,2,2,25,9,0.0,89.9
9256,5df777be98ea09de,6c7020b859c7a3ce,71002dbc1743b9a7,2013-09-04,0,0,0,900,0,0,136,33,135,1,0,0,1,1,39,19,96,32,0.0,663.7
9257,5df777be98ea09de,71002dbc1743b9a7,6c7020b859c7a3ce,2013-09-04,0,1,0,900,5,3,78,13,65,13,9,7,4,3,19,15,46,10,236.3,591.0
9258,5aeac72404dd7c6d,a3be148af5c7b088,a8283a4f415e1eb9,2013-09-04,0,1,1,530,2,2,87,32,74,13,0,0,13,11,15,10,59,21,86.9,383.0
9259,5aeac72404dd7c6d,a8283a4f415e1eb9,a3be148af5c7b088,2013-09-04,1,0,0,530,4,1,43,11,43,0,0,0,0,0,16,11,27,11,0.0,341.1
9260,563adcb4abd48f6b,19db7ac26308178f,cd12227edd3f134b,2013-09-04,0,0,0,900,10,2,94,8,94,0,0,0,0,0,75,61,19,8,0.0,475.0
9261,563adcb4abd48f6b,cd12227edd3f134b,19db7ac26308178f,2013-09-04,0,0,0,900,1,0,78,24,78,0,0,0,0,0,20,18,58,24,0.0,861.0
9262,46aa72d0ccd2be0a,3dd92ff9fb0412b3,e363b21261814830,2013-09-04,2,1,0,808,5,3,68,29,41,27,3,2,24,17,9,7,32,12,195.4,467.3
9263,46aa72d0ccd2be0a,e363b21261814830,3dd92ff9fb0412b3,2013-09-04,0,0,0,808,0,0,47,12,37,10,4,4,6,5,15,11,22,7,94.7,451.6
9264,fef6b147d5fb90bd,b5b684eac99ae0a3,c47df9303d318c67,2013-08-31,1,1,0,630,5,3,66,24,51,15,3,3,12,10,6,5,45,14,147.6,443.0
9265,fef6b147d5fb90bd,c47df9303d318c67,b5b684eac99ae0a3,2013-08-31,0,0,0,630,4,0,99,11,99,0,0,0,0,0,9,6,90,11,0.0,477.4
9266,fa084335b5f87627,2676b28836a5a836,cbb682f5fcc44bfc,2013-08-31,0,0,0,281,3,0,16,3,15,1,0,0,1,1,8,8,7,2,27.0,92.0
9267,fa084335b5f87627,cbb682f5fcc44bfc,2676b28836a5a836,2013-08-31,0,1,1,281,0,0,16,3,16,0,0,0,0,0,7,6,9,3,0.0,254.0
9268,b4555cd5b5d2a53f,1091d4d957141094,60029bcf496bd707,2013-08-31,0,2,0,694,1,0,68,37,68,0,0,0,0,0,9,8,59,37,0.0,253.0
9269,b4555cd5b5d2a53f,60029bcf496bd707,1091d4d957141094,2013-08-31,1,0,0,694,4,4,42,26,18,24,0,0,24,18,3,3,15,8,304.0,238.0
9270,af51920a3e176995,029eaff01e6bb8f0,99bd87a300079ed9,2013-08-31,2,2,0,900,6,2,92,40,65,27,0,0,27,22,20,14,45,18,283.2,379.3
9271,af51920a3e176995,99bd87a300079ed9,029eaff01e6bb8f0,2013-08-31,0,5,0,900,0,0,74,17,67,7,0,0,7,6,16,15,51,11,69.7,407.8
9272,aac887ea8a83d7a4,1ff9589f9065a9ed,ad3f53c454cbbead,2013-08-31,0,0,0,116,0,0,16,6,16,0,0,0,0,0,3,3,13,6,0.0,113.9
9273,aac887ea8a83d7a4,ad3f53c454cbbead,1ff9589f9065a9ed,2013-08-31,1,0,0,116,0,0,38,13,37,1,0,0,1,0,14,13,23,13,2.1,45.0
9274,9cd973a0a6c1cd5c,46fd223e3ced39b3,59279a7c978f7da0,2013-08-31,0,0,0,900,6,0,155,20,155,0,0,0,0,0,33,25,122,20,0.0,818.3
9275,9cd973a0a6c1cd5c,59279a7c978f7da0,46fd223e3ced39b3,2013-08-31,0,0,0,900,4,4,177,55,170,7,0,0,7,5,30,25,140,50,13.7,847.0
9276,98903717ea3dfc24,0e21976afc92e4d1,23459ee7e373b98f,2013-08-31,0,1,1,57,0,0,13,3,13,0,0,0,0,0,3,1,10,3,0.0,49.0
9277,98903717ea3dfc24,23459ee7e373b98f,0e21976afc92e4d1,2013-08-31,0,0,0,57,1,0,8,0,8,0,0,0,0,0,4,3,4,0,0.0,56.0
9278,7b13fdc889028e66,75e5fec9f72910ef,a54fc2d6fc224dc3,2013-08-31,0,0,0,900,4,2,55,23,37,18,0,0,18,15,7,3,30,8,291.4,448.8
9279,7b13fdc889028e66,a54fc2d6fc224dc3,75e5fec9f72910ef,2013-08-31,0,1,0,900,3,1,76,28,53,23,1,1,22,14,13,8,40,14,111.2,492.6
9280,6ce1b33bccdfa676,32be4b7f7de1c905,a7897d200692ab64,2013-08-31,0,1,0,900,1,0,69,27,35,34,1,1,33,14,0,0,35,13,129.0,244.7
9281,6ce1b33bccdfa676,a7897d200692ab64,32be4b7f7de1c905,2013-08-31,0,0,0,900,3,3,70,14,40,30,1,1,29,13,8,3,32,1,507.3,213.0
9282,66a99e85803efd92,203c957eac95dd87,a01e84abefd85ec0,2013-08-31,2,0,0,238,1,1,75,24,65,10,0,0,10,8,4,2,61,16,10.0,225.0
9283,66a99e85803efd92,a01e84abefd85ec0,203c957eac95dd87,2013-08-31,0,0,0,238,1,0,59,13,59,0,0,0,0,0,9,8,50,13,0.0,228.0
9284,4dc03e76536b85e5,bd58d34e39b7b12a,fa315e6c77eee106,2013-08-31,1,0,0,714,0,0,103,40,101,2,0,0,2,0,18,16,83,40,7.1,615.0
9285,4dc03e76536b85e5,fa315e6c77eee106,bd58d34e39b7b12a,2013-08-31,0,0,0,714,1,0,63,12,63,0,0,0,0,0,30,29,33,12,0.0,706.9
9286,336670b46f343d65,b72a60a0cadff408,c96d9178c9ed9e62,2013-08-31,0,0,0,900,0,0,78,12,78,0,0,0,0,0,22,16,56,12,0.0,433.7
9287,336670b46f343d65,c96d9178c9ed9e62,b72a60a0cadff408,2013-08-31,0,2,0,900,6,6,200,76,96,104,13,13,91,49,37,27,59,27,452.3,352.0
9288,f18ea0d8b472dc1e,523fa774700d7d3f,e1147d3d2dabe1ce,2013-08-28,0,0,0,900,8,1,305,41,305,0,0,0,0,0,92,47,213,41,0.0,866.0
9289,f18ea0d8b472dc1e,e1147d3d2dabe1ce,523fa774700d7d3f,2013-08-28,0,0,0,900,0,0,184,48,184,0,0,0,0,0,3,0,181,48,0.0,900.0
9290,f0d839f6d712a233,8c0580d4fff106c1,eee7dafac7d672b5,2013-08-28,1,1,1,146,2,1,23,10,22,1,1,1,0,0,4,3,18,10,6.0,116.0
9291,f0d839f6d712a233,eee7dafac7d672b5,8c0580d4fff106c1,2013-08-28,0,0,0,146,0,0,21,5,21,0,0,0,0,0,4,2,17,5,0.0,140.0
9292,e1f9390c465a2988,19a8cce18a1cef9e,e5d03e4d966126bd,2013-08-28,0,0,0,101,0,0,1,0,1,0,0,0,0,0,0,0,1,0,0.0,37.0
9293,e1f9390c465a2988,e5d03e4d966126bd,19a8cce18a1cef9e,2013-08-28,0,2,1,101,1,1,6,1,3,3,0,0,3,1,1,0,2,0,61.0,40.0
9294,dd1131c208475365,92a9aa9c93192871,ef7fa30364cbe7f2,2013-08-28,0,0,0,900,5,2,144,36,115,29,3,3,26,14,21,9,94,22,295.0,438.0
9295,dd1131c208475365,ef7fa30364cbe7f2,92a9aa9c93192871,2013-08-28,0,0,0,900,1,1,69,14,67,2,0,0,2,2,30,17,37,12,45.0,515.0
9296,ca17e1385ef98e57,1d00756835ca67c9,6a2f7c151031653d,2013-08-28,0,0,0,900,1,1,80,9,80,0,0,0,0,0,46,31,34,9,0.0,622.8
9297,ca17e1385ef98e57,6a2f7c151031653d,1d00756835ca67c9,2013-08-28,1,0,0,900,6,2,109,21,92,17,0,0,17,8,31,18,61,13,217.2,670.0
9298,bfef39e6493f6487,8b69839f3555a67b,f9f07bb5a43535ed,2013-08-28,0,0,0,954,15,6,97,29,89,8,0,0,8,4,6,6,83,25,129.2,622.6
9299,bfef39e6493f6487,f9f07bb5a43535ed,8b69839f3555a67b,2013-08-28,1,2,0,954,2,0,235,68,232,3,2,2,1,0,48,30,184,68,8.4,748.8
9300,a86b801279e0ef4a,00debc804e2b1cd4,c9f6385af6df66d7,2013-08-28,1,0,0,692,5,2,45,12,39,6,1,1,5,3,9,7,30,9,41.4,311.0
9301,a86b801279e0ef4a,c9f6385af6df66d7,00debc804e2b1cd4,2013-08-28,0,3,0,692,5,3,40,12,30,10,1,1,9,7,11,6,19,5,312.0,338.6
9302,964eb53864554ed0,638cfec7ec559d6e,e56daf7725a0b5ab,2013-08-28,2,0,0,83,1,1,26,13,20,6,0,0,6,4,4,4,16,9,6.3,64.0
9303,964eb53864554ed0,e56daf7725a0b5ab,638cfec7ec559d6e,2013-08-28,0,0,0,83,2,0,10,1,10,0,0,0,0,0,1,1,9,1,0.0,74.7
9304,8ab4682a544f3c49,0c6d9ea8306c029e,5cafbc97dba2e797,2013-08-28,0,0,0,900,1,0,79,7,75,4,3,3,1,1,28,20,47,6,43.1,601.6
9305,8ab4682a544f3c49,5cafbc97dba2e797,0c6d9ea8306c029e,2013-08-28,0,0,0,900,3,1,56,7,51,5,1,0,4,2,17,7,34,5,201.4,574.9
9306,6b30fe49b6df63de,3b9f723e2720a238,e14b5aa06eea9653,2013-08-28,0,3,0,597,5,4,104,34,100,4,1,1,3,3,11,8,89,31,90.0,416.5
9307,6b30fe49b6df63de,e14b5aa06eea9653,3b9f723e2720a238,2013-08-28,0,0,0,597,1,1,123,42,114,9,4,4,5,4,4,4,110,38,45.5,411.0
9308,602e8602fe9c9121,4ba8d454f762005d,c4fe2e9a06ea5bcb,2013-08-28,0,1,1,259,3,2,11,3,10,1,0,0,1,1,2,2,8,2,30.0,79.0
9309,602e8602fe9c9121,c4fe2e9a06ea5bcb,4ba8d454f762005d,2013-08-28,0,0,0,259,0,0,9,1,9,0,0,0,0,0,7,5,2,1,0.0,229.0
9310,382d626d45c36f14,48e093ea1f43a053,af62f99eb7606308,2013-08-28,0,1,0,900,5,2,106,32,102,4,0,0,4,3,9,7,93,29,37.6,723.6
9311,382d626d45c36f14,af62f99eb7606308,48e093ea1f43a053,2013-08-28,0,0,0,900,11,5,113,17,112,1,0,0,1,1,32,20,80,16,16.4,584.4
9312,f12126b5c49a318a,22aa91e402d0fe1f,6256b2b1562cb8e1,2013-08-17,0,0,0,58,2,1,2,0,2,0,0,0,0,0,2,0,0,0,0.0,36.0
9313,f12126b5c49a318a,6256b2b1562cb8e1,22aa91e402d0fe1f,2013-08-17,0,1,1,58,0,0,0,0,0,0,0,0,0,0,0,0,0,0,0.0,41.0
9314,eefc526e320524e6,3236bf606fe9fa5b,b4ad3a06ee4d660c,2013-08-17,1,0,0,248,0,0,27,8,25,2,0,0,2,2,8,6,17,6,0.7,201.8
9315,eefc526e320524e6,b4ad3a06ee4d660c,3236bf606fe9fa5b,2013-08-17,2,0,0,248,1,0,66,21,48,18,0,0,18,11,22,20,26,10,44.2,112.3
9316,a2c0f4142ba4ba75,361d49960a196976,c2e3e67b5911bfb7,2013-08-17,0,0,0,900,8,0,160,47,121,39,3,3,36,21,16,11,105,26,152.4,485.0
9317,a2c0f4142ba4ba75,c2e3e67b5911bfb7,361d49960a196976,2013-08-17,0,0,0,900,10,8,86,31,73,13,2,1,11,5,18,10,55,26,247.0,481.6
9318,8e41d022b55277ae,c945adc22c2bfe8f,d0314416a7f26527,2013-08-17,0,0,0,523,1,1,78,16,68,10,0,0,10,4,5,1,63,12,128.2,371.6
9319,8e41d022b55277ae,d0314416a7f26527,c945adc22c2bfe8f,2013-08-17,2,2,1,523,1,0,87,44,82,5,0,0,5,3,8,7,74,41,10.4,365.8
9320,85ee3b5995874141,31123249b0bbf52e,f5990c11974d8e9c,2013-08-17,1,0,0,29,0,0,18,8,12,6,1,0,5,5,2,2,10,3,5.1,23.0
9321,85ee3b5995874141,f5990c11974d8e9c,31123249b0bbf52e,2013-08-17,0,0,0,29,0,0,3,0,3,0,0,0,0,0,0,0,3,0,0.0,23.9
9322,751f2796809d2a6f,2f95a3c6d58b2aad,78114b7199cef90c,2013-08-17,0,1,0,900,1,1,23,5,10,13,2,1,11,5,4,2,6,0,152.0,140.0
9323,751f2796809d2a6f,78114b7199cef90c,2f95a3c6d58b2aad,2013-08-17,0,0,0,900,5,4,79,53,7,72,1,1,71,50,1,0,6,3,608.0,140.0
9324,5d839e4eda09d6e4,150ff4cc642270b9,f4c49976c75c5ab2,2013-08-17,0,0,0,900,0,0,93,10,93,0,0,0,0,0,22,13,71,10,0.0,555.1
9325,5d839e4eda09d6e4,f4c49976c75c5ab2,150ff4cc642270b9,2013-08-17,0,0,0,900,5,4,153,34,137,16,0,0,16,9,40,19,97,25,344.9,512.0
9326,5135e078b807f9a2,50db8711c70196cd,7bc96507e4b38d3b,2013-08-17,1,0,0,127,0,0,11,6,4,7,0,0,7,6,0,0,4,0,8.8,117.0
9327,5135e078b807f9a2,7bc96507e4b38d3b,50db8711c70196cd,2013-08-17,0,0,0,127,3,0,15,2,15,0,0,0,0,0,9,8,6,2,0.0,45.2
9328,47dd6356ceb2eba8,65578a75fa7900e3,fc31f896cde2bc2e,2013-08-17,0,0,0,900,8,2,62,17,53,9,3,3,6,4,24,21,29,13,105.5,538.9
9329,47dd6356ceb2eba8,fc31f896cde2bc2e,65578a75fa7900e3,2013-08-17,0,1,0,900,6,2,61,10,55,6,2,2,4,3,28,21,27,7,68.1,567.5
9330,320580a92d5c2924,3bad7ef643840f67,511e82663651438d,2013-08-17,0,0,0,900,4,0,109,24,109,0,0,0,0,0,1,1,108,24,0.0,858.7
9331,320580a92d5c2924,511e82663651438d,3bad7ef643840f67,2013-08-17,2,0,0,900,2,2,255,81,250,5,0,0,5,2,47,35,203,79,13.3,839.0
9332,1308a39eec6f86cc,140745cbbcb023ac,48d1f690b763934c,2013-08-17,0,0,0,287,1,0,1,0,1,0,0,0,0,0,0,0,1,0,0.0,36.599999999999994
9333,1308a39eec6f86cc,48d1f690b763934c,140745cbbcb023ac,2013-08-17,0,2,1,287,3,2,9,3,2,7,1,1,6,3,1,1,1,0,200.4,58.0
9334,0f74449bf6f64616,282fa667ff9c51ed,cc6f9d1e89f3449a,2013-08-17,0,0,0,900,0,0,112,28,110,2,0,0,2,2,7,4,103,26,1.1,548.6
9335,0f74449bf6f64616,cc6f9d1e89f3449a,282fa667ff9c51ed,2013-08-17,0,0,0,900,7,5,62,12,51,11,1,1,10,5,16,10,35,7,345.4,427.9
9336,05dce98da0acefd8,d188a3b817860ec6,e0b74df14f52cd15,2013-08-17,1,0,0,50,0,0,16,5,8,8,0,0,8,4,1,1,7,1,6.0,44.0
9337,05dce98da0acefd8,e0b74df14f52cd15,d188a3b817860ec6,2013-08-17,0,0,0,50,0,0,3,2,3,0,0,0,0,0,1,1,2,2,0.0,44.0
9338,bf6857338637013b,48e96d9cea6d4ab0,94527830000ab715,2013-08-03,0,0,0,900,0,0,13,4,9,4,0,0,4,2,1,1,8,2,199.0,198.0
9339,bf6857338637013b,94527830000ab715,48e96d9cea6d4ab0,2013-08-03,0,1,0,900,7,2,40,13,26,14,1,1,13,9,6,0,20,4,503.0,198.0
9340,af0327945c9656e0,6809c31286b08d97,cfb65863d5099327,2013-08-03,0,0,0,900,0,0,67,19,67,0,0,0,0,0,19,14,48,19,0.0,430.9
9341,af0327945c9656e0,cfb65863d5099327,6809c31286b08d97,2013-08-03,0,3,0,900,9,5,91,47,72,19,0,0,19,19,6,4,66,28,395.1,297.0
9342,a602962f1dda3205,902ab9197b83d0db,f7a7f7118d4b01b6,2013-08-03,0,0,0,900,10,2,90,4,79,11,6,3,5,2,34,14,45,2,55.8,829.0
9343,a602962f1dda3205,f7a7f7118d4b01b6,902ab9197b83d0db,2013-08-03,0,0,0,900,0,0,61,12,61,0,0,0,0,0,30,15,31,12,0.0,822.2
9344,7b97ca2c378e7782,acd9513399a8b09b,b69f24c500d783e7,2013-08-03,0,0,0,900,1,0,71,13,63,8,1,1,7,4,9,5,54,9,97.0,674.6
9345,7b97ca2c378e7782,b69f24c500d783e7,acd9513399a8b09b,2013-08-03,0,0,0,900,5,2,63,10,61,2,1,1,1,1,22,20,39,9,31.4,583.0
9346,72e1b3e1224f5314,c451d67c09c55418,d0f3959b4a9747e6,2013-08-03,0,0,0,1020,0,0,117,13,116,1,0,0,1,0,11,4,105,13,0.6,717.0
9347,72e1b3e1224f5314,d0f3959b4a9747e6,c451d67c09c55418,2013-08-03,1,0,0,1020,6,5,87,24,78,9,1,1,8,3,9,7,69,21,300.0,719.4
9348,5f9b11f4cb3057f2,b35ba64b6a2bbcb3,c268b2cfebccf652,2013-08-03,0,1,0,363,5,1,36,9,34,2,0,0,2,2,19,10,15,7,9.4,293.1
9349,5f9b11f4cb3057f2,c268b2cfebccf652,b35ba64b6a2bbcb3,2013-08-03,1,0,0,363,2,2,58,17,37,21,2,1,19,9,9,4,28,8,36.9,302.6
9350,5f2065f737591226,14aa21bc82cac57d,701e057d63c124d9,2013-08-03,0,0,0,900,7,1,172,32,170,2,0,0,2,2,14,11,156,30,10.9,826.1
9351,5f2065f737591226,701e057d63c124d9,14aa21bc82cac57d,2013-08-03,0,0,0,900,5,1,226,34,216,10,0,0,10,4,87,58,129,30,35.9,828.1
9352,4f8b6eecb0361290,a17322f99ddfd8e9,d221ee27afc7a60e,2013-08-03,0,0,0,96,0,0,17,0,17,0,0,0,0,0,0,0,17,0,0.0,78.0
9353,4f8b6eecb0361290,d221ee27afc7a60e,a17322f99ddfd8e9,2013-08-03,1,0,0,96,0,0,18,9,11,7,0,0,7,4,3,3,8,5,18.0,78.0
9354,4c6030fafb46330f,4b4753d19489297f,88a9bc81271ccd89,2013-08-03,1,0,0,14,0,0,13,8,1,12,0,0,12,7,0,0,1,1,6.0,8.0
9355,4c6030fafb46330f,88a9bc81271ccd89,4b4753d19489297f,2013-08-03,0,0,0,14,0,0,1,1,1,0,0,0,0,0,0,0,1,1,0.0,8.0
9356,3846db1456151f80,1bcaac2d99b90fce,84b3e7d38f2d2ec5,2013-08-03,0,1,1,193,1,1,20,12,9,11,0,0,11,9,1,1,8,3,66.0,127.0
9357,3846db1456151f80,84b3e7d38f2d2ec5,1bcaac2d99b90fce,2013-08-03,0,0,0,193,0,0,29,6,29,0,0,0,0,0,2,1,27,6,0.0,106.0
9358,1acdcfe32d975f42,dbc17725b887860a,dea070ed4a2a8281,2013-08-03,0,1,1,47,0,0,5,3,5,0,0,0,0,0,1,0,4,3,0.0,40.0
9359,1acdcfe32d975f42,dea070ed4a2a8281,dbc17725b887860a,2013-08-03,0,0,0,47,1,0,1,0,1,0,0,0,0,0,0,0,1,0,0.0,43.0
9360,168413032bb51ce0,80fa8218c99f9c58,837d30395faca41e,2013-08-03,1,0,0,128,3,2,16,9,3,13,2,1,11,8,0,0,3,1,98.0,30.0
9361,168413032bb51ce0,837d30395faca41e,80fa8218c99f9c58,2013-08-03,0,0,0,128,0,0,8,1,8,0,0,0,0,0,4,2,4,1,0.0,18.0
9362,f747701638da90ae,f2925e6db404bf1d,fb8a3025ae722e64,2013-07-27,1,0,0,324,1,1,46,22,44,2,1,0,1,1,6,6,38,21,16.2,251.0
9363,f747701638da90ae,fb8a3025ae722e64,f2925e6db404bf1d,2013-07-27,0,0,0,324,0,0,42,6,42,0,0,0,0,0,7,4,35,6,0.0,307.8
9364,edc00a33666b0b59,8a304bfd6bf04a57,92437c6775b3f7d1,2013-07-27,0,3,1,1423,12,12,95,20,57,38,19,16,19,16,37,31,20,4,585.1,556.1
9365,edc00a33666b0b59,92437c6775b3f7d1,8a304bfd6bf04a57,2013-07-27,0,0,0,1423,5,1,76,13,66,10,1,1,9,5,22,18,44,8,50.9,720.9
9366,dbd0ffc84699ad6b,4b47e71384a9522f,d1e7fc58d4225cdf,2013-07-27,0,0,0,900,0,0,93,19,91,2,1,1,1,1,22,18,69,18,13.7,523.0
9367,dbd0ffc84699ad6b,d1e7fc58d4225cdf,4b47e71384a9522f,2013-07-27,0,0,0,900,8,6,79,17,77,2,1,1,1,0,10,7,67,17,336.0,550.3
9368,dbab923a090fe93f,1d239d571e342453,981ab7a0576f76a0,2013-07-27,0,0,0,900,0,0,82,9,82,0,0,0,0,0,42,41,40,9,0.0,669.0
9369,dbab923a090fe93f,981ab7a0576f76a0,1d239d571e342453,2013-07-27,0,0,0,900,9,2,76,6,76,0,0,0,0,0,22,22,54,6,0.0,609.0
9370,cf6b9a001b0824de,5f04e3d58d9ce982,5f99b2bafb10305f,2013-07-27,0,0,0,900,0,0,126,10,126,0,0,0,0,0,47,38,79,10,0.0,900.0
9371,cf6b9a001b0824de,5f99b2bafb10305f,5f04e3d58d9ce982,2013-07-27,0,0,0,900,1,0,142,15,142,0,0,0,0,0,47,29,95,15,0.0,900.0
9372,c5603628f7ae84d3,06f36cf4bd97ec77,f797f0c57a83353e,2013-07-27,0,1,0,900,5,2,129,46,129,0,0,0,0,0,30,27,99,46,0.0,702.0
9373,c5603628f7ae84d3,f797f0c57a83353e,06f36cf4bd97ec77,2013-07-27,0,1,0,900,5,1,108,37,108,0,0,0,0,0,52,50,56,37,0.0,700.0
9374,c543563958093446,51a0c09cbe9b8472,6a1901c62ab3870f,2013-07-27,1,1,0,537,3,3,83,45,11,72,3,3,69,40,2,2,9,5,459.2,59.0
9375,c543563958093446,6a1901c62ab3870f,51a0c09cbe9b8472,2013-07-27,0,1,0,537,1,1,15,3,13,2,0,0,2,1,7,7,6,2,6.0,56.80000000000001
9376,b616969d55fb2d7a,9b198c73e3d0d289,f2c8ebbeafd45f2b,2013-07-27,0,0,0,900,9,3,140,38,138,2,0,0,2,2,25,16,113,36,4.6,870.0
9377,b616969d55fb2d7a,f2c8ebbeafd45f2b,9b198c73e3d0d289,2013-07-27,0,0,0,900,0,0,172,10,172,0,0,0,0,0,49,16,123,10,0.0,895.4
9378,9cb8fe20b05d886e,3623bd267a2eef2e,7bd94b60d7521e4a,2013-07-27,0,4,1,469,2,1,7,2,6,1,0,0,1,1,3,2,3,1,341.0,87.0
9379,9cb8fe20b05d886e,7bd94b60d7521e4a,3623bd267a2eef2e,2013-07-27,0,3,0,469,0,0,12,0,11,1,1,1,0,0,3,3,8,0,41.0,46.0
9380,900ae72adbf7c49f,47b9e0e7703a4868,c58f51dedb310998,2013-07-27,0,2,1,599,0,0,38,15,31,7,1,1,6,6,8,8,23,9,192.0,326.0
9381,900ae72adbf7c49f,c58f51dedb310998,47b9e0e7703a4868,2013-07-27,1,0,0,599,5,2,53,18,52,1,0,0,1,0,7,6,45,18,81.0,245.0
9382,7ec61e2b0728e6d4,86f582852a5b240a,ccd1299e0345e0ce,2013-07-27,0,0,0,467,1,0,56,8,56,0,0,0,0,0,17,15,39,8,0.0,426.0
9383,7ec61e2b0728e6d4,ccd1299e0345e0ce,86f582852a5b240a,2013-07-27,1,0,0,467,0,0,88,27,81,7,0,0,7,6,13,12,68,21,28.0,427.0
9384,3f14c96ea899321d,cbd5d3cdd862e90e,d81ac739417d7f53,2013-07-27,0,0,0,900,1,0,118,37,118,0,0,0,0,0,16,9,102,37,0.0,884.2
9385,3f14c96ea899321d,d81ac739417d7f53,cbd5d3cdd862e90e,2013-07-27,0,0,0,900,3,1,97,16,96,1,0,0,1,1,8,3,88,15,15.8,837.0
9386,faca931257ad2e92,eee7dafac7d672b5,fd5b6598a3b70c0a,2013-07-06,1,0,0,299,1,1,42,17,28,14,0,0,14,10,8,7,20,7,100.0,199.0
9387,faca931257ad2e92,fd5b6598a3b70c0a,eee7dafac7d672b5,2013-07-06,0,0,0,299,1,0,54,8,54,0,0,0,0,0,7,5,47,8,0.0,183.0
9388,c5de5c3633a0bfce,270b89c00ef0c55c,cbd6f1abf955e628,2013-07-06,1,0,0,17,0,0,3,3,1,2,0,0,2,2,0,0,1,1,3.0,14.0
9389,c5de5c3633a0bfce,cbd6f1abf955e628,270b89c00ef0c55c,2013-07-06,0,0,0,17,0,0,3,0,3,0,0,0,0,0,3,3,0,0,0.0,14.0
9390,c3601529b7a7d489,5f87a5c00b3d17ed,d247691a6c0e9034,2013-07-06,0,0,0,744,4,1,144,10,140,4,1,1,3,1,32,15,108,9,194.0,487.0
9391,c3601529b7a7d489,d247691a6c0e9034,5f87a5c00b3d17ed,2013-07-06,1,0,0,744,1,1,101,32,79,22,1,1,21,13,19,10,60,19,63.0,487.0
9392,b57f68fa967fa59e,3c660c90d48fc80d,a6bbd3df469c6bea,2013-07-06,0,0,0,900,4,2,92,21,75,17,0,0,17,11,43,33,32,10,170.5,499.6
9393,b57f68fa967fa59e,a6bbd3df469c6bea,3c660c90d48fc80d,2013-07-06,0,0,0,900,4,2,29,8,28,1,0,0,1,1,7,4,21,7,29.4,523.5
9394,a7cc5dc1a5c1e643,236a37d96d476164,8f3df4c579cfbb69,2013-07-06,1,0,0,475,4,0,41,11,33,8,0,0,8,4,7,6,26,7,93.3,195.0
9395,a7cc5dc1a5c1e643,8f3df4c579cfbb69,236a37d96d476164,2013-07-06,0,0,0,475,0,0,44,0,44,0,0,0,0,0,19,17,25,0,0.0,364.7
9396,9a6a6716cdfadc98,1f454354805b6f75,3a8176e15b9887c1,2013-07-06,0,0,0,378,0,0,24,4,24,0,0,0,0,0,12,10,12,4,0.0,263.0
9397,9a6a6716cdfadc98,3a8176e15b9887c1,1f454354805b6f75,2013-07-06,1,2,0,378,3,1,43,16,25,18,0,0,18,8,1,0,24,8,115.0,263.0
9398,8c124a6196e39ad8,179f1948dc234f1f,c80095f6092271a7,2013-07-06,0,2,0,900,10,5,102,36,38,64,28,26,36,26,10,7,28,10,416.4,305.7
9399,8c124a6196e39ad8,c80095f6092271a7,179f1948dc234f1f,2013-07-06,0,3,0,900,3,1,41,9,38,3,0,0,3,2,21,14,17,7,28.3,304.6
9400,86bbe429ae27d913,14ff46596ad80609,c4af2feb4b58bc3b,2013-07-06,0,0,0,900,13,2,128,50,126,2,0,0,2,2,23,18,103,48,70.8,617.0
9401,86bbe429ae27d913,c4af2feb4b58bc3b,14ff46596ad80609,2013-07-06,0,0,0,900,5,1,128,26,128,0,0,0,0,0,18,17,110,26,0.0,671.2
9402,701279417e0bf776,8a70ceb3edbe757b,d43a048a880efdff,2013-07-06,0,0,0,900,3,2,101,50,92,9,0,0,9,6,14,14,78,44,80.2,695.0
9403,701279417e0bf776,d43a048a880efdff,8a70ceb3edbe757b,2013-07-06,0,0,0,900,7,0,66,17,66,0,0,0,0,0,21,13,45,17,0.0,518.8
9404,6453b20a65c62cfe,07225ba28ae309b6,f2688492b9a525a3,2013-07-06,0,1,0,900,4,0,125,27,123,2,0,0,2,2,24,11,99,25,0.2,659.1
9405,6453b20a65c62cfe,f2688492b9a525a3,07225ba28ae309b6,2013-07-06,0,0,0,900,5,2,146,53,127,19,2,2,17,14,32,26,95,39,239.9,596.8
9406,005723fb99440272,15b1b21cd743d652,64a50dad704d1d49,2013-07-06,0,0,0,404,5,0,42,13,42,0,0,0,0,0,9,6,33,13,0.0,402.0
9407,005723fb99440272,64a50dad704d1d49,15b1b21cd743d652,2013-07-06,1,0,0,404,0,0,89,9,89,0,0,0,0,0,49,40,40,9,0.0,391.0
9408,c8ec6fd9aa2dcc23,1ccf4e7caff270df,ee779c43a8926d52,2013-06-15,0,0,0,900,0,0,91,24,90,1,0,0,1,1,17,16,73,23,0.0,899.0
9409,c8ec6fd9aa2dcc23,ee779c43a8926d52,1ccf4e7caff270df,2013-06-15,0,0,0,900,8,0,87,32,87,0,0,0,0,0,10,7,77,32,0.0,678.0
9410,a4daf2f24acdcd43,3f7c14c7eca7195d,d28dee5c705991df,2013-06-15,0,0,0,900,1,0,127,19,127,0,0,0,0,0,7,4,120,19,0.0,875.0
9411,a4daf2f24acdcd43,d28dee5c705991df,3f7c14c7eca7195d,2013-06-15,0,0,0,900,8,1,172,90,171,1,0,0,1,1,16,16,155,89,4.0,775.0
9412,8b08b73f16ff7b3b,173acb3f920082b8,bbfca6d5c27d9cd8,2013-06-15,0,2,0,900,11,6,45,22,19,26,0,0,26,17,1,0,18,5,543.1,133.1
9413,8b08b73f16ff7b3b,bbfca6d5c27d9cd8,173acb3f920082b8,2013-06-15,0,2,0,900,0,0,89,42,34,55,0,0,55,29,0,0,34,13,202.9,142.89999999999998
9414,63af858a04c1ad79,501b07aec9b8fc2d,8f6a18831a120817,2013-06-15,0,0,0,887,2,2,226,24,216,10,0,0,10,5,71,49,145,19,61.5,746.0
9415,63af858a04c1ad79,8f6a18831a120817,501b07aec9b8fc2d,2013-06-15,0,1,1,887,2,1,188,68,183,5,0,0,5,1,35,28,148,67,61.0,703.5
9416,5deeecb6aaa5dfd1,1a7745388839e52b,c76ec2bc3a57666a,2013-06-15,0,0,0,900,7,3,41,11,36,5,0,0,5,3,4,4,32,8,186.8,430.2
9417,5deeecb6aaa5dfd1,c76ec2bc3a57666a,1a7745388839e52b,2013-06-15,0,0,0,900,1,0,105,16,95,10,0,0,10,4,47,25,48,12,58.8,566.2
9418,4912788e449ce79a,4c2d90e335e6df19,5dfe71ade71f3a4b,2013-06-15,0,3,0,900,3,0,73,33,60,13,3,3,10,7,9,8,51,26,202.5,165.0
9419,4912788e449ce79a,5dfe71ade71f3a4b,4c2d90e335e6df19,2013-06-15,0,0,0,900,2,1,61,31,51,10,0,0,10,10,3,3,48,21,330.0,334.5
9420,44ca8997a3e5cda8,53278852bcd91e11,bc3ec52ef70fc155,2013-06-15,0,1,0,900,4,0,40,8,40,0,0,0,0,0,4,4,36,8,0.0,595.4
9421,44ca8997a3e5cda8,bc3ec52ef70fc155,53278852bcd91e11,2013-06-15,1,0,0,900,2,1,83,26,65,18,3,3,15,11,36,36,29,15,246.6,256.0
9422,43d1693f0198a93e,effd9de9937996f8,fe435e440b5de0ff,2013-06-15,0,0,0,900,0,0,94,11,94,0,0,0,0,0,52,49,42,11,0.0,775.0
9423,43d1693f0198a93e,fe435e440b5de0ff,effd9de9937996f8,2013-06-15,0,0,0,900,18,0,211,6,211,0,0,0,0,0,119,76,92,6,0.0,654.0
9424,27ff1bfeb2d50b38,658c3465581ae46b,ca2efc9d7d523c43,2013-06-15,0,0,0,59,0,0,3,1,3,0,0,0,0,0,1,1,2,1,0.0,54.0
9425,27ff1bfeb2d50b38,ca2efc9d7d523c43,658c3465581ae46b,2013-06-15,1,0,0,59,0,0,15,10,11,4,0,0,4,4,0,0,11,6,5.0,54.0
9426,19828eb12f6d41a8,55f80a8aeffcdb33,b4eeac608fc82f88,2013-06-15,0,7,0,900,2,1,18,11,10,8,0,0,8,7,5,4,5,4,208.0,188.8
9427,19828eb12f6d41a8,b4eeac608fc82f88,55f80a8aeffcdb33,2013-06-15,0,0,0,900,1,1,29,15,15,14,1,1,13,11,5,4,10,4,425.2,206.0
9428,177c1956907ed687,0d506315895efffc,6e0273f9478be71e,2013-06-15,0,0,0,900,1,0,92,32,83,9,1,1,8,3,4,3,79,29,68.2,533.3
9429,177c1956907ed687,6e0273f9478be71e,0d506315895efffc,2013-06-15,0,0,0,900,6,1,119,47,97,22,2,1,20,9,19,17,78,38,275.7,430.8
9430,f5ebfe526cf409e8,2f13e4020cea5b38,8bb6f4479685bbcc,2013-06-08,0,1,1,411,5,3,54,10,39,15,8,7,7,4,6,0,33,6,145.0,237.0
9431,f5ebfe526cf409e8,8bb6f4479685bbcc,2f13e4020cea5b38,2013-06-08,0,0,0,411,1,0,27,3,27,0,0,0,0,0,12,11,15,3,0.0,264.0
9432,d03618c86d395b43,71002dbc1743b9a7,fa37628269132d1a,2013-06-08,1,0,0,212,0,0,35,26,1,34,0,0,34,26,1,1,0,0,131.0,20.0
9433,d03618c86d395b43,fa37628269132d1a,71002dbc1743b9a7,2013-06-08,0,0,0,212,2,1,13,4,3,10,0,0,10,3,0,0,3,1,61.0,20.0
9434,c25c2000aa99832c,b71ce838b01f2cad,cfaf010d5b389c09,2013-06-08,0,1,1,84,0,0,8,7,3,5,0,0,5,5,0,0,3,2,0.0,40.0
9435,c25c2000aa99832c,cfaf010d5b389c09,b71ce838b01f2cad,2013-06-08,0,0,0,84,1,1,4,3,1,3,1,1,2,2,0,0,1,1,44.0,40.0
9436,bd9100f5d4ee6823,9c65736747ca92ec,ed74afc8b5b47a61,2013-06-08,0,1,1,583,7,1,46,16,41,5,0,0,5,3,7,6,34,13,58.6,350.2
9437,bd9100f5d4ee6823,ed74afc8b5b47a61,9c65736747ca92ec,2013-06-08,0,0,0,583,4,2,57,22,39,18,1,1,17,10,12,12,27,12,150.8,281.4
9438,b6d027c60f879e4a,159da492e000afbf,7c6e87729e824ef4,2013-06-08,0,0,0,900,6,0,87,19,87,0,0,0,0,0,41,31,46,19,0.0,730.5
9439,b6d027c60f879e4a,7c6e87729e824ef4,159da492e000afbf,2013-06-08,0,0,0,900,3,3,105,17,102,3,0,0,3,1,16,16,86,16,91.5,717.0
9440,8c1787fe568f1ca6,49e49b54e5901d0d,7e47047d0971d566,2013-06-08,0,0,0,140,0,0,12,3,12,0,0,0,0,0,2,1,10,3,0.0,118.0
9441,8c1787fe568f1ca6,7e47047d0971d566,49e49b54e5901d0d,2013-06-08,0,1,1,140,1,1,9,5,9,0,0,0,0,0,3,3,6,5,0.0,74.0
9442,8857bf28823b1b2d,492b202d2064e7a9,ee9d73f4fee9cbdd,2013-06-08,0,1,1,461,2,1,37,18,31,6,1,1,5,5,13,13,18,13,85.0,291.0
9443,8857bf28823b1b2d,ee9d73f4fee9cbdd,492b202d2064e7a9,2013-06-08,0,0,0,461,1,0,40,12,40,0,0,0,0,0,3,2,37,12,0.0,253.0
9444,66b295262ef7ee91,d4c9dcd330403612,fae67903c4fe636b,2013-06-08,0,0,0,112,0,0,19,2,19,0,0,0,0,0,5,3,14,2,0.0,108.0
9445,66b295262ef7ee91,fae67903c4fe636b,d4c9dcd330403612,2013-06-08,0,1,1,112,3,1,15,5,15,0,0,0,0,0,2,1,13,5,0.0,85.0
9446,401a21d881a1f26a,0c5c66ddd1886b83,d23ccf4a6c221284,2013-06-08,0,5,1,469,2,1,37,14,13,24,5,3,19,11,5,4,8,3,108.4,32.0
9447,401a21d881a1f26a,d23ccf4a6c221284,0c5c66ddd1886b83,2013-06-08,0,0,0,469,6,2,52,28,4,48,2,2,46,27,0,0,4,1,288.0,66.6
9448,291bebbbf4f9128f,35faad160d346839,a20d7dfaba74c067,2013-06-08,0,0,0,900,1,0,199,60,199,0,0,0,0,0,46,42,153,60,0.0,900.0
9449,291bebbbf4f9128f,a20d7dfaba74c067,35faad160d346839,2013-06-08,0,0,0,900,7,2,162,51,162,0,0,0,0,0,34,25,128,51,0.0,796.0
9450,2692ac9853970e08,2924886ee9c4c527,5c1ca0c72b599a3c,2013-06-08,1,0,0,269,0,0,75,23,73,2,0,0,2,2,18,14,55,21,3.0,266.0
9451,2692ac9853970e08,5c1ca0c72b599a3c,2924886ee9c4c527,2013-06-08,0,0,0,269,0,0,61,20,61,0,0,0,0,0,7,4,54,20,0.0,266.0
9452,0e272af30a23e09b,5866fc86183a9fb8,e5d03e4d966126bd,2013-06-08,0,1,1,71,0,0,1,0,1,0,0,0,0,0,0,0,1,0,0.0,53.0
9453,0e272af30a23e09b,e5d03e4d966126bd,5866fc86183a9fb8,2013-06-08,0,0,0,71,1,0,6,0,6,0,0,0,0,0,2,0,4,0,0.0,58.0
9454,e1d33aa47b35d021,032cc3922d871c7f,e14b5aa06eea9653,2013-05-25,0,2,0,900,27,21,40,16,15,25,4,4,21,11,4,3,11,5,542.2,217.1
9455,e1d33aa47b35d021,e14b5aa06eea9653,032cc3922d871c7f,2013-05-25,0,0,0,900,1,1,30,8,25,5,1,1,4,2,2,2,23,6,53.9,260.79999999999995
9456,d51757fe7dd89f2d,0ff11cc094e887bc,8349d55cdecd393a,2013-05-25,1,0,0,81,2,0,28,16,16,12,0,0,12,11,2,2,14,5,10.2,70.0
9457,d51757fe7dd89f2d,8349d55cdecd393a,0ff11cc094e887bc,2013-05-25,0,0,0,81,0,0,3,1,3,0,0,0,0,0,0,0,3,1,0.0,70.8
9458,d236fe0f180312e3,5b5307450405abf0,f5990c11974d8e9c,2013-05-25,1,0,0,900,7,3,111,31,77,34,0,0,34,18,38,26,39,13,321.9,327.2
9459,d236fe0f180312e3,f5990c11974d8e9c,5b5307450405abf0,2013-05-25,0,2,0,900,0,0,74,24,72,2,0,0,2,2,13,9,59,22,4.8,554.1
9460,a6ba04a54eb7e8fa,2c64c035485906aa,4a28cb716c19157a,2013-05-25,0,0,0,900,1,0,121,26,121,0,0,0,0,0,39,30,82,26,0.0,860.0
9461,a6ba04a54eb7e8fa,4a28cb716c19157a,2c64c035485906aa,2013-05-25,0,0,0,900,4,2,134,30,134,0,0,0,0,0,44,35,90,30,0.0,522.0
9462,9dd931fd20d6c886,7d96bc577e5178b2,a26198ba5093147e,2013-05-25,0,0,0,127,0,0,28,13,28,0,0,0,0,0,1,0,27,13,0.0,122.2
9463,9dd931fd20d6c886,a26198ba5093147e,7d96bc577e5178b2,2013-05-25,3,0,0,127,0,0,52,22,43,9,0,0,9,4,4,4,39,18,4.8,112.0
9464,5f87dc7d18517d87,7ff97850e8c32bda,f5431394fb284bb9,2013-05-25,0,1,1,158,2,1,22,11,17,5,0,0,5,4,1,1,16,7,73.3,70.0
9465,5f87dc7d18517d87,f5431394fb284bb9,7ff97850e8c32bda,2013-05-25,0,0,0,158,0,0,21,4,21,0,0,0,0,0,4,4,17,4,0.0,78.7
9466,3f19bab8de698eb0,1d00756835ca67c9,b7ffa72aa148599a,2013-05-25,0,0,0,900,7,4,152,51,118,34,4,3,30,19,33,24,85,32,295.8,552.0
9467,3f19bab8de698eb0,b7ffa72aa148599a,1d00756835ca67c9,2013-05-25,0,0,0,900,0,0,122,17,122,0,0,0,0,0,51,25,71,17,0.0,604.2
9468,3333fdbe86a763fb,2e25c1d983c26311,e1147d3d2dabe1ce,2013-05-25,1,1,0,641,6,0,91,18,91,0,0,0,0,0,22,15,69,18,0.0,636.3
9469,3333fdbe86a763fb,e1147d3d2dabe1ce,2e25c1d983c26311,2013-05-25,2,0,0,641,1,1,113,53,110,3,0,0,3,2,0,0,110,51,1.7,627.0
9470,19d6c7f5263c9398,63def5a5662a6917,eef9b891edbd4604,2013-05-25,2,0,0,858,1,1,131,54,124,7,1,1,6,5,24,19,100,49,43.5,771.0
9471,19d6c7f5263c9398,eef9b891edbd4604,63def5a5662a6917,2013-05-25,0,0,0,858,0,0,99,20,99,0,0,0,0,0,16,9,83,20,0.0,814.5
9472,172dfd6cab9b627b,18968f97ad34f15c,d0a5ef38a7778ac2,2013-05-25,0,1,0,900,10,6,88,24,60,28,12,10,16,14,23,15,37,10,493.2,352.6
9473,172dfd6cab9b627b,d0a5ef38a7778ac2,18968f97ad34f15c,2013-05-25,0,1,0,900,0,0,94,14,93,1,0,0,1,0,24,11,69,14,1.4,389.8
9474,149a0b38fa02e647,150ff4cc642270b9,6f242453c91a5af0,2013-05-25,0,0,0,900,1,0,193,64,193,0,0,0,0,0,20,11,173,64,0.0,736.0
9475,149a0b38fa02e647,6f242453c91a5af0,150ff4cc642270b9,2013-05-25,0,0,0,900,9,4,225,47,195,30,0,0,30,16,31,26,164,31,156.0,692.0
9476,1260d0031a5e469d,3c0437fbeda06962,b26d3e3746fb4024,2013-05-25,1,0,0,403,0,0,100,32,87,13,1,1,12,9,19,11,68,23,23.7,332.8
9477,1260d0031a5e469d,b26d3e3746fb4024,3c0437fbeda06962,2013-05-25,1,1,0,403,0,0,72,20,68,4,0,0,4,3,7,4,61,17,39.2,330.3
9478,edc4e54d5258eea8,03c9994c5b8958ec,75e5fec9f72910ef,2013-05-18,0,0,0,454,1,0,26,2,26,0,0,0,0,0,11,7,15,2,0.0,436.1
9479,edc4e54d5258eea8,75e5fec9f72910ef,03c9994c5b8958ec,2013-05-18,0,1,1,454,4,2,67,15,66,1,0,0,1,1,8,6,58,14,10.9,367.0
9480,eacfc05c3e5ead5e,7413b80dbb0f8f9f,c3bd649a9194e50c,2013-05-18,1,0,0,613,0,0,111,28,109,2,0,0,2,2,11,11,98,26,0.5,563.4
9481,eacfc05c3e5ead5e,c3bd649a9194e50c,7413b80dbb0f8f9f,2013-05-18,1,0,0,613,7,2,108,48,102,6,0,0,6,4,6,4,96,44,45.6,407.5
9482,cf5f9da861c5e63f,6fb1ba67bef41b37,ed209f6618c82e41,2013-05-18,1,0,0,900,17,4,95,34,71,24,2,2,22,17,9,6,62,17,316.2,408.0
9483,cf5f9da861c5e63f,ed209f6618c82e41,6fb1ba67bef41b37,2013-05-18,0,1,0,900,3,1,86,36,82,4,0,0,4,4,5,4,77,32,44.0,363.8
9484,caa56c26127bf7e8,b102c26727306ab6,b2e3aca4cd363477,2013-05-18,0,0,0,900,8,4,26,5,20,6,1,1,5,4,5,4,15,1,530.0,321.9
9485,caa56c26127bf7e8,b2e3aca4cd363477,b102c26727306ab6,2013-05-18,0,1,0,900,1,1,90,15,71,19,0,0,19,9,21,11,50,6,48.1,289.0
9486,ac269f99e4e53634,6c2030e0a143a94b,7a703c565ccaa18f,2013-05-18,0,0,0,217,0,0,14,3,14,0,0,0,0,0,1,1,13,3,0.0,65.80000000000001
9487,ac269f99e4e53634,7a703c565ccaa18f,6c2030e0a143a94b,2013-05-18,0,1,1,217,3,1,16,8,7,9,0,0,9,6,2,0,5,2,142.2,59.0
9488,91f33ac24fb39eca,a8283a4f415e1eb9,af90b10c785ced3e,2013-05-18,0,1,1,188,1,1,8,3,8,0,0,0,0,0,4,2,4,3,0.0,131.0
9489,91f33ac24fb39eca,af90b10c785ced3e,a8283a4f415e1eb9,2013-05-18,0,0,0,188,3,1,11,1,11,0,0,0,0,0,6,4,5,1,0.0,128.0
9490,8aff100107d0ba11,a1b0715c4fd2dbd3,c268b2cfebccf652,2013-05-18,0,0,0,367,3,0,38,5,36,2,0,0,2,2,5,2,31,3,0.7,278.3
9491,8aff100107d0ba11,c268b2cfebccf652,a1b0715c4fd2dbd3,2013-05-18,3,0,0,367,0,0,80,21,56,24,4,2,20,9,16,13,40,12,87.7,260.3
9492,59bb17087b12ad35,0dba4df5f34d5ff0,be4076c9e8d791e3,2013-05-18,0,0,0,900,2,1,67,17,44,23,2,2,21,14,19,10,25,3,239.9,608.0
9493,59bb17087b12ad35,be4076c9e8d791e3,0dba4df5f34d5ff0,2013-05-18,0,2,0,900,2,0,40,12,40,0,0,0,0,0,7,2,33,12,0.0,639.1
9494,4b4c4df2778538d9,30a09e43f15f1d75,e51fcd9cd84c0b93,2013-05-18,0,0,0,900,4,2,92,22,79,13,2,1,11,7,25,23,54,15,63.8,697.7
9495,4b4c4df2778538d9,e51fcd9cd84c0b93,30a09e43f15f1d75,2013-05-18,0,0,0,900,12,3,63,15,62,1,0,0,1,1,22,15,40,14,40.3,554.2
9496,11249454ed5fd71f,1fb80f46d3c105d9,27d65e9d0fba61ea,2013-05-18,0,0,0,900,2,1,151,44,142,9,2,2,7,6,66,54,76,38,20.0,687.9
9497,11249454ed5fd71f,27d65e9d0fba61ea,1fb80f46d3c105d9,2013-05-18,0,0,0,900,7,2,44,14,43,1,0,0,1,1,17,15,26,13,14.1,613.0
9498,110d18c0953bde1d,00e11b5c8b7bfeeb,0ee783aa00e468f0,2013-05-18,0,0,0,152,1,0,15,2,15,0,0,0,0,0,7,4,8,2,0.0,139.0
9499,110d18c0953bde1d,0ee783aa00e468f0,00e11b5c8b7bfeeb,2013-05-18,1,0,0,152,0,0,20,8,14,6,0,0,6,5,2,1,12,3,13.0,139.0
9500,05f8696303709939,6a2f7c151031653d,e5c9de15bb58b1c6,2013-05-18,0,0,0,900,2,0,183,35,183,0,0,0,0,0,46,31,137,35,0.0,830.2
9501,05f8696303709939,e5c9de15bb58b1c6,6a2f7c151031653d,2013-05-18,0,0,0,900,7,3,270,60,266,4,1,0,3,2,16,8,250,58,27.8,740.0
9502,019b88d4ac875ae4,14aa21bc82cac57d,2f95a3c6d58b2aad,2013-05-18,0,0,0,151,2,0,10,0,10,0,0,0,0,0,6,3,4,0,0.0,122.1
9503,019b88d4ac875ae4,2f95a3c6d58b2aad,14aa21bc82cac57d,2013-05-18,1,0,0,151,0,0,37,16,30,7,0,0,7,6,3,3,27,10,3.9,146.0
9504,fb30b2752d3dc1eb,7be74a12d7352df2,837d30395faca41e,2013-04-27,1,0,0,246,2,2,9,7,2,7,1,1,6,6,0,0,2,1,227.0,19.0
9505,fb30b2752d3dc1eb,837d30395faca41e,7be74a12d7352df2,2013-04-27,0,0,0,246,0,0,12,1,12,0,0,0,0,0,8,6,4,1,0.0,18.0
9506,c29850ed8d9d1073,88a9bc81271ccd89,902ab9197b83d0db,2013-04-27,0,0,0,900,3,1,151,14,149,2,0,0,2,0,29,15,120,14,20.0,861.7
9507,c29850ed8d9d1073,902ab9197b83d0db,88a9bc81271ccd89,2013-04-27,0,0,0,900,1,0,268,72,267,1,0,0,1,0,15,7,252,72,18.3,825.0
9508,bb59b82bddc96cca,50d2f0018bcf9eef,d1941565abf50b16,2013-04-27,0,2,0,842,7,5,95,41,65,30,2,1,28,16,14,11,51,25,245.2,298.7
9509,bb59b82bddc96cca,d1941565abf50b16,50d2f0018bcf9eef,2013-04-27,0,0,0,842,1,1,57,18,44,13,0,0,13,12,12,9,32,6,118.3,414.8
9510,8151421edf24a821,07f72a2a7591b409,48d1f690b763934c,2013-04-27,1,0,0,273,6,3,27,16,8,19,2,2,17,13,3,2,5,3,179.8,27.0
9511,8151421edf24a821,48d1f690b763934c,07f72a2a7591b409,2013-04-27,0,0,0,273,0,0,15,0,15,0,0,0,0,0,10,6,5,0,0.0,93.19999999999999
9512,6d6a1834e0d18f0c,a7151778b3381036,d188a3b817860ec6,2013-04-27,0,2,0,900,2,1,92,13,79,13,8,6,5,4,26,22,53,9,121.5,422.5
9513,6d6a1834e0d18f0c,d188a3b817860ec6,a7151778b3381036,2013-04-27,0,2,0,900,4,1,109,36,84,25,3,2,22,11,14,12,70,25,178.5,371.5
9514,59ad5b88804afbf5,813550bc53b15fb0,9b7694d064a8a0ad,2013-04-27,0,0,0,152,0,0,18,1,18,0,0,0,0,0,6,3,12,1,0.0,152.0
9515,59ad5b88804afbf5,9b7694d064a8a0ad,813550bc53b15fb0,2013-04-27,1,0,0,152,2,1,17,2,17,0,0,0,0,0,4,1,13,2,0.0,135.0
9516,523e8ca343a0becc,50db8711c70196cd,fcd448a2fe1a23cc,2013-04-27,0,0,0,633,2,0,84,33,84,0,0,0,0,0,19,14,65,33,0.0,591.0
9517,523e8ca343a0becc,fcd448a2fe1a23cc,50db8711c70196cd,2013-04-27,0,0,0,633,4,0,50,5,50,0,0,0,0,0,36,23,14,5,0.0,562.0
9518,44ad16cd4e6c93d7,7be63795363029e8,917e53fa0adea0d3,2013-04-27,0,4,0,900,13,5,54,27,44,10,0,0,10,10,6,3,38,17,344.4,339.0
9519,44ad16cd4e6c93d7,917e53fa0adea0d3,7be63795363029e8,2013-04-27,0,0,0,900,0,0,77,10,75,2,2,2,0,0,5,3,70,10,10.0,535.6
9520,372a0456aa4ff6cf,5ef0088c1b19beeb,ffc3e6daaa6da0b7,2013-04-27,0,1,1,884,7,3,108,38,107,1,0,0,1,1,9,5,98,37,190.5,503.0
9521,372a0456aa4ff6cf,ffc3e6daaa6da0b7,5ef0088c1b19beeb,2013-04-27,0,0,0,884,1,0,131,30,131,0,0,0,0,0,23,20,108,30,0.0,673.5
9522,1ac61e415deca2fe,2b93ebd9f5417ad2,4130a743d9d22163,2013-04-27,0,0,0,871,0,0,225,64,225,0,0,0,0,0,38,29,187,64,0.0,863.0
9523,1ac61e415deca2fe,4130a743d9d22163,2b93ebd9f5417ad2,2013-04-27,0,0,0,871,3,0,150,11,150,0,0,0,0,0,39,18,111,11,0.0,871.0
9524,04e6a26fe2a4017d,1eacf73d6a0055dc,3f7c14c7eca7195d,2013-04-27,0,0,0,123,0,0,6,0,6,0,0,0,0,0,4,4,2,0,0.0,99.3
9525,04e6a26fe2a4017d,3f7c14c7eca7195d,1eacf73d6a0055dc,2013-04-27,1,0,0,123,0,0,5,2,4,1,0,0,1,1,1,0,3,1,23.7,52.0
9526,d13ea6559225991f,92a9aa9c93192871,b5b684eac99ae0a3,2013-04-20,0,0,0,68,0,0,29,1,29,0,0,0,0,0,1,1,28,1,0.0,65.0
9527,d13ea6559225991f,b5b684eac99ae0a3,92a9aa9c93192871,2013-04-20,1,0,0,68,0,0,14,5,11,3,0,0,3,2,2,2,9,3,3.0,65.0
9528,c8a48abe3263f796,5abf827d62f98fee,f77c68bb4be8516d,2013-04-20,0,0,0,92,0,0,18,1,18,0,0,0,0,0,4,2,14,1,0.0,89.0
9529,c8a48abe3263f796,f77c68bb4be8516d,5abf827d62f98fee,2013-04-20,1,0,0,92,1,0,12,6,8,4,0,0,4,4,6,6,2,2,3.0,89.0
9530,b229ee2997b70d16,c849740a3ff51931,f95381efb3051d81,2013-04-20,1,0,0,262,3,1,44,16,41,3,0,0,3,3,5,5,36,13,37.2,200.0
9531,b229ee2997b70d16,f95381efb3051d81,c849740a3ff51931,2013-04-20,0,0,0,262,0,0,34,8,34,0,0,0,0,0,4,3,30,8,0.0,224.8
9532,a6797238f9f98644,6546af7ab545b90c,80eacd4da0617c57,2013-04-20,0,0,0,590,2,0,33,6,31,2,0,0,2,1,9,5,22,5,13.0,467.5
9533,a6797238f9f98644,80eacd4da0617c57,6546af7ab545b90c,2013-04-20,2,0,0,590,2,2,153,35,133,20,5,4,15,2,22,18,111,33,96.5,466.0
9534,786033c27fdaa020,47b9e0e7703a4868,4b47e71384a9522f,2013-04-20,0,0,0,900,8,6,132,38,68,64,6,6,58,21,10,6,58,17,410.0,441.9
9535,786033c27fdaa020,4b47e71384a9522f,47b9e0e7703a4868,2013-04-20,0,0,0,900,1,0,133,33,90,43,0,0,43,17,19,10,71,16,16.1,472.0
9536,704adfae22d0dfb8,08e908ed6d18d6a0,22aa91e402d0fe1f,2013-04-20,1,0,0,362,2,2,24,3,21,3,0,0,3,2,7,2,14,1,137.0,86.0
9537,704adfae22d0dfb8,22aa91e402d0fe1f,08e908ed6d18d6a0,2013-04-20,0,0,0,362,1,1,28,3,26,2,0,0,2,1,6,3,20,2,139.0,86.0
9538,6599a94704d56719,2676b28836a5a836,aa5b4eff51bdc7d1,2013-04-20,0,0,0,1500,4,0,166,20,163,3,1,1,2,1,55,47,108,19,16.3,1404.0
9539,6599a94704d56719,aa5b4eff51bdc7d1,2676b28836a5a836,2013-04-20,0,0,0,1500,1,1,191,16,188,3,1,1,2,0,35,26,153,16,9.0,1432.7
9540,56ce29bdb1fe9abf,8355922d564b152c,a566371ba2ad7152,2013-04-20,0,1,0,524,1,1,74,17,71,3,0,0,3,2,9,4,62,15,16.2,426.2
9541,56ce29bdb1fe9abf,a566371ba2ad7152,8355922d564b152c,2013-04-20,1,0,0,524,1,1,71,23,51,20,2,1,18,9,19,12,32,14,43.8,426.8
9542,56ad1de1924984ad,3b9f723e2720a238,6bf5a7d3e081ade2,2013-04-20,0,0,0,472,1,1,76,15,73,3,0,0,3,3,21,12,52,12,23.1,417.6
9543,56ad1de1924984ad,6bf5a7d3e081ade2,3b9f723e2720a238,2013-04-20,1,0,0,472,1,0,46,15,45,1,0,0,1,0,13,11,32,15,0.4,446.9
9544,4dd561df1ca58ab8,1ff9589f9065a9ed,d967f0128c323de6,2013-04-20,0,0,0,900,0,0,60,5,59,1,0,0,1,1,22,19,37,4,1.1,882.0
9545,4dd561df1ca58ab8,d967f0128c323de6,1ff9589f9065a9ed,2013-04-20,0,0,0,900,1,0,96,27,96,0,0,0,0,0,39,32,57,27,0.0,444.9
9546,3566c8e9d3a9caa8,3591d0d5d382a381,9450848a71d53776,2013-04-20,0,0,0,900,11,2,75,8,75,0,0,0,0,0,17,4,58,8,0.0,582.5
9547,3566c8e9d3a9caa8,9450848a71d53776,3591d0d5d382a381,2013-04-20,0,0,0,900,0,0,82,11,81,1,0,0,1,1,36,21,45,10,0.5,892.0
9548,004885f7983f4658,2aa49b3766a59bcd,31123249b0bbf52e,2013-04-20,1,0,0,360,0,0,58,18,46,12,0,0,12,6,9,6,37,12,65.2,257.8
9549,004885f7983f4658,31123249b0bbf52e,2aa49b3766a59bcd,2013-04-20,1,1,0,360,1,0,84,27,71,13,5,5,8,6,12,8,59,21,15.2,259.8
9550,f286aad7b3558b21,65578a75fa7900e3,8c0580d4fff106c1,2013-04-13,0,0,0,900,3,2,77,23,68,9,0,0,9,8,26,21,42,15,60.4,616.9
9551,f286aad7b3558b21,8c0580d4fff106c1,65578a75fa7900e3,2013-04-13,0,0,0,900,6,3,74,7,64,10,1,1,9,2,24,23,40,5,169.1,450.6
9552,dc85144d1d945076,54ed8dc6f8c31207,5cafbc97dba2e797,2013-04-13,0,1,0,769,5,3,34,6,34,0,0,0,0,0,10,8,24,6,0.0,312.8
9553,dc85144d1d945076,5cafbc97dba2e797,54ed8dc6f8c31207,2013-04-13,0,3,1,769,0,0,54,26,42,12,2,2,10,9,9,7,33,17,226.2,392.0
9554,b4d0659f60c8aa7c,0b64d0fed453ef7f,78114b7199cef90c,2013-04-13,0,0,0,1096,6,1,168,45,168,0,0,0,0,0,32,28,136,45,0.0,890.8
9555,b4d0659f60c8aa7c,78114b7199cef90c,0b64d0fed453ef7f,2013-04-13,0,3,1,1096,6,4,163,57,161,2,0,0,2,1,40,36,121,56,76.2,791.0
9556,ae0fdb792308b0f8,361d49960a196976,879f6cae48d25baa,2013-04-13,0,1,1,95,3,2,2,0,2,0,0,0,0,0,1,1,1,0,0.0,16.0
9557,ae0fdb792308b0f8,879f6cae48d25baa,361d49960a196976,2013-04-13,0,0,0,95,0,0,2,0,2,0,0,0,0,0,0,0,2,0,0.0,95.0
9558,adf590055f922f5b,00debc804e2b1cd4,ddbe4fa2ea573393,2013-04-13,1,0,0,202,0,0,24,20,9,15,0,0,15,12,0,0,9,8,6.3,194.0
9559,adf590055f922f5b,ddbe4fa2ea573393,00debc804e2b1cd4,2013-04-13,0,0,0,202,4,1,10,5,10,0,0,0,0,0,2,2,8,5,0.0,28.7
9560,8c8468ed2878dc0a,16bf6a73bdd302cd,172c2135e70f87b7,2013-04-13,0,0,0,900,12,2,212,67,212,0,0,0,0,0,49,28,163,67,0.0,682.2
9561,8c8468ed2878dc0a,172c2135e70f87b7,16bf6a73bdd302cd,2013-04-13,0,1,0,900,2,1,232,93,229,3,0,0,3,2,29,20,200,91,4.8,858.0
9562,5ba1e6f5519074c9,270b89c00ef0c55c,3236bf606fe9fa5b,2013-04-13,0,0,0,71,2,0,1,0,1,0,0,0,0,0,1,1,0,0,0.0,13.0
9563,5ba1e6f5519074c9,3236bf606fe9fa5b,270b89c00ef0c55c,2013-04-13,1,0,0,71,0,0,10,7,10,0,0,0,0,0,2,2,8,7,0.0,71.0
9564,5067fe22dbc4baff,8d9586726252dbf7,9deff9e3e8d94d47,2013-04-13,0,2,0,437,1,0,22,9,6,16,3,2,13,9,4,3,2,0,162.5,216.1
9565,5067fe22dbc4baff,9deff9e3e8d94d47,8d9586726252dbf7,2013-04-13,1,0,0,437,0,0,62,13,50,12,1,1,11,4,28,22,22,9,27.9,137.5
9566,4f850f7e35d85bb8,282fa667ff9c51ed,4304992c2acc187b,2013-04-13,0,1,1,263,1,1,43,1,43,0,0,0,0,0,7,4,36,1,0.0,219.0
9567,4f850f7e35d85bb8,4304992c2acc187b,282fa667ff9c51ed,2013-04-13,0,0,0,263,0,0,62,7,61,1,0,0,1,1,14,11,47,6,0.0,263.0
9568,40a43ffdd1624bed,92b62174c175ce19,a17322f99ddfd8e9,2013-04-13,2,0,0,833,1,0,143,50,125,18,1,1,17,12,24,15,101,38,55.9,715.0
9569,40a43ffdd1624bed,a17322f99ddfd8e9,92b62174c175ce19,2013-04-13,0,0,0,833,9,3,81,17,81,0,0,0,0,0,4,4,77,17,0.0,633.1
9570,2594287e8fa31404,3ecd936bd8814108,b96619b3acd7d9da,2013-04-13,1,1,0,775,1,1,42,23,31,11,2,2,9,9,10,10,21,14,194.2,224.7
9571,2594287e8fa31404,b96619b3acd7d9da,3ecd936bd8814108,2013-04-13,0,3,0,775,7,3,42,21,34,8,0,0,8,5,2,2,32,16,197.3,284.8
9572,0a5a021cb11299bf,4a1329cc8eb0928a,b8aef0faf4ce9b31,2013-04-13,0,1,0,900,4,2,145,39,144,1,0,0,1,0,32,13,112,39,15.0,653.2
9573,0a5a021cb11299bf,b8aef0faf4ce9b31,4a1329cc8eb0928a,2013-04-13,0,1,0,900,7,1,99,19,96,3,1,0,2,1,8,7,88,18,21.8,754.0
9574,fa520c5834cda94e,46fd223e3ced39b3,4f732e58ed907eff,2013-04-06,0,0,0,525,7,1,77,7,77,0,0,0,0,0,39,22,38,7,0.0,330.3
9575,fa520c5834cda94e,4f732e58ed907eff,46fd223e3ced39b3,2013-04-06,1,0,0,525,1,1,41,22,35,6,0,0,6,3,6,6,29,19,6.7,515.0
9576,f3ebaf9af44c1e6d,8e5bfd4e82352340,c2e3e67b5911bfb7,2013-04-06,0,0,0,207,2,1,14,2,14,0,0,0,0,0,2,2,12,2,0.0,131.2
9577,f3ebaf9af44c1e6d,c2e3e67b5911bfb7,8e5bfd4e82352340,2013-04-06,0,1,1,207,0,0,18,4,15,3,0,0,3,2,7,5,8,2,75.8,106.0
9578,e67e15cc6578d1c3,98ec9f385cca47fc,c9f6385af6df66d7,2013-04-06,0,0,0,900,3,2,79,22,78,1,0,0,1,0,24,21,54,22,4.4,492.2
9579,e67e15cc6578d1c3,c9f6385af6df66d7,98ec9f385cca47fc,2013-04-06,0,0,0,900,6,4,80,14,55,25,11,7,14,9,38,32,17,5,142.8,558.6
9580,bc0779b232828e67,511e82663651438d,e25bcbcdaf6537a1,2013-04-06,1,0,0,693,0,0,64,13,53,11,0,0,11,5,11,7,42,8,67.2,216.0
9581,bc0779b232828e67,e25bcbcdaf6537a1,511e82663651438d,2013-04-06,0,2,1,693,6,4,46,33,9,37,0,0,37,32,2,1,7,1,367.0,258.8
9582,a89b9eeacdb85ec1,6ef65b6a152e49d5,ba280572acfba13f,2013-04-06,0,0,0,19,2,0,2,0,2,0,0,0,0,0,0,0,2,0,0.0,16.0
9583,a89b9eeacdb85ec1,ba280572acfba13f,6ef65b6a152e49d5,2013-04-06,1,0,0,19,0,0,9,7,3,6,0,0,6,6,0,0,3,1,3.0,16.0
9584,9eb1ce435cc1536e,1e327b281ef6a745,411d012af19ecb59,2013-04-06,0,0,0,900,10,6,99,12,93,6,0,0,6,2,46,26,47,10,73.4,631.0
9585,9eb1ce435cc1536e,411d012af19ecb59,1e327b281ef6a745,2013-04-06,0,0,0,900,0,0,57,1,57,0,0,0,0,0,13,4,44,1,0.0,826.6
9586,8b0ff8defc1a14f4,4c7781da8c6cae93,c4fe2e9a06ea5bcb,2013-04-06,0,1,0,900,8,6,90,23,72,18,0,0,18,8,24,14,48,15,177.6,288.7
9587,8b0ff8defc1a14f4,c4fe2e9a06ea5bcb,4c7781da8c6cae93,2013-04-06,0,0,0,900,2,1,28,7,27,1,0,0,1,1,5,2,22,6,29.3,634.4
9588,7047b70f28c2d2fd,8abf70f79e9e27c2,b27b8881d7444114,2013-04-06,0,1,1,191,1,1,11,5,7,4,0,0,4,4,3,1,4,1,141.0,50.0
9589,7047b70f28c2d2fd,b27b8881d7444114,8abf70f79e9e27c2,2013-04-06,0,0,0,191,0,0,12,1,12,0,0,0,0,0,4,1,8,1,0.0,50.0
9590,53467e6296c2e5e6,3f52ce18fb98008f,960d6cae8879ba2b,2013-04-06,0,0,0,900,6,2,86,18,86,0,0,0,0,0,37,30,49,18,0.0,616.4
9591,53467e6296c2e5e6,960d6cae8879ba2b,3f52ce18fb98008f,2013-04-06,0,0,0,900,2,0,144,29,139,5,2,2,3,3,44,36,95,26,13.6,769.0
9592,4e69c86d09c9f782,bc7230f231701d66,c945adc22c2bfe8f,2013-04-06,0,0,0,900,8,3,155,44,152,3,0,0,3,1,36,27,116,43,14.1,734.3
9593,4e69c86d09c9f782,c945adc22c2bfe8f,bc7230f231701d66,2013-04-06,0,0,0,900,7,4,205,50,203,2,0,0,2,0,22,18,181,50,15.7,611.9
9594,438f5404c43303b8,4d44f37107f01b9b,b7f38813485745da,2013-04-06,0,1,1,365,7,0,13,4,13,0,0,0,0,0,3,3,10,4,0.0,102.1
9595,438f5404c43303b8,b7f38813485745da,4d44f37107f01b9b,2013-04-06,0,0,0,365,3,3,29,11,14,15,0,0,15,9,8,3,6,2,92.9,235.0
9596,3509779ebe302d06,232c582f29f8f65e,e9a3aeb207578eea,2013-04-06,0,0,0,900,0,0,150,62,148,2,0,0,2,1,30,18,118,61,6.0,867.4
9597,3509779ebe302d06,e9a3aeb207578eea,232c582f29f8f65e,2013-04-06,0,0,0,900,3,1,112,11,106,6,0,0,6,2,11,7,95,9,26.6,863.0
9598,24393bea0c4cf49a,81801f57bd0a7c41,f4c49976c75c5ab2,2013-04-06,0,0,0,67,0,0,41,7,41,0,0,0,0,0,7,5,34,7,0.0,62.0
9599,24393bea0c4cf49a,f4c49976c75c5ab2,81801f57bd0a7c41,2013-04-06,1,0,0,67,0,0,35,20,29,6,0,0,6,5,1,1,28,15,5.0,62.0
9600,e5e3c3a055df3016,6506c1d34da9c013,f57a8a52ca401ed9,2013-03-16,0,0,0,1500,16,9,167,69,118,49,8,8,41,24,36,28,82,45,661.9,676.0
9601,e5e3c3a055df3016,f57a8a52ca401ed9,6506c1d34da9c013,2013-03-16,0,1,0,1500,0,0,136,19,136,0,0,0,0,0,37,22,99,19,0.0,802.1
9602,d0797451df1de80f,9fa3bd637edd9aa2,fb8a3025ae722e64,2013-03-16,0,0,0,900,6,0,135,52,132,3,0,0,3,2,28,20,104,50,25.6,548.1
9603,d0797451df1de80f,fb8a3025ae722e64,9fa3bd637edd9aa2,2013-03-16,0,0,0,900,5,4,175,55,150,25,3,2,22,13,33,26,117,42,129.9,531.4
9604,cc6e74d0558b7340,3c921b1a30fdcbdd,7d09200f6a77b20e,2013-03-16,0,0,0,900,2,2,137,34,126,11,2,1,9,7,37,12,89,27,172.1,648.9
9605,cc6e74d0558b7340,7d09200f6a77b20e,3c921b1a30fdcbdd,2013-03-16,0,0,0,900,2,0,127,11,124,3,1,1,2,1,67,25,57,10,32.1,652.9
9606,b6c46c3c239e7863,2aa49b3766a59bcd,d0c29452d3272603,2013-03-16,1,0,0,282,0,0,53,25,53,0,0,0,0,0,4,4,49,25,0.0,264.0
9607,b6c46c3c239e7863,d0c29452d3272603,2aa49b3766a59bcd,2013-03-16,0,1,0,282,1,1,37,4,37,0,0,0,0,0,11,7,26,4,0.0,249.0
9608,9c3db86db300119e,57bf89d42364d39e,c849740a3ff51931,2013-03-16,0,0,0,326,1,0,20,4,20,0,0,0,0,0,10,7,10,4,0.0,272.2
9609,9c3db86db300119e,c849740a3ff51931,57bf89d42364d39e,2013-03-16,1,0,0,326,3,2,57,13,49,8,1,1,7,7,24,16,25,6,53.8,151.0
9610,9030c92a161afaf9,16af2d5a6f28bee2,5b5307450405abf0,2013-03-16,0,0,0,185,1,0,50,8,50,0,0,0,0,0,8,1,42,8,0.0,179.8
9611,9030c92a161afaf9,5b5307450405abf0,16af2d5a6f28bee2,2013-03-16,1,0,0,185,1,1,49,10,43,6,4,4,2,0,10,6,33,10,5.2,178.0
9612,8e4650807ea06626,3c0437fbeda06962,4417980b3e798abf,2013-03-16,0,1,0,900,3,2,75,15,63,12,3,3,9,8,25,15,38,7,101.8,411.5
9613,8e4650807ea06626,4417980b3e798abf,3c0437fbeda06962,2013-03-16,0,0,0,900,6,1,56,15,41,15,2,1,13,6,14,14,27,9,225.5,347.2
9614,7b9de06ef8c09ba6,92a9aa9c93192871,fef3d17e27e916e7,2013-03-16,1,0,0,186,2,0,54,8,54,0,0,0,0,0,7,6,47,8,0.0,165.0
9615,7b9de06ef8c09ba6,fef3d17e27e916e7,92a9aa9c93192871,2013-03-16,0,0,0,186,0,0,27,7,27,0,0,0,0,0,2,2,25,7,0.0,180.0
9616,79dcde3ad50f6165,6c2030e0a143a94b,b13da0b1a3aed3e7,2013-03-16,0,0,0,900,0,0,247,48,247,0,0,0,0,0,22,16,225,48,0.0,880.0
9617,79dcde3ad50f6165,b13da0b1a3aed3e7,6c2030e0a143a94b,2013-03-16,0,0,0,900,1,0,225,33,225,0,0,0,0,0,77,53,148,33,0.0,900.0
9618,5adcbd20eed3795d,a8e6a69796280f17,d81ac739417d7f53,2013-03-16,0,0,0,180,0,0,23,2,23,0,0,0,0,0,12,11,11,2,0.0,177.0
9619,5adcbd20eed3795d,d81ac739417d7f53,a8e6a69796280f17,2013-03-16,1,0,0,180,0,0,25,8,21,4,0,0,4,2,5,5,16,6,3.0,177.0
9620,29398b15b94c3847,0941df56f6ac954b,f9f07bb5a43535ed,2013-03-16,0,0,0,900,15,12,71,25,65,6,0,0,6,5,9,5,56,20,192.4,409.4
9621,29398b15b94c3847,f9f07bb5a43535ed,0941df56f6ac954b,2013-03-16,0,0,0,900,0,0,145,26,139,6,0,0,6,6,27,16,112,20,9.6,683.6
9622,0bd0ca01a255038c,5f99b2bafb10305f,c21a036b4e012f1c,2013-03-16,0,0,0,900,4,0,198,32,197,1,0,0,1,1,32,19,165,31,2.0,896.2
9623,0bd0ca01a255038c,c21a036b4e012f1c,5f99b2bafb10305f,2013-03-16,0,0,0,900,0,0,195,58,194,1,0,0,1,0,42,28,152,58,1.8,887.0
9624,e830cb1df07f3466,acff437707625fc7,db1f2ed63b54b9a7,2013-03-02,0,0,0,900,5,3,89,24,83,6,1,1,5,3,14,12,69,21,111.9,581.5
9625,e830cb1df07f3466,db1f2ed63b54b9a7,acff437707625fc7,2013-03-02,0,0,0,900,3,0,89,30,87,2,0,0,2,1,18,15,69,29,57.5,558.1
9626,e2b547e64f6532bb,579fcdfcabd23a7b,a1f6999fe57236e0,2013-03-02,1,0,0,548,0,0,76,23,76,0,0,0,0,0,25,20,51,23,0.0,483.7
9627,e2b547e64f6532bb,a1f6999fe57236e0,579fcdfcabd23a7b,2013-03-02,2,0,0,548,2,0,83,37,78,5,0,0,5,5,7,6,71,32,10.3,511.0
9628,e0bdef2580715030,9bcf8603ceb25680,aec185309b4843d0,2013-03-02,0,1,0,900,6,3,58,16,12,46,5,5,41,12,2,2,10,4,674.0,224.0
9629,e0bdef2580715030,aec185309b4843d0,9bcf8603ceb25680,2013-03-02,0,0,0,900,0,0,24,4,21,3,1,1,2,0,3,0,18,4,2.0,224.0
9630,c996b2ff10a915b1,ebc1f40e00e0c481,eef9b891edbd4604,2013-03-02,0,1,0,704,0,0,67,19,58,9,0,0,9,3,7,5,51,16,125.0,341.0
9631,c996b2ff10a915b1,eef9b891edbd4604,ebc1f40e00e0c481,2013-03-02,1,0,0,704,2,1,82,37,77,5,0,0,5,2,12,10,65,35,238.0,341.0
9632,c79c00f5443c2f6e,0c6d9ea8306c029e,7c35f869033901ae,2013-03-02,0,0,0,900,0,0,254,86,254,0,0,0,0,0,37,30,217,86,0.0,900.0
9633,c79c00f5443c2f6e,7c35f869033901ae,0c6d9ea8306c029e,2013-03-02,0,0,0,900,1,1,172,35,172,0,0,0,0,0,54,34,118,35,0.0,841.0
9634,be70a2f68f6ad3e7,7aa3d6964eff4877,a7897d200692ab64,2013-03-02,0,0,0,900,0,0,56,18,31,25,6,5,19,14,8,7,23,4,285.6,273.1
9635,be70a2f68f6ad3e7,a7897d200692ab64,7aa3d6964eff4877,2013-03-02,0,0,0,900,9,5,43,11,36,7,1,1,6,3,7,4,29,8,329.9,237.39999999999998
9636,8666332154fc6f4a,c4af2feb4b58bc3b,ff4c3ab594c7fac3,2013-03-02,1,0,0,900,2,2,77,20,53,24,3,1,21,7,16,12,37,13,449.8,389.4
9637,8666332154fc6f4a,ff4c3ab594c7fac3,c4af2feb4b58bc3b,2013-03-02,0,0,0,900,4,1,76,21,75,1,0,0,1,1,19,12,56,20,4.6,395.2
9638,7af713ee9e3006eb,48e093ea1f43a053,5ef0088c1b19beeb,2013-03-02,0,0,0,900,1,0,117,42,117,0,0,0,0,0,26,25,91,42,0.0,844.8
9639,7af713ee9e3006eb,5ef0088c1b19beeb,48e093ea1f43a053,2013-03-02,0,1,0,900,12,2,89,31,88,1,0,0,1,1,7,6,81,30,43.2,554.0
9640,68e1a69423360900,0c9c0a43d3f3f49d,203c957eac95dd87,2013-03-02,0,0,0,540,12,2,99,21,98,1,0,0,1,0,33,26,65,21,64.0,474.0
9641,68e1a69423360900,203c957eac95dd87,0c9c0a43d3f3f49d,2013-03-02,1,0,0,540,0,0,134,41,132,2,0,0,2,2,25,21,107,39,2.0,474.0
9642,1dcc880fc80e6332,35faad160d346839,94527830000ab715,2013-03-02,0,0,0,900,1,1,14,3,13,1,0,0,1,0,1,1,12,3,94.5,205.7
9643,1dcc880fc80e6332,94527830000ab715,35faad160d346839,2013-03-02,0,1,0,900,12,5,29,11,14,15,1,1,14,8,2,1,12,3,505.3,266.5
9644,1acde2739237c4f8,3be081c29bf734d9,82e7929bf6c2b689,2013-03-02,0,0,0,900,0,0,180,48,180,0,0,0,0,0,45,33,135,48,0.0,897.0
9645,1acde2739237c4f8,82e7929bf6c2b689,3be081c29bf734d9,2013-03-02,0,1,0,900,5,2,145,29,145,0,0,0,0,0,45,36,100,29,0.0,880.0
9646,ee43dc83049ecc8d,1ccf4e7caff270df,f7a7f7118d4b01b6,2013-02-23,0,0,0,900,3,1,64,5,62,2,0,0,2,1,33,15,29,4,25.1,782.0
9647,ee43dc83049ecc8d,f7a7f7118d4b01b6,1ccf4e7caff270df,2013-02-23,0,0,0,900,1,1,54,17,50,4,0,0,4,4,18,10,32,13,5.0,869.9
9648,e9e6023dbba9a8b0,51a0c09cbe9b8472,8bdac25ce0bb874d,2013-02-23,0,1,0,289,0,0,6,4,6,0,0,0,0,0,0,0,6,4,0.0,60.400000000000006
9649,e9e6023dbba9a8b0,8bdac25ce0bb874d,51a0c09cbe9b8472,2013-02-23,0,1,1,289,1,1,14,6,7,7,1,1,6,3,0,0,7,3,176.6,62.0
9650,db43605f10bd67b4,523fa774700d7d3f,d1a1314976c50bef,2013-02-23,0,0,0,900,5,2,334,116,299,35,0,0,35,22,64,50,235,94,170.8,612.0
9651,db43605f10bd67b4,d1a1314976c50bef,523fa774700d7d3f,2013-02-23,0,0,0,900,0,0,152,45,152,0,0,0,0,0,21,18,131,45,0.0,725.2
9652,b4db19e62f087a7f,dd37fd509af89f15,f2925e6db404bf1d,2013-02-23,0,0,0,237,6,2,4,1,2,2,1,1,1,1,0,0,2,0,194.0,31.5
9653,b4db19e62f087a7f,f2925e6db404bf1d,dd37fd509af89f15,2013-02-23,1,0,0,237,0,0,15,7,6,9,0,0,9,7,2,2,4,0,11.5,29.0
9654,919ddc634c54ad20,84b3e7d38f2d2ec5,a0602dd050bebefc,2013-02-23,0,0,0,900,5,4,120,42,102,18,1,1,17,9,26,22,76,33,108.7,592.0
9655,919ddc634c54ad20,a0602dd050bebefc,84b3e7d38f2d2ec5,2013-02-23,0,0,0,900,13,1,85,12,85,0,0,0,0,0,12,5,73,12,0.0,464.3
9656,80769cf090fa34dd,6f242453c91a5af0,bfc2fc38a0e20211,2013-02-23,1,2,0,900,9,0,209,89,159,50,0,0,50,41,42,31,117,48,152.8,566.6
9657,80769cf090fa34dd,bfc2fc38a0e20211,6f242453c91a5af0,2013-02-23,1,0,0,900,12,1,162,49,157,5,0,0,5,2,42,33,115,47,9.4,612.2
9658,785c0e68b34ea383,5755960ebd0b16f6,78114b7199cef90c,2013-02-23,0,0,0,274,1,1,7,3,6,1,0,0,1,0,1,0,5,3,1.0,39.5
9659,785c0e68b34ea383,78114b7199cef90c,5755960ebd0b16f6,2013-02-23,0,1,1,274,0,0,24,16,4,20,0,0,20,15,1,1,3,1,230.5,31.0
9660,69f8e2ba5d1048d4,706f8e2b34e8e18b,c58f51dedb310998,2013-02-23,0,0,0,449,0,0,55,11,55,0,0,0,0,0,13,7,42,11,0.0,398.0
9661,69f8e2ba5d1048d4,c58f51dedb310998,706f8e2b34e8e18b,2013-02-23,0,2,1,449,5,1,50,3,50,0,0,0,0,0,4,2,46,3,0.0,321.0
9662,69ca032aaef2e3d0,0fb1e2694a39a02f,2c64c035485906aa,2013-02-23,0,1,0,900,6,3,112,24,109,3,0,0,3,3,30,24,79,21,42.8,630.2
9663,69ca032aaef2e3d0,2c64c035485906aa,0fb1e2694a39a02f,2013-02-23,0,1,0,900,0,0,216,95,184,32,5,4,27,24,25,22,159,71,98.8,718.2
9664,50eb4822a74a417e,89a407032911e27e,e6c5908910cc26e4,2013-02-23,0,1,0,900,8,5,31,16,12,19,0,0,19,12,4,2,8,4,527.6,149.2
9665,50eb4822a74a417e,e6c5908910cc26e4,89a407032911e27e,2013-02-23,0,0,0,900,1,1,52,18,30,22,3,3,19,15,17,15,13,3,28.8,317.4
9666,2b3a1c063245e280,01d2ed8c502e3828,501b07aec9b8fc2d,2013-02-23,0,0,0,900,13,3,92,24,92,0,0,0,0,0,32,23,60,24,0.0,684.3
9667,2b3a1c063245e280,501b07aec9b8fc2d,01d2ed8c502e3828,2013-02-23,0,0,0,900,3,1,120,21,114,6,3,3,3,1,36,22,78,20,88.7,501.0
9668,2a8ff828e4891b82,64959f90b6dd9759,6e0273f9478be71e,2013-02-23,0,1,0,177,0,0,3,0,3,0,0,0,0,0,1,1,2,0,0.0,22.0
9669,2a8ff828e4891b82,6e0273f9478be71e,64959f90b6dd9759,2013-02-23,0,2,1,177,1,1,13,8,3,10,0,0,10,8,1,1,2,0,155.0,22.0
9670,f509d5ffcc3f46fe,8bb6f4479685bbcc,d34636a85f0f4c90,2013-02-16,0,0,0,900,0,0,48,7,46,2,0,0,2,2,20,13,26,5,7.1,829.0
9671,f509d5ffcc3f46fe,d34636a85f0f4c90,8bb6f4479685bbcc,2013-02-16,0,1,0,900,15,1,35,1,35,0,0,0,0,0,7,3,28,1,0.0,421.9
9672,e27a9b4b4a46f091,33011768c3c4dc9a,44bc27bfa76dcd9e,2013-02-16,0,0,0,900,0,0,62,5,62,0,0,0,0,0,13,8,49,5,0.0,432.8
9673,e27a9b4b4a46f091,44bc27bfa76dcd9e,33011768c3c4dc9a,2013-02-16,1,0,0,900,3,2,119,38,75,44,0,0,44,19,17,9,58,19,465.2,255.0
9674,d607908be8b19273,60ba33c3f555a7a3,b6c4451cb13c9303,2013-02-16,0,2,0,900,2,1,26,0,26,0,0,0,0,0,11,7,15,0,0.0,90.0
9675,d607908be8b19273,b6c4451cb13c9303,60ba33c3f555a7a3,2013-02-16,0,0,0,900,2,2,42,10,29,13,6,6,7,5,4,3,25,5,791.0,109.0
9676,7549887ba7ae86e6,f8dc544e7077d014,fd55393021a8c255,2013-02-16,0,0,0,900,0,0,123,19,122,1,0,0,1,1,30,24,92,18,0.4,645.1
9677,7549887ba7ae86e6,fd55393021a8c255,f8dc544e7077d014,2013-02-16,0,0,0,900,4,2,80,32,57,23,2,1,21,14,11,9,46,18,242.9,561.6
9678,635ef1f12a60e9d7,bc3ec52ef70fc155,f5431394fb284bb9,2013-02-16,1,0,0,900,2,0,52,28,16,36,0,0,36,23,7,6,9,5,334.5,232.2
9679,635ef1f12a60e9d7,f5431394fb284bb9,bc3ec52ef70fc155,2013-02-16,0,0,0,900,5,2,79,34,30,49,1,1,48,33,20,14,10,1,286.8,167.5
9680,530558f01ac425af,7b143a54451263d9,d1e7fc58d4225cdf,2013-02-16,0,5,0,900,0,0,23,2,23,0,0,0,0,0,3,2,20,2,0.0,165.0
9681,530558f01ac425af,d1e7fc58d4225cdf,7b143a54451263d9,2013-02-16,0,0,0,900,6,4,67,35,7,60,2,2,58,35,1,1,6,0,735.0,165.0
9682,493b7a8e3253b133,029eaff01e6bb8f0,d247691a6c0e9034,2013-02-16,0,0,0,900,9,2,140,33,134,6,0,0,6,1,33,25,101,32,96.8,543.7
9683,493b7a8e3253b133,d247691a6c0e9034,029eaff01e6bb8f0,2013-02-16,0,0,0,900,2,2,126,40,114,12,2,1,10,7,24,17,90,33,114.3,622.2
9684,3dbf17b9946d26db,2c99576fefe53c7c,d0314416a7f26527,2013-02-16,0,1,1,1137,10,4,112,28,104,8,1,1,7,4,14,7,90,24,79.3,899.0
9685,3dbf17b9946d26db,d0314416a7f26527,2c99576fefe53c7c,2013-02-16,0,0,0,1137,1,0,92,26,91,1,0,0,1,1,0,0,91,25,0.0,1057.7
9686,2968840a5f24ce9f,1e1dbd1cc5a7469e,43563a32c3f10e95,2013-02-16,1,0,0,300,3,3,36,10,33,3,0,0,3,1,10,8,23,9,32.8,158.0
9687,2968840a5f24ce9f,43563a32c3f10e95,1e1dbd1cc5a7469e,2013-02-16,0,0,0,300,0,0,14,1,14,0,0,0,0,0,10,8,4,1,0.0,248.2
9688,287c71b9017c5769,6cadfd8f1d9e7685,d023ae89a2a4a41e,2013-02-16,0,0,0,900,1,0,50,12,41,9,3,2,6,5,16,14,25,7,12.5,530.5
9689,287c71b9017c5769,d023ae89a2a4a41e,6cadfd8f1d9e7685,2013-02-16,0,0,0,900,14,5,40,14,28,12,3,3,9,8,13,6,15,6,337.5,212.5
9690,22a574162e2ebcf6,1d4bbaabd8b60173,6809c31286b08d97,2013-02-16,0,0,0,582,6,5,78,26,47,31,1,0,30,15,15,13,32,11,82.7,406.7
9691,22a574162e2ebcf6,6809c31286b08d97,1d4bbaabd8b60173,2013-02-16,1,0,0,582,0,0,102,31,97,5,0,0,5,3,36,25,61,28,15.3,235.3
9692,16ba92318ff66d4a,1e35aa8955794580,ba043b03eb799063,2013-02-16,0,0,0,900,3,0,159,8,159,0,0,0,0,0,48,27,111,8,0.0,889.4
9693,16ba92318ff66d4a,ba043b03eb799063,1e35aa8955794580,2013-02-16,0,0,0,900,1,1,150,12,148,2,0,0,2,0,29,21,119,12,2.6,891.0
9694,cd03bff050e53625,6f81b6de2557739a,887961364be5ceb3,2013-02-02,0,0,0,865,12,4,51,4,44,7,2,0,5,3,12,2,32,1,337.0,308.4
9695,cd03bff050e53625,887961364be5ceb3,6f81b6de2557739a,2013-02-02,0,1,1,865,1,1,90,34,53,37,2,2,35,26,24,18,29,8,219.6,255.0
9696,8bcdb1c3418fe739,5bb0a618ad03ac64,effd9de9937996f8,2013-02-02,0,0,0,36,0,0,2,0,2,0,0,0,0,0,0,0,2,0,0.0,27.0
9697,8bcdb1c3418fe739,effd9de9937996f8,5bb0a618ad03ac64,2013-02-02,1,0,0,36,0,0,22,13,5,17,3,2,14,11,0,0,5,2,9.0,27.0
9698,6247ad19755b71d6,32be4b7f7de1c905,fe91d254db77a7fc,2013-02-02,0,0,0,710,3,1,41,12,34,7,1,1,6,4,12,10,22,8,264.6,290.0
9699,6247ad19755b71d6,fe91d254db77a7fc,32be4b7f7de1c905,2013-02-02,0,5,1,710,0,0,56,13,47,9,0,0,9,5,6,3,41,8,42.0,389.4
9700,54c842a037183f48,5f04e3d58d9ce982,c295de4e10acd4c9,2013-02-02,0,0,0,900,3,1,115,32,115,0,0,0,0,0,33,26,82,32,0.0,729.0
9701,54c842a037183f48,c295de4e10acd4c9,5f04e3d58d9ce982,2013-02-02,0,0,0,900,0,0,222,47,222,0,0,0,0,0,42,29,180,47,0.0,766.0
9702,42eba784becde9ad,7ea4a9f07df33a45,bbfca6d5c27d9cd8,2013-02-02,1,0,0,560,2,2,127,25,118,9,0,0,9,5,38,26,80,20,50.2,397.0
9703,42eba784becde9ad,bbfca6d5c27d9cd8,7ea4a9f07df33a45,2013-02-02,1,0,0,560,1,1,97,18,91,6,0,0,6,4,12,6,79,14,96.0,381.8
9704,40cc0ccf580a4836,701e057d63c124d9,80eacd4da0617c57,2013-02-02,0,0,0,900,4,1,113,18,110,3,0,0,3,2,43,22,67,16,14.1,811.0
9705,40cc0ccf580a4836,80eacd4da0617c57,701e057d63c124d9,2013-02-02,0,0,0,900,1,0,184,33,184,0,0,0,0,0,49,24,135,33,0.0,859.9
9706,21419797f539de5e,8349d55cdecd393a,b4ad3a06ee4d660c,2013-02-02,1,0,0,625,1,0,48,18,46,2,0,0,2,1,8,3,38,17,0.0,433.0
9707,21419797f539de5e,b4ad3a06ee4d660c,8349d55cdecd393a,2013-02-02,0,0,0,625,1,1,71,22,49,22,10,10,12,9,23,19,26,13,192.0,241.0
9708,1d43112d98de273a,75e5fec9f72910ef,e5c9de15bb58b1c6,2013-02-02,0,1,0,900,9,2,169,28,169,0,0,0,0,0,13,9,156,28,0.0,790.0
9709,1d43112d98de273a,e5c9de15bb58b1c6,75e5fec9f72910ef,2013-02-02,0,0,0,900,9,0,237,76,237,0,0,0,0,0,27,15,210,76,0.0,808.0
9710,1c4e4b3358089960,d0f3959b4a9747e6,f2688492b9a525a3,2013-02-02,0,0,0,1500,0,0,253,65,253,0,0,0,0,0,18,11,235,65,0.0,1495.0
9711,1c4e4b3358089960,f2688492b9a525a3,d0f3959b4a9747e6,2013-02-02,0,0,0,1500,11,2,272,24,272,0,0,0,0,0,58,36,214,24,0.0,1443.0
9712,171eb38b335030d3,427b5953ac8e3a27,6f018c039b4d5d80,2013-02-02,0,3,0,900,17,7,17,7,9,8,4,4,4,4,2,1,7,3,514.0,112.5
9713,171eb38b335030d3,6f018c039b4d5d80,427b5953ac8e3a27,2013-02-02,0,1,0,900,0,0,16,3,15,1,0,0,1,1,4,3,11,2,16.5,353.0
9714,031eac0f0f85d0bf,73e09f837f3b5ecc,ee779c43a8926d52,2013-02-02,0,0,0,900,0,0,152,28,152,0,0,0,0,0,21,12,131,28,0.0,900.0
9715,031eac0f0f85d0bf,ee779c43a8926d52,73e09f837f3b5ecc,2013-02-02,0,0,0,900,5,1,81,16,81,0,0,0,0,0,14,6,67,16,0.0,885.0
9716,e8c24a1754599237,a26198ba5093147e,eb29176b03dfa888,2013-01-26,1,0,0,291,0,0,93,37,78,15,2,1,13,8,18,16,60,29,26.9,221.0
9717,e8c24a1754599237,eb29176b03dfa888,a26198ba5093147e,2013-01-26,0,0,0,291,1,0,57,9,57,0,0,0,0,0,13,9,44,9,0.0,264.1
9718,df0d3dec831e2142,0dba4df5f34d5ff0,ab850a77a0fa487d,2013-01-26,0,4,1,733,6,4,111,47,62,49,0,0,49,38,19,17,43,9,328.6,391.0
9719,df0d3dec831e2142,ab850a77a0fa487d,0dba4df5f34d5ff0,2013-01-26,0,0,0,733,0,0,84,11,84,0,0,0,0,0,6,1,78,11,0.0,393.4
9720,ca28f69fa42f88ed,353de740bb6c7e75,ca2efc9d7d523c43,2013-01-26,0,0,0,528,6,1,45,25,45,0,0,0,0,0,0,0,45,25,0.0,230.8
9721,ca28f69fa42f88ed,ca2efc9d7d523c43,353de740bb6c7e75,2013-01-26,1,0,0,528,2,2,72,39,49,23,0,0,23,22,4,3,45,17,79.2,404.0
9722,bddf441908777c0c,1d00756835ca67c9,cbb682f5fcc44bfc,2013-01-26,0,0,0,155,0,0,12,2,12,0,0,0,0,0,4,2,8,2,0.0,153.0
9723,bddf441908777c0c,cbb682f5fcc44bfc,1d00756835ca67c9,2013-01-26,1,0,0,155,0,0,28,13,26,2,0,0,2,2,7,5,19,11,2.0,153.0
9724,9b9591a4f7febe32,8a304bfd6bf04a57,99506df1af6c8b3b,2013-01-26,0,0,0,1500,15,5,247,70,242,5,1,1,4,2,92,56,150,68,19.4,1148.3
9725,9b9591a4f7febe32,99506df1af6c8b3b,8a304bfd6bf04a57,2013-01-26,1,0,0,1500,4,1,156,25,155,1,0,0,1,1,47,32,108,24,6.7,1326.6
9726,97cec48c97e7ea31,c0ab242c40decc55,ccdd90bd1fc7dab6,2013-01-26,1,1,1,50,0,0,6,2,4,2,0,0,2,0,1,1,3,2,6.0,44.0
9727,97cec48c97e7ea31,ccdd90bd1fc7dab6,c0ab242c40decc55,2013-01-26,0,0,0,50,0,0,4,0,4,0,0,0,0,0,0,0,4,0,0.0,30.0
9728,856e171bdfc98cb5,a01e84abefd85ec0,c0c36a5b3d5bbdd5,2013-01-26,0,1,0,900,2,1,309,115,306,3,0,0,3,3,55,48,251,112,10.1,667.5
9729,856e171bdfc98cb5,c0c36a5b3d5bbdd5,a01e84abefd85ec0,2013-01-26,0,0,0,900,8,2,142,26,141,1,0,0,1,0,47,37,94,26,7.5,739.9
9730,83f6a6fc79036749,8f3df4c579cfbb69,fea8acf9bfcf09ec,2013-01-26,0,2,0,900,2,1,159,52,134,25,2,1,23,12,12,7,122,40,155.1,638.3
9731,83f6a6fc79036749,fea8acf9bfcf09ec,8f3df4c579cfbb69,2013-01-26,0,0,0,900,1,1,115,36,113,2,1,0,1,0,16,13,97,36,19.7,527.9
9732,76690fbdcaa85c21,c47df9303d318c67,ef7fa30364cbe7f2,2013-01-26,0,0,0,900,6,3,112,14,102,10,0,0,10,3,27,12,75,11,427.5,383.2
9733,76690fbdcaa85c21,ef7fa30364cbe7f2,c47df9303d318c67,2013-01-26,0,1,0,900,0,0,99,29,96,3,0,0,3,3,25,12,71,26,3.8,462.5
9734,638093bc4f69f639,7ff97850e8c32bda,ffc088e64fab57e9,2013-01-26,1,0,0,900,5,5,179,70,144,35,0,0,35,23,15,10,129,47,159.0,682.0
9735,638093bc4f69f639,ffc088e64fab57e9,7ff97850e8c32bda,2013-01-26,0,0,0,900,4,0,169,45,169,0,0,0,0,0,8,8,161,45,0.0,736.0
9736,4e87af7e5156bbf7,3974fa35c917af1d,99bd87a300079ed9,2013-01-26,1,0,0,452,8,2,56,18,36,20,2,1,18,14,18,13,18,4,144.4,257.0
9737,4e87af7e5156bbf7,99bd87a300079ed9,3974fa35c917af1d,2013-01-26,0,0,0,452,0,0,44,9,44,0,0,0,0,0,7,5,37,9,0.0,287.6
9738,f4273b2155fe20fe,a8283a4f415e1eb9,c0eecd851dbf3146,2013-01-19,0,1,1,410,5,2,19,5,10,9,3,3,6,4,6,4,4,1,143.4,104.0
9739,f4273b2155fe20fe,c0eecd851dbf3146,a8283a4f415e1eb9,2013-01-19,0,0,0,410,1,0,9,2,7,2,0,0,2,2,3,1,4,0,67.0,199.6
9740,dff7ce155b47442c,8a70ceb3edbe757b,bd21a1e3d41c97ee,2013-01-19,0,0,0,900,1,0,29,12,19,10,3,3,7,6,5,5,14,6,111.9,456.5
9741,dff7ce155b47442c,bd21a1e3d41c97ee,8a70ceb3edbe757b,2013-01-19,0,2,0,900,12,2,9,3,8,1,0,0,1,1,2,2,6,2,264.5,259.1
9742,c7ad34973f9d1cf6,7c6e87729e824ef4,7f6ef4e1227600bc,2013-01-19,0,3,1,459,3,2,55,10,55,0,0,0,0,0,19,14,36,10,0.0,343.8
9743,c7ad34973f9d1cf6,7f6ef4e1227600bc,7c6e87729e824ef4,2013-01-19,0,0,0,459,1,0,53,14,51,2,0,0,2,0,23,14,28,14,29.2,386.0
9744,b51d691b9f5603a8,0ee783aa00e468f0,2b93ebd9f5417ad2,2013-01-19,1,0,0,387,0,0,53,12,46,7,1,1,6,4,6,5,40,8,4.7,381.0
9745,b51d691b9f5603a8,2b93ebd9f5417ad2,0ee783aa00e468f0,2013-01-19,0,0,0,387,1,0,66,8,66,0,0,0,0,0,9,6,57,8,0.0,382.3
9746,8f426040f746905d,7cf20446453f852b,fa37628269132d1a,2013-01-19,0,0,0,900,6,5,34,8,31,3,0,0,3,2,9,9,22,6,180.5,413.0
9747,8f426040f746905d,fa37628269132d1a,7cf20446453f852b,2013-01-19,0,0,0,900,1,0,76,18,70,6,1,1,5,5,19,17,51,13,126.0,467.5
9748,7651b2e09ea2c420,032cc3922d871c7f,8a59d346dc976a10,2013-01-19,1,0,0,115,0,0,31,22,12,19,0,0,19,17,2,0,10,5,13.0,102.0
9749,7651b2e09ea2c420,8a59d346dc976a10,032cc3922d871c7f,2013-01-19,0,0,0,115,0,0,10,0,10,0,0,0,0,0,3,2,7,0,0.0,102.0
9750,7601245171a28da1,2f95a3c6d58b2aad,e983c62faf677ab2,2013-01-19,0,1,0,131,1,1,31,17,16,15,0,0,15,14,6,3,10,3,67.0,64.0
9751,7601245171a28da1,e983c62faf677ab2,2f95a3c6d58b2aad,2013-01-19,0,0,0,131,1,0,10,1,10,0,0,0,0,0,3,2,7,1,0.0,61.0
9752,4d231d5d5f815085,5d7bdab5e03e3216,7e47047d0971d566,2013-01-19,0,0,0,900,6,2,152,47,126,26,5,3,21,14,13,12,113,33,122.5,715.0
9753,4d231d5d5f815085,7e47047d0971d566,5d7bdab5e03e3216,2013-01-19,1,0,0,900,6,0,98,26,97,1,0,0,1,1,23,12,74,25,39.0,660.5
9754,470f6fdd47f671fd,64a50dad704d1d49,7413b80dbb0f8f9f,2013-01-19,1,0,0,158,0,0,45,15,36,9,0,0,9,6,15,11,21,9,10.0,148.0
9755,470f6fdd47f671fd,7413b80dbb0f8f9f,64a50dad704d1d49,2013-01-19,0,0,0,158,0,0,31,9,31,0,0,0,0,0,4,3,27,9,0.0,148.0
9756,302ce74d8b0d12a6,3a24769a4855040a,6fb1ba67bef41b37,2013-01-19,0,0,0,900,0,0,32,12,30,2,0,0,2,2,8,6,22,10,0.0,402.1
9757,302ce74d8b0d12a6,6fb1ba67bef41b37,3a24769a4855040a,2013-01-19,0,0,0,900,21,10,74,34,38,36,8,8,28,23,15,14,23,11,497.9,167.0
9758,2eeb1656692bd967,270b89c00ef0c55c,bd58d34e39b7b12a,2013-01-19,0,1,1,361,8,3,28,11,28,0,0,0,0,0,8,6,20,11,0.0,223.0
9759,2eeb1656692bd967,bd58d34e39b7b12a,270b89c00ef0c55c,2013-01-19,0,0,0,361,0,0,27,10,27,0,0,0,0,0,2,2,25,10,0.0,324.0
9760,fc9ec3a01d0129b6,92437c6775b3f7d1,b2e3aca4cd363477,2012-12-29,0,1,1,671,2,2,74,15,74,0,0,0,0,0,22,11,52,15,0.0,577.9
9761,fc9ec3a01d0129b6,b2e3aca4cd363477,92437c6775b3f7d1,2012-12-29,0,0,0,671,2,1,122,19,120,2,0,0,2,0,29,20,91,19,5.1,635.0
9762,ea9059fd076a2f1e,af62f99eb7606308,ecdf14f4f8643d39,2012-12-29,1,0,0,230,0,0,58,23,22,36,7,7,29,14,10,10,12,9,137.8,31.0
9763,ea9059fd076a2f1e,ecdf14f4f8643d39,af62f99eb7606308,2012-12-29,0,0,0,230,0,0,11,3,11,0,0,0,0,0,6,5,5,3,0.0,83.19999999999999
9764,bab948352454f302,b1a3e0aca758b322,d43a048a880efdff,2012-12-29,0,1,0,900,13,4,130,30,109,21,1,1,20,9,20,10,89,21,370.4,459.0
9765,bab948352454f302,d43a048a880efdff,b1a3e0aca758b322,2012-12-29,0,0,0,900,0,0,94,20,94,0,0,0,0,0,25,20,69,20,0.0,529.6
9766,a551d93167533459,150ff4cc642270b9,917e53fa0adea0d3,2012-12-29,1,0,0,900,0,0,269,68,268,1,0,0,1,0,76,52,192,68,1.0,884.5
9767,a551d93167533459,917e53fa0adea0d3,150ff4cc642270b9,2012-12-29,0,0,0,900,4,2,359,64,358,1,0,0,1,0,39,25,319,64,7.5,801.0
9768,85f67de8e9dc5689,08e908ed6d18d6a0,511e82663651438d,2012-12-29,0,1,0,900,6,3,121,48,46,75,4,3,71,41,5,5,41,7,613.6,270.0
9769,85f67de8e9dc5689,511e82663651438d,08e908ed6d18d6a0,2012-12-29,0,0,0,900,0,0,41,2,41,0,0,0,0,0,13,4,28,2,0.0,286.4
9770,84500d5c1aba97a2,6ef65b6a152e49d5,bda04c573563cc2e,2012-12-29,0,0,0,124,1,1,13,7,13,0,0,0,0,0,1,0,12,7,0.0,70.0
9771,84500d5c1aba97a2,bda04c573563cc2e,6ef65b6a152e49d5,2012-12-29,1,0,0,124,0,0,31,14,31,0,0,0,0,0,7,6,24,14,0.0,91.0
9772,5d7a720a2e2f4749,3bad7ef643840f67,d1941565abf50b16,2012-12-29,0,3,0,900,1,0,123,25,120,3,1,1,2,1,13,9,107,24,27.2,731.5
9773,5d7a720a2e2f4749,d1941565abf50b16,3bad7ef643840f67,2012-12-29,0,2,0,900,1,1,204,61,194,10,4,4,6,3,36,26,158,58,41.5,681.8
9774,5a65ffe3842ce2f2,c945adc22c2bfe8f,fc9a9559a05f2704,2012-12-29,0,0,0,900,0,0,212,33,212,0,0,0,0,0,58,34,154,33,0.0,898.0
9775,5a65ffe3842ce2f2,fc9a9559a05f2704,c945adc22c2bfe8f,2012-12-29,1,0,0,900,2,0,294,83,294,0,0,0,0,0,18,7,276,83,0.0,900.0
9776,526790a5b3c4b5a2,05560764359161e4,c80095f6092271a7,2012-12-29,1,0,0,731,0,0,74,27,43,31,0,0,31,17,4,1,39,10,131.0,538.4
9777,526790a5b3c4b5a2,c80095f6092271a7,05560764359161e4,2012-12-29,1,0,0,731,8,2,53,8,51,2,0,0,2,1,25,17,26,7,23.6,411.0
9778,23cdc3ef525ba8e4,4130a743d9d22163,acff437707625fc7,2012-12-29,0,2,0,900,0,0,28,4,28,0,0,0,0,0,2,2,26,4,0.0,296.2
9779,23cdc3ef525ba8e4,acff437707625fc7,4130a743d9d22163,2012-12-29,0,0,0,900,5,1,44,14,29,15,3,3,12,10,3,3,26,4,400.8,419.0
9780,0d4927585d0480fc,a54fc2d6fc224dc3,ccd1299e0345e0ce,2012-12-29,0,1,0,900,10,7,97,23,97,0,0,0,0,0,14,9,83,23,0.0,622.1
9781,0d4927585d0480fc,ccd1299e0345e0ce,a54fc2d6fc224dc3,2012-12-29,0,1,0,900,1,0,112,31,104,8,1,1,7,4,26,25,78,27,42.9,841.0
9782,02a373f6503b3530,0ff11cc094e887bc,63def5a5662a6917,2012-12-29,1,0,0,1500,33,11,224,82,175,49,0,0,49,37,31,29,144,45,401.1,665.0
9783,02a373f6503b3530,63def5a5662a6917,0ff11cc094e887bc,2012-12-29,0,0,0,1500,1,0,137,32,137,0,0,0,0,0,35,25,102,32,0.0,1035.9
9784,e88c59ad88e9dc27,029eaff01e6bb8f0,b0a6124751a56bc4,2012-12-15,0,1,1,255,2,0,73,28,73,0,0,0,0,0,8,7,65,28,0.0,186.0
9785,e88c59ad88e9dc27,b0a6124751a56bc4,029eaff01e6bb8f0,2012-12-15,0,0,0,255,2,0,54,20,54,0,0,0,0,0,8,6,46,20,0.0,228.0
9786,cade8a4e97911e89,658c3465581ae46b,85980f5da429c0a6,2012-12-15,1,0,0,326,0,0,15,8,13,2,0,0,2,0,4,3,9,8,19.0,307.0
9787,cade8a4e97911e89,85980f5da429c0a6,658c3465581ae46b,2012-12-15,0,2,0,326,4,1,25,1,25,0,0,0,0,0,16,13,9,1,0.0,108.0
9788,b43c83505edcd8fa,c96d9178c9ed9e62,edad57b3dddf2168,2012-12-15,1,4,0,900,14,7,69,26,63,6,0,0,6,5,12,10,51,21,233.5,420.4
9789,b43c83505edcd8fa,edad57b3dddf2168,c96d9178c9ed9e62,2012-12-15,0,0,0,900,1,0,97,28,93,4,0,0,4,2,10,8,83,26,51.6,537.5
9790,99c12cc04b4261bf,2e25c1d983c26311,3c921b1a30fdcbdd,2012-12-15,0,1,0,900,16,7,18,3,10,8,6,5,2,2,7,7,3,1,497.3,125.7
9791,99c12cc04b4261bf,3c921b1a30fdcbdd,2e25c1d983c26311,2012-12-15,0,0,0,900,0,0,15,6,10,5,0,0,5,4,4,3,6,2,28.3,368.7
9792,8935fc5943a78c20,8b260672a21d1fd6,af90b10c785ced3e,2012-12-15,0,0,0,851,0,0,59,19,55,4,0,0,4,4,13,12,42,15,48.5,622.1
9793,8935fc5943a78c20,af90b10c785ced3e,8b260672a21d1fd6,2012-12-15,0,1,1,851,11,4,67,15,65,2,0,0,2,1,17,15,48,14,46.9,450.5
9794,6b83234360b3ca62,8f2939f5fd9cca1e,f8fe2053d73d7bcf,2012-12-15,1,4,1,364,5,1,17,10,8,9,0,0,9,7,3,3,5,3,59.2,177.8
9795,6b83234360b3ca62,f8fe2053d73d7bcf,8f2939f5fd9cca1e,2012-12-15,0,0,0,364,2,1,16,6,9,7,0,0,7,5,5,4,4,1,107.2,105.8
9796,6463a48c9347a9f3,4417980b3e798abf,f95381efb3051d81,2012-12-15,0,0,0,245,0,0,30,4,30,0,0,0,0,0,6,4,24,4,0.0,186.0
9797,6463a48c9347a9f3,f95381efb3051d81,4417980b3e798abf,2012-12-15,3,0,0,245,0,0,39,18,32,7,0,0,7,5,5,4,27,13,37.0,208.0
9798,5bcc7204a43cf34e,3f7c14c7eca7195d,ba280572acfba13f,2012-12-15,1,0,0,178,1,0,53,22,48,5,0,0,5,4,2,1,46,18,40.0,130.0
9799,5bcc7204a43cf34e,ba280572acfba13f,3f7c14c7eca7195d,2012-12-15,0,0,0,178,0,0,28,9,28,0,0,0,0,0,6,4,22,9,0.0,118.0
9800,452a9728317893d7,e363b21261814830,ffc3e6daaa6da0b7,2012-12-15,0,1,0,360,0,0,15,2,15,0,0,0,0,0,8,2,7,2,0.0,204.0
9801,452a9728317893d7,ffc3e6daaa6da0b7,e363b21261814830,2012-12-15,2,0,0,360,1,1,60,27,41,19,1,1,18,14,11,6,30,13,156.0,163.0
9802,1d20bba4aca5f81a,19a8cce18a1cef9e,f5990c11974d8e9c,2012-12-15,0,0,0,115,0,0,25,7,25,0,0,0,0,0,7,6,18,7,0.0,91.8
9803,1d20bba4aca5f81a,f5990c11974d8e9c,19a8cce18a1cef9e,2012-12-15,1,0,0,115,0,0,17,7,10,7,0,0,7,5,3,2,7,2,3.2,109.0
9804,12d17a837caeae63,9b7694d064a8a0ad,c77a953488e5607d,2012-12-15,1,0,0,135,6,5,19,12,6,13,1,1,12,10,0,0,6,2,83.2,39.0
9805,12d17a837caeae63,c77a953488e5607d,9b7694d064a8a0ad,2012-12-15,0,0,0,135,0,0,4,0,4,0,0,0,0,0,1,0,3,0,0.0,49.8
9806,f82c414666fe934c,b788862dd1c11eac,cfaf010d5b389c09,2012-12-14,1,0,0,900,2,0,119,36,119,0,0,0,0,0,42,39,77,36,0.0,752.9
9807,f82c414666fe934c,cfaf010d5b389c09,b788862dd1c11eac,2012-12-14,0,0,0,900,12,1,159,29,157,2,1,1,1,1,34,24,123,28,33.1,668.0
9808,e57b884785848624,5a6e4d2f0c76a242,c4fe2e9a06ea5bcb,2012-12-14,0,0,0,297,4,3,12,4,12,0,0,0,0,0,0,0,12,4,0.0,62.4
9809,e57b884785848624,c4fe2e9a06ea5bcb,5a6e4d2f0c76a242,2012-12-14,1,0,0,297,0,0,26,10,21,5,0,0,5,5,7,6,14,5,15.6,269.0
9810,e2bacdc395aa7b40,4f732e58ed907eff,896c322f56b8be5a,2012-12-14,2,0,0,641,1,0,100,32,99,1,0,0,1,1,19,18,80,31,1.5,623.0
9811,e2bacdc395aa7b40,896c322f56b8be5a,4f732e58ed907eff,2012-12-14,0,0,0,641,6,1,113,27,113,0,0,0,0,0,15,7,98,27,0.0,548.5
9812,ddf2eff896475431,14ff46596ad80609,7d09200f6a77b20e,2012-12-14,0,0,0,900,9,6,98,29,91,7,1,1,6,5,20,12,71,24,319.7,489.0
9813,ddf2eff896475431,7d09200f6a77b20e,14ff46596ad80609,2012-12-14,0,0,0,900,0,0,141,21,141,0,0,0,0,0,56,35,85,21,0.0,545.3
9814,d6b3c56a4cf14c1a,34e552520a934063,e1147d3d2dabe1ce,2012-12-14,0,0,0,900,5,1,171,29,169,2,1,1,1,1,37,25,132,28,30.0,638.1
9815,d6b3c56a4cf14c1a,e1147d3d2dabe1ce,34e552520a934063,2012-12-14,1,0,0,900,0,0,202,64,191,11,1,1,10,5,29,18,162,59,6.9,848.0
9816,d4c85298623130de,236a37d96d476164,fd5b6598a3b70c0a,2012-12-14,0,0,0,900,12,6,48,16,39,9,0,0,9,3,0,0,39,13,418.2,296.0
9817,d4c85298623130de,fd5b6598a3b70c0a,236a37d96d476164,2012-12-14,0,0,0,900,0,0,106,24,106,0,0,0,0,0,11,10,95,24,0.0,470.8
9818,a6097fd4e77cb881,3623bd267a2eef2e,b5b684eac99ae0a3,2012-12-14,0,0,0,115,0,0,15,0,15,0,0,0,0,0,5,2,10,0,0.0,113.0
9819,a6097fd4e77cb881,b5b684eac99ae0a3,3623bd267a2eef2e,2012-12-14,1,0,0,115,0,0,13,4,11,2,0,0,2,2,7,6,4,2,2.0,113.0
9820,6834ae686aa0c588,8ddf9c51c5fdea75,db1f2ed63b54b9a7,2012-12-14,0,0,0,218,0,0,13,0,13,0,0,0,0,0,7,6,6,0,0.0,183.4
9821,6834ae686aa0c588,db1f2ed63b54b9a7,8ddf9c51c5fdea75,2012-12-14,2,0,0,218,0,0,46,23,36,10,0,0,10,7,3,1,33,16,34.6,173.0
9822,61d89fc97e7b145c,46baf0f57edfa4df,53278852bcd91e11,2012-12-14,0,0,0,900,3,0,139,32,139,0,0,0,0,0,38,33,101,32,0.0,333.0
9823,61d89fc97e7b145c,53278852bcd91e11,46baf0f57edfa4df,2012-12-14,0,0,0,900,2,0,94,39,94,0,0,0,0,0,10,9,84,39,0.0,784.0
9824,4eda704823ccfb71,7bc96507e4b38d3b,879b8df81523d91b,2012-12-14,1,0,0,275,1,1,27,9,20,7,0,0,7,5,11,10,9,4,25.8,162.0
9825,4eda704823ccfb71,879b8df81523d91b,7bc96507e4b38d3b,2012-12-14,1,0,0,275,0,0,18,6,15,3,1,1,2,0,0,0,15,6,54.0,141.2
9826,f0cf2ca8e5c621a8,0b64d0fed453ef7f,7bd94b60d7521e4a,2012-12-08,0,1,1,299,1,0,18,8,4,14,3,3,11,8,1,1,3,0,268.0,18.0
9827,f0cf2ca8e5c621a8,7bd94b60d7521e4a,0b64d0fed453ef7f,2012-12-08,0,1,0,299,0,0,10,5,8,2,0,0,2,2,0,0,8,3,13.0,18.0
9828,ed8944898353b526,182f2b78582de3d8,e14b5aa06eea9653,2012-12-08,0,0,0,536,10,2,16,3,16,0,0,0,0,0,9,6,7,3,0.0,197.9
9829,ed8944898353b526,e14b5aa06eea9653,182f2b78582de3d8,2012-12-08,1,2,0,536,1,1,75,22,43,32,22,19,10,9,17,16,26,13,90.1,353.0
9830,bc72dac46f0383f1,2676b28836a5a836,8355922d564b152c,2012-12-08,1,0,0,1500,12,8,198,63,88,110,37,26,73,41,35,35,53,22,763.3,480.0
9831,bc72dac46f0383f1,8355922d564b152c,2676b28836a5a836,2012-12-08,0,2,0,1500,6,0,83,8,83,0,0,0,0,0,28,22,55,8,0.0,692.7
9832,b57345c34f6d2ab3,22aa91e402d0fe1f,a36556bb1565e32d,2012-12-08,1,0,0,900,10,5,117,35,101,16,2,1,14,7,23,13,78,28,210.2,412.3
9833,b57345c34f6d2ab3,a36556bb1565e32d,22aa91e402d0fe1f,2012-12-08,0,4,0,900,0,0,68,17,67,1,1,1,0,0,6,3,61,17,14.7,542.8
9834,b3e520f1092401c1,2f13e4020cea5b38,bc7230f231701d66,2012-12-08,0,0,0,900,6,0,156,28,156,0,0,0,0,0,38,29,118,28,0.0,756.0
9835,b3e520f1092401c1,bc7230f231701d66,2f13e4020cea5b38,2012-12-08,0,0,0,900,3,0,155,7,155,0,0,0,0,0,37,23,118,7,0.0,899.0
9836,9caaca5748ea9086,18968f97ad34f15c,5f04e3d58d9ce982,2012-12-08,0,0,0,115,1,0,21,3,21,0,0,0,0,0,3,2,18,3,0.0,107.0
9837,9caaca5748ea9086,5f04e3d58d9ce982,18968f97ad34f15c,2012-12-08,1,0,0,115,1,0,21,5,19,2,0,0,2,2,5,3,14,3,6.0,109.0
9838,5c36d760c7e272f5,5f99b2bafb10305f,76729a829623e266,2012-12-08,1,0,0,477,0,0,91,28,91,0,0,0,0,0,30,24,61,28,0.0,476.0
9839,5c36d760c7e272f5,76729a829623e266,5f99b2bafb10305f,2012-12-08,0,0,0,477,2,0,102,16,102,0,0,0,0,0,9,5,93,16,0.0,348.0
9840,41d1e163b930426b,5f87a5c00b3d17ed,80dbeb1dd5b53e64,2012-12-08,0,0,0,900,4,2,273,91,225,48,2,2,46,37,55,35,170,54,398.1,477.0
9841,41d1e163b930426b,80dbeb1dd5b53e64,5f87a5c00b3d17ed,2012-12-08,0,0,0,900,0,0,120,17,120,0,0,0,0,0,26,7,94,17,0.0,501.9
9842,405cbbcaa79db24b,31123249b0bbf52e,9fe85152f351e737,2012-12-08,1,2,0,451,1,1,39,13,37,2,0,0,2,2,13,12,24,11,5.8,344.8
9843,405cbbcaa79db24b,9fe85152f351e737,31123249b0bbf52e,2012-12-08,0,0,0,451,2,0,29,9,28,1,0,0,1,1,0,0,28,8,45.2,264.2
9844,3b1aed7d00a775c6,140745cbbcb023ac,3c6976f8182d9527,2012-12-08,0,1,0,900,3,1,95,23,95,0,0,0,0,0,26,18,69,23,0.0,678.4
9845,3b1aed7d00a775c6,3c6976f8182d9527,140745cbbcb023ac,2012-12-08,0,0,0,900,12,6,156,57,137,19,2,2,17,13,20,13,117,44,133.6,668.0
9846,2adfc6444d1adc01,73c7cfa551289285,cbd5d3cdd862e90e,2012-12-08,0,0,0,900,2,0,89,20,89,0,0,0,0,0,7,4,82,20,0.0,827.2
9847,2adfc6444d1adc01,cbd5d3cdd862e90e,73c7cfa551289285,2012-12-08,0,0,0,900,3,1,203,78,201,2,0,0,2,1,55,38,146,77,16.8,749.0
9848,f6d8bdc3cdcf1dd8,a20d7dfaba74c067,fef3d17e27e916e7,2012-11-17,0,0,0,900,0,0,158,30,158,0,0,0,0,0,39,20,119,30,0.0,890.0
9849,f6d8bdc3cdcf1dd8,fef3d17e27e916e7,a20d7dfaba74c067,2012-11-17,0,0,0,900,0,0,150,9,150,0,0,0,0,0,54,39,96,9,0.0,900.0
9850,e843a7a6f49db3bb,92a9aa9c93192871,d188a3b817860ec6,2012-11-17,0,6,0,900,7,6,91,36,50,41,4,3,37,20,11,5,39,16,490.6,216.7
9851,e843a7a6f49db3bb,d188a3b817860ec6,92a9aa9c93192871,2012-11-17,0,1,0,900,0,0,48,8,47,1,0,0,1,1,8,7,39,7,1.3,395.4
9852,bc3323f172832a53,0a97691039c4bbfb,8e5bfd4e82352340,2012-11-17,1,0,0,900,1,1,66,18,52,14,8,8,6,4,19,13,33,14,52.5,399.0
9853,bc3323f172832a53,8e5bfd4e82352340,0a97691039c4bbfb,2012-11-17,0,1,0,900,5,2,197,54,127,70,4,4,66,36,32,25,95,18,441.0,343.5
9854,a65cf6951e097273,6a2f7c151031653d,cf9d24e4bd0cf2ce,2012-11-17,0,0,0,900,5,4,134,33,120,14,0,0,14,8,31,21,89,25,79.2,651.0
9855,a65cf6951e097273,cf9d24e4bd0cf2ce,6a2f7c151031653d,2012-11-17,0,1,0,900,11,0,59,4,59,0,0,0,0,0,21,15,38,4,0.0,598.8
9856,9b6806203bc4875a,5755960ebd0b16f6,a1b0715c4fd2dbd3,2012-11-17,0,1,1,164,0,0,10,3,8,2,1,1,1,1,4,2,4,2,0.0,44.0
9857,9b6806203bc4875a,a1b0715c4fd2dbd3,5755960ebd0b16f6,2012-11-17,0,0,0,164,1,1,13,3,8,5,0,0,5,2,2,1,6,1,120.0,44.0
9858,8d12287f672cabd8,6506c1d34da9c013,f9f07bb5a43535ed,2012-11-17,0,0,0,1500,8,7,132,52,68,64,10,10,54,35,18,9,50,17,883.2,542.2
9859,8d12287f672cabd8,f9f07bb5a43535ed,6506c1d34da9c013,2012-11-17,1,0,0,1500,0,0,148,27,129,19,0,0,19,13,31,9,98,14,60.8,552.8
9860,72a3ec0672871ab4,7f955f71fa2ce7ac,9fa3bd637edd9aa2,2012-11-17,1,0,0,86,0,0,34,19,24,10,0,0,10,9,8,5,16,10,5.4,73.0
9861,72a3ec0672871ab4,9fa3bd637edd9aa2,7f955f71fa2ce7ac,2012-11-17,0,0,0,86,0,0,33,9,33,0,0,0,0,0,6,5,27,9,0.0,80.6
9862,4a29c1f671bd89cb,0941df56f6ac954b,8b69839f3555a67b,2012-11-17,1,0,0,46,0,0,7,3,6,1,0,0,1,1,0,0,6,2,2.0,44.0
9863,4a29c1f671bd89cb,8b69839f3555a67b,0941df56f6ac954b,2012-11-17,0,0,0,46,0,0,4,0,4,0,0,0,0,0,1,0,3,0,0.0,44.0
9864,4861212df08bbf77,3591d0d5d382a381,4d44f37107f01b9b,2012-11-17,0,1,0,900,2,0,84,15,80,4,0,0,4,1,27,19,53,14,13.1,749.9
9865,4861212df08bbf77,4d44f37107f01b9b,3591d0d5d382a381,2012-11-17,0,2,0,900,8,2,75,14,74,1,0,0,1,0,8,6,66,14,58.1,479.9
9866,467d2dc6a71e1b00,501b07aec9b8fc2d,c21a036b4e012f1c,2012-11-17,0,0,0,900,5,0,369,31,367,2,0,0,2,1,51,32,316,30,0.0,900.0
9867,467d2dc6a71e1b00,c21a036b4e012f1c,501b07aec9b8fc2d,2012-11-17,0,0,0,900,0,0,157,66,157,0,0,0,0,0,32,18,125,66,0.0,900.0
9868,30ebe705eac7b121,1a7745388839e52b,d023ae89a2a4a41e,2012-11-17,0,2,0,900,6,0,109,30,109,0,0,0,0,0,10,7,99,30,0.0,824.0
9869,30ebe705eac7b121,d023ae89a2a4a41e,1a7745388839e52b,2012-11-17,0,0,0,900,4,1,163,22,158,5,3,0,2,0,38,23,120,22,48.0,708.0
9870,1f7c1c741b06a3ed,43563a32c3f10e95,fdf18227faa596dd,2012-11-17,1,1,1,144,2,2,7,6,5,2,0,0,2,2,1,0,4,4,46.4,28.0
9871,1f7c1c741b06a3ed,fdf18227faa596dd,43563a32c3f10e95,2012-11-17,0,0,0,144,2,1,3,0,3,0,0,0,0,0,2,2,1,0,0.0,90.6
9872,e881ba0a28fffb6e,48e093ea1f43a053,97a8f39186f489db,2012-11-10,0,0,0,900,4,4,112,53,35,77,7,4,70,43,7,6,28,10,594.5,230.0
9873,e881ba0a28fffb6e,97a8f39186f489db,48e093ea1f43a053,2012-11-10,0,0,0,900,7,1,25,5,24,1,0,0,1,1,13,9,11,4,6.0,269.5
9874,dd875196c446fdf0,30a09e43f15f1d75,9bcf8603ceb25680,2012-11-10,0,0,0,900,0,0,10,0,10,0,0,0,0,0,3,2,7,0,0.0,151.0
9875,dd875196c446fdf0,9bcf8603ceb25680,30a09e43f15f1d75,2012-11-10,0,2,0,900,6,3,40,18,7,33,5,4,28,18,3,0,4,0,732.0,168.0
9876,dd440cb166329a82,0bcfe2513cb3bc39,7c35f869033901ae,2012-11-10,0,0,0,900,0,0,120,26,120,0,0,0,0,0,22,18,98,26,0.0,820.4
9877,dd440cb166329a82,7c35f869033901ae,0bcfe2513cb3bc39,2012-11-10,0,0,0,900,5,3,164,35,156,8,4,4,4,4,58,46,98,31,79.6,482.0
9878,b79a0b9c1f729c0d,c268b2cfebccf652,c34e5849184b08c3,2012-11-10,0,0,0,900,0,0,224,38,222,2,1,1,1,1,83,38,139,37,9.3,872.0
9879,b79a0b9c1f729c0d,c34e5849184b08c3,c268b2cfebccf652,2012-11-10,0,0,0,900,1,0,158,34,158,0,0,0,0,0,48,28,110,34,0.0,890.7
9880,8d556e2826924946,53ec9cb470e1a4ea,c23e3d4875340d8d,2012-11-10,0,2,0,900,0,0,82,24,82,0,0,0,0,0,16,12,66,24,0.0,497.0
9881,8d556e2826924946,c23e3d4875340d8d,53ec9cb470e1a4ea,2012-11-10,0,0,0,900,2,2,93,33,93,0,0,0,0,0,12,7,81,33,0.0,824.0
9882,346875f19aefc88d,1d4bbaabd8b60173,2924886ee9c4c527,2012-11-10,1,0,0,705,4,0,70,10,68,2,0,0,2,0,12,8,56,10,31.0,323.5
9883,346875f19aefc88d,2924886ee9c4c527,1d4bbaabd8b60173,2012-11-10,0,1,0,705,1,1,95,20,87,8,1,1,7,5,48,41,39,15,9.5,617.0
9884,1a113ac3255f3ac3,d4f364dd076bb0e2,d897897060f10a3a,2012-11-10,1,0,0,137,0,0,16,4,16,0,0,0,0,0,5,4,11,4,0.0,135.0
9885,1a113ac3255f3ac3,d897897060f10a3a,d4f364dd076bb0e2,2012-11-10,0,0,0,137,0,0,21,6,21,0,0,0,0,0,7,6,14,6,0.0,137.0
9886,0fad42b9ab3f31be,3be081c29bf734d9,86f582852a5b240a,2012-11-10,1,0,0,900,2,1,140,31,139,1,0,0,1,1,32,23,107,30,21.8,606.4
9887,0fad42b9ab3f31be,86f582852a5b240a,3be081c29bf734d9,2012-11-10,0,1,0,900,5,2,122,48,115,7,0,0,7,4,25,16,90,44,32.6,785.2
9888,01993fb1d4b34b21,7aa3d6964eff4877,d34636a85f0f4c90,2012-11-10,0,0,0,900,0,0,124,40,121,3,1,1,2,2,31,23,90,38,23.7,829.0
9889,01993fb1d4b34b21,d34636a85f0f4c90,7aa3d6964eff4877,2012-11-10,0,0,0,900,12,2,75,8,75,0,0,0,0,0,19,14,56,8,0.0,652.3
9890,eaa0355223b770dc,10559c53de0b950e,c2e3e67b5911bfb7,2012-10-13,0,1,0,900,4,0,109,22,104,5,0,0,5,4,21,17,83,18,26.4,580.0
9891,eaa0355223b770dc,c2e3e67b5911bfb7,10559c53de0b950e,2012-10-13,1,0,0,900,4,3,77,22,60,17,2,1,15,9,15,10,45,13,283.0,540.6
9892,e3072951bb030826,e25bcbcdaf6537a1,ff4c3ab594c7fac3,2012-10-13,0,0,0,900,4,3,151,70,151,0,0,0,0,0,11,7,140,70,0.0,769.0
9893,e3072951bb030826,ff4c3ab594c7fac3,e25bcbcdaf6537a1,2012-10-13,0,0,0,900,1,0,241,52,239,2,0,0,2,0,36,20,203,52,0.0,900.0
9894,dba1add63d4bcbaa,cbd6f1abf955e628,ee9d73f4fee9cbdd,2012-10-13,0,0,0,571,2,2,32,3,29,3,0,0,3,1,13,10,16,2,31.0,318.4
9895,dba1add63d4bcbaa,ee9d73f4fee9cbdd,cbd6f1abf955e628,2012-10-13,1,3,1,571,3,1,49,19,42,7,0,0,7,3,1,1,41,16,190.6,295.0
9896,dab5e3680cf6eac7,b71ce838b01f2cad,b8aef0faf4ce9b31,2012-10-13,1,1,0,556,1,1,96,33,88,8,0,0,8,8,19,13,69,25,7.2,467.6
9897,dab5e3680cf6eac7,b8aef0faf4ce9b31,b71ce838b01f2cad,2012-10-13,0,0,0,556,1,1,96,28,84,12,0,0,12,7,18,11,66,21,79.4,462.8
9898,d9df78e82953bfe5,24b033b3daf1c9df,6c2030e0a143a94b,2012-10-13,0,1,0,900,3,1,133,42,131,2,0,0,2,2,18,13,113,40,14.4,828.0
9899,d9df78e82953bfe5,6c2030e0a143a94b,24b033b3daf1c9df,2012-10-13,0,0,0,900,1,0,269,67,269,0,0,0,0,0,43,30,226,67,0.0,885.6
9900,778d3f5c4bcc2927,1fb80f46d3c105d9,7ff97850e8c32bda,2012-10-13,0,0,0,600,0,0,36,9,36,0,0,0,0,0,2,1,34,9,0.0,190.39999999999998
9901,778d3f5c4bcc2927,7ff97850e8c32bda,1fb80f46d3c105d9,2012-10-13,1,1,0,600,3,3,145,84,47,98,0,0,98,66,2,1,45,18,409.6,182.0
9902,5ab7629e07da22e6,1bcaac2d99b90fce,44bc27bfa76dcd9e,2012-10-13,0,1,1,790,11,4,45,13,44,1,0,0,1,1,9,3,35,12,52.2,504.1
9903,5ab7629e07da22e6,44bc27bfa76dcd9e,1bcaac2d99b90fce,2012-10-13,0,0,0,790,0,0,76,12,70,6,5,5,1,0,12,9,58,12,24.9,679.8
9904,526ab0f38313c630,1f454354805b6f75,c6a33ff198aaaeeb,2012-10-13,1,0,0,280,0,0,27,15,19,8,0,0,8,5,4,4,15,10,8.4,259.0
9905,526ab0f38313c630,c6a33ff198aaaeeb,1f454354805b6f75,2012-10-13,0,0,0,280,3,0,43,9,43,0,0,0,0,0,10,3,33,9,0.0,93.6
9906,4c9cb823fd7e3e2c,7f6ef4e1227600bc,902ab9197b83d0db,2012-10-13,0,0,0,569,0,0,11,0,11,0,0,0,0,0,2,2,9,0,0.0,275.7
9907,4c9cb823fd7e3e2c,902ab9197b83d0db,7f6ef4e1227600bc,2012-10-13,0,2,1,569,6,5,49,16,20,29,10,7,19,14,6,6,14,2,293.3,215.0
9908,297a3fe0edd6f1c5,75e5fec9f72910ef,a8283a4f415e1eb9,2012-10-13,0,2,0,900,6,5,63,26,54,9,0,0,9,6,11,10,43,20,123.2,369.5
9909,297a3fe0edd6f1c5,a8283a4f415e1eb9,75e5fec9f72910ef,2012-10-13,1,2,0,900,0,0,97,27,76,21,0,0,21,11,20,18,56,16,133.5,528.8
9910,219610bc6e7d9196,427b5953ac8e3a27,5b5307450405abf0,2012-10-13,0,1,1,150,5,3,8,4,1,7,1,1,6,3,0,0,1,1,135.0,15.0
9911,219610bc6e7d9196,5b5307450405abf0,427b5953ac8e3a27,2012-10-13,0,0,0,150,0,0,5,1,5,0,0,0,0,0,2,2,3,1,0.0,15.0
9912,034ce0af4dedbfd7,5866fc86183a9fb8,6f018c039b4d5d80,2012-10-13,0,2,0,900,3,2,33,12,24,9,1,1,8,7,9,6,15,5,69.3,319.2
9913,034ce0af4dedbfd7,6f018c039b4d5d80,5866fc86183a9fb8,2012-10-13,0,2,0,900,9,6,131,69,40,91,9,6,82,55,10,7,30,14,403.8,302.7
9914,dc5e46b2ee0898ec,99506df1af6c8b3b,b102c26727306ab6,2012-10-05,2,0,0,575,2,0,112,20,102,10,2,2,8,8,17,11,85,12,18.0,557.0
9915,dc5e46b2ee0898ec,b102c26727306ab6,99506df1af6c8b3b,2012-10-05,0,0,0,575,5,0,37,8,37,0,0,0,0,0,1,1,36,8,0.0,557.0
9916,b56d1822b9f9a35f,d1a1314976c50bef,e56daf7725a0b5ab,2012-10-05,0,0,0,45,1,0,0,0,0,0,0,0,0,0,0,0,0,0,0.0,25.0
9917,b56d1822b9f9a35f,e56daf7725a0b5ab,d1a1314976c50bef,2012-10-05,0,1,1,45,1,0,7,4,7,0,0,0,0,0,2,2,5,4,0.0,37.0
9918,a80162f4c8842da3,6f81b6de2557739a,75e0d3cc2262b732,2012-10-05,0,2,1,158,4,1,25,6,16,9,0,0,9,5,7,2,9,1,84.0,74.0
9919,a80162f4c8842da3,75e0d3cc2262b732,6f81b6de2557739a,2012-10-05,0,0,0,158,0,0,7,0,7,0,0,0,0,0,0,0,7,0,0.0,74.0
9920,a6548a1e188c53fb,3a24769a4855040a,4304992c2acc187b,2012-10-05,2,0,0,900,6,3,137,36,102,35,0,0,35,17,31,25,71,19,307.1,546.8
9921,a6548a1e188c53fb,4304992c2acc187b,3a24769a4855040a,2012-10-05,0,2,0,900,0,0,119,16,118,1,0,0,1,1,31,21,87,15,2.2,579.9
9922,8802182074bf4a3a,5bb0a618ad03ac64,d81ac739417d7f53,2012-10-05,0,0,0,900,2,0,127,17,127,0,0,0,0,0,20,15,107,17,0.0,856.7
9923,8802182074bf4a3a,d81ac739417d7f53,5bb0a618ad03ac64,2012-10-05,0,0,0,900,4,2,81,18,75,6,0,0,6,5,9,7,66,13,43.3,835.0
9924,5e69e2fa8421ce5e,182f2b78582de3d8,4f853e98886283cf,2012-10-05,0,0,0,900,7,3,77,10,75,2,0,0,2,1,48,43,27,9,20.3,392.0
9925,5e69e2fa8421ce5e,4f853e98886283cf,182f2b78582de3d8,2012-10-05,0,3,0,900,5,0,79,0,79,0,0,0,0,0,60,42,19,0,0.0,747.7
9926,3195350c98c9491d,511e82663651438d,d1e7fc58d4225cdf,2012-10-05,1,0,0,366,0,0,36,8,32,4,0,0,4,4,11,9,21,4,3.0,121.0
9927,3195350c98c9491d,d1e7fc58d4225cdf,511e82663651438d,2012-10-05,1,1,0,366,1,0,35,14,18,17,0,0,17,12,4,3,14,2,242.0,121.0
9928,28990faebda68fa8,236a37d96d476164,d5f820c11a121050,2012-10-05,1,0,0,329,2,0,21,8,19,2,0,0,2,2,2,2,17,6,23.0,252.2
9929,28990faebda68fa8,d5f820c11a121050,236a37d96d476164,2012-10-05,1,1,0,329,1,1,44,23,40,4,0,0,4,4,12,5,28,19,7.8,259.0
9930,147c04a6798a69c3,6546af7ab545b90c,ba043b03eb799063,2012-10-05,0,2,1,518,0,0,43,4,39,4,0,0,4,0,10,3,29,4,80.0,362.5
9931,147c04a6798a69c3,ba043b03eb799063,6546af7ab545b90c,2012-10-05,0,0,0,518,3,2,57,3,54,3,1,1,2,0,14,6,40,3,35.5,284.0
9932,0cced3b02b6b1b95,3236bf606fe9fa5b,8349d55cdecd393a,2012-10-05,0,0,0,207,0,0,19,2,19,0,0,0,0,0,6,6,13,2,0.0,177.6
9933,0cced3b02b6b1b95,8349d55cdecd393a,3236bf606fe9fa5b,2012-10-05,1,0,0,207,2,0,20,8,15,5,1,1,4,3,6,6,9,5,29.4,154.0
9934,e34d313fbe1c28f1,0c6d9ea8306c029e,6809c31286b08d97,2012-09-29,0,0,0,900,12,5,173,62,171,2,1,1,1,0,24,20,147,62,43.3,567.6
9935,e34d313fbe1c28f1,6809c31286b08d97,0c6d9ea8306c029e,2012-09-29,0,0,0,900,2,0,127,32,125,2,0,0,2,2,43,33,82,30,7.4,789.7
9936,e0a69c1f4a019727,960d6cae8879ba2b,f59e9e49ef85b469,2012-09-29,1,0,0,23,0,0,17,6,12,5,0,0,5,5,1,1,11,1,3.0,20.0
9937,e0a69c1f4a019727,f59e9e49ef85b469,960d6cae8879ba2b,2012-09-29,0,0,0,23,0,0,2,1,2,0,0,0,0,0,1,1,1,1,0.0,20.0
9938,cc6934588298958e,3f52ce18fb98008f,b6c4451cb13c9303,2012-09-29,0,0,0,900,0,0,93,29,93,0,0,0,0,0,17,16,76,29,0.0,597.5
9939,cc6934588298958e,b6c4451cb13c9303,3f52ce18fb98008f,2012-09-29,1,0,0,900,11,1,105,36,86,19,0,0,19,17,23,16,63,19,300.5,552.0
9940,a97a7707d5021181,d28dee5c705991df,ebc1f40e00e0c481,2012-09-29,0,0,0,530,3,1,95,24,94,1,0,0,1,1,26,24,68,23,1.5,527.0
9941,a97a7707d5021181,ebc1f40e00e0c481,d28dee5c705991df,2012-09-29,1,0,0,530,0,0,128,41,128,0,0,0,0,0,18,16,110,41,0.0,528.5
9942,91e4da6ecf28a7a3,1a7745388839e52b,28f3c2258a1d8874,2012-09-29,0,0,0,900,3,1,41,11,38,3,0,0,3,2,2,2,36,9,77.2,560.4
9943,91e4da6ecf28a7a3,28f3c2258a1d8874,1a7745388839e52b,2012-09-29,0,0,0,900,2,1,135,20,116,19,7,6,12,6,19,15,97,14,236.6,573.8
9944,4c54ca018e70ed04,6cadfd8f1d9e7685,84ac950d4c1722dd,2012-09-29,1,0,0,148,2,2,13,6,5,8,0,0,8,5,2,2,3,1,90.9,23.0
9945,4c54ca018e70ed04,84ac950d4c1722dd,6cadfd8f1d9e7685,2012-09-29,0,0,0,148,0,0,10,2,9,1,0,0,1,0,0,0,9,2,0.0,57.099999999999994
9946,29cd6bee493a8662,7b143a54451263d9,eb29176b03dfa888,2012-09-29,0,0,0,228,1,1,10,4,0,10,2,2,8,4,0,0,0,0,175.0,13.0
9947,29cd6bee493a8662,eb29176b03dfa888,7b143a54451263d9,2012-09-29,0,2,1,228,0,0,4,2,1,3,0,0,3,2,1,1,0,0,40.0,13.0
9948,26f876a7fb1020e1,1e1dbd1cc5a7469e,b959e8c7fd8390d2,2012-09-29,1,1,0,600,0,0,77,32,75,2,2,2,0,0,19,19,56,32,5.1,549.0
9949,26f876a7fb1020e1,b959e8c7fd8390d2,1e1dbd1cc5a7469e,2012-09-29,0,0,0,600,8,2,44,4,44,0,0,0,0,0,24,24,20,4,0.0,284.9
9950,21392a61a2cf24a3,b4eeac608fc82f88,c945adc22c2bfe8f,2012-09-29,0,0,0,220,0,0,57,15,57,0,0,0,0,0,13,11,44,15,0.0,218.0
9951,21392a61a2cf24a3,c945adc22c2bfe8f,b4eeac608fc82f88,2012-09-29,1,0,0,220,1,0,48,8,46,2,0,0,2,2,9,6,37,6,2.0,218.0
9952,1332dc236a3fd3b2,2650e2f846a30f64,473ce3aa581251a2,2012-09-29,0,0,0,900,2,0,134,31,133,1,0,0,1,1,43,30,90,30,1.8,598.2
9953,1332dc236a3fd3b2,473ce3aa581251a2,2650e2f846a30f64,2012-09-29,0,0,0,900,7,3,141,51,114,27,1,1,26,16,14,13,100,35,256.8,489.2
9954,de1124dba8c1a1b0,0d506315895efffc,5431dccc09118234,2012-09-22,0,0,0,900,3,0,159,51,154,5,0,0,5,3,27,23,127,48,71.7,700.0
9955,de1124dba8c1a1b0,5431dccc09118234,0d506315895efffc,2012-09-22,1,0,0,900,1,0,200,56,186,14,0,0,14,11,45,35,141,45,28.0,784.3
9956,c97d0a476c2e7cb5,2b93ebd9f5417ad2,579fcdfcabd23a7b,2012-09-22,0,0,0,900,13,4,141,46,136,5,0,0,5,1,22,18,114,45,52.3,616.4
9957,c97d0a476c2e7cb5,579fcdfcabd23a7b,2b93ebd9f5417ad2,2012-09-22,0,0,0,900,0,0,141,27,138,3,0,0,3,2,39,30,99,25,11.6,781.7
9958,aa1db19806dfd62e,fd5b6598a3b70c0a,fea8acf9bfcf09ec,2012-09-22,1,0,0,250,0,0,78,12,77,1,0,0,1,1,9,3,68,11,0.5,248.0
9959,aa1db19806dfd62e,fea8acf9bfcf09ec,fd5b6598a3b70c0a,2012-09-22,0,0,0,250,0,0,54,9,54,0,0,0,0,0,9,8,45,9,0.0,249.5
9960,9890835f4c1c6b75,80eacd4da0617c57,8a304bfd6bf04a57,2012-09-22,0,2,0,1500,7,0,250,23,249,1,0,0,1,1,46,21,203,22,7.6,1262.7
9961,9890835f4c1c6b75,8a304bfd6bf04a57,80eacd4da0617c57,2012-09-22,0,0,0,1500,10,5,156,29,146,10,2,2,8,7,58,46,88,22,33.3,1352.4
9962,8af511cc6e6a9678,07f72a2a7591b409,0ee783aa00e468f0,2012-09-22,1,1,1,954,1,1,110,46,54,56,3,3,53,39,28,16,26,7,545.5,387.5
9963,8af511cc6e6a9678,0ee783aa00e468f0,07f72a2a7591b409,2012-09-22,0,1,0,954,0,0,36,8,34,2,0,0,2,1,10,8,24,7,1.5,402.5
9964,87790788d1bb3b75,7339d340aa2889cb,98f6da59d765ec94,2012-09-22,1,0,0,45,0,0,15,7,9,6,0,0,6,4,0,0,9,3,2.0,43.0
9965,87790788d1bb3b75,98f6da59d765ec94,7339d340aa2889cb,2012-09-22,0,0,0,45,0,0,2,0,2,0,0,0,0,0,0,0,2,0,0.0,43.0
9966,5af6a54d7e0f2b7f,a26198ba5093147e,e5c9de15bb58b1c6,2012-09-22,0,0,0,900,3,0,300,99,300,0,0,0,0,0,75,65,225,99,0.0,806.0
9967,5af6a54d7e0f2b7f,e5c9de15bb58b1c6,a26198ba5093147e,2012-09-22,0,0,0,900,8,3,377,132,373,4,0,0,4,1,41,28,332,131,54.0,792.0
9968,3367081258d6ae12,53278852bcd91e11,88a9bc81271ccd89,2012-09-22,0,0,0,374,2,1,13,3,10,3,0,0,3,2,5,5,5,1,79.3,170.4
9969,3367081258d6ae12,88a9bc81271ccd89,53278852bcd91e11,2012-09-22,0,2,1,374,3,1,19,2,16,3,1,1,2,1,12,12,4,1,18.6,195.7
9970,307b12b9f08a4cbf,07225ba28ae309b6,d247691a6c0e9034,2012-09-22,0,0,0,160,2,1,18,5,15,3,0,0,3,2,1,1,14,3,46.0,112.0
9971,307b12b9f08a4cbf,d247691a6c0e9034,07225ba28ae309b6,2012-09-22,1,0,0,160,0,0,21,6,20,1,0,0,1,0,8,3,12,6,2.0,112.0
9972,304fc030ee6dd9ee,27d65e9d0fba61ea,98b80a717b9bda17,2012-09-22,0,0,0,900,0,0,72,9,71,1,0,0,1,1,30,17,41,8,0.0,542.4
9973,304fc030ee6dd9ee,98b80a717b9bda17,27d65e9d0fba61ea,2012-09-22,0,0,0,900,8,6,144,86,63,81,6,5,75,65,6,3,57,21,357.6,538.0
9974,2aff05a835ed715e,92aafa8f4b26269b,b8592b4a383696cd,2012-09-22,0,0,0,69,0,0,8,0,8,0,0,0,0,0,2,1,6,0,0.0,38.0
9975,2aff05a835ed715e,b8592b4a383696cd,92aafa8f4b26269b,2012-09-22,1,1,1,69,0,0,11,5,4,7,0,0,7,4,1,0,3,1,31.0,38.0
9976,147e0b1c64cb7ef0,81801f57bd0a7c41,893d51aaf024eddd,2012-09-22,1,0,0,900,0,0,282,52,278,4,1,0,3,1,102,59,176,51,4.3,800.5
9977,147e0b1c64cb7ef0,893d51aaf024eddd,81801f57bd0a7c41,2012-09-22,0,0,0,900,9,2,175,81,169,6,0,0,6,5,6,6,163,76,84.5,740.7
9978,f0d5e2c27c9fd2c1,acff437707625fc7,b2a2da86546ddb19,2012-08-11,1,0,0,485,6,3,68,23,22,46,1,1,45,18,2,2,20,5,321.0,157.0
9979,f0d5e2c27c9fd2c1,b2a2da86546ddb19,acff437707625fc7,2012-08-11,0,1,0,485,0,0,35,10,35,0,0,0,0,0,7,5,28,10,0.0,161.0
9980,c47cf097227cc6a0,06f36cf4bd97ec77,fe435e440b5de0ff,2012-08-11,0,0,0,900,1,1,50,8,44,6,0,0,6,3,14,13,30,5,52.7,341.2
9981,c47cf097227cc6a0,fe435e440b5de0ff,06f36cf4bd97ec77,2012-08-11,0,0,0,900,8,3,47,15,31,16,1,1,15,11,19,17,12,4,321.8,304.3
9982,be6d6abb11ef8297,32be4b7f7de1c905,55f80a8aeffcdb33,2012-08-11,0,1,0,900,2,2,45,26,12,33,2,2,31,21,4,4,8,5,632.8,112.0
9983,be6d6abb11ef8297,55f80a8aeffcdb33,32be4b7f7de1c905,2012-08-11,0,1,0,900,2,1,37,21,17,20,0,0,20,15,3,1,14,6,136.0,131.20000000000005
9984,9360a34eb511a9b4,23459ee7e373b98f,b7f38813485745da,2012-08-11,0,0,0,436,3,0,149,49,149,0,0,0,0,0,15,12,134,49,0.0,425.0
9985,9360a34eb511a9b4,b7f38813485745da,23459ee7e373b98f,2012-08-11,2,0,0,436,2,1,95,43,94,1,0,0,1,0,14,13,80,43,5.0,361.0
9986,7ddf71a85fbb0e4c,2676b28836a5a836,f2688492b9a525a3,2012-08-11,0,1,0,1500,1,0,167,33,167,0,0,0,0,0,43,31,124,33,0.0,1433.0
9987,7ddf71a85fbb0e4c,f2688492b9a525a3,2676b28836a5a836,2012-08-11,1,2,0,1500,6,2,182,29,180,2,1,1,1,1,55,36,125,28,60.0,1320.0
9988,7c07a71fa1882bf4,1d00756835ca67c9,ccd1299e0345e0ce,2012-08-11,1,0,0,76,0,0,9,3,9,0,0,0,0,0,2,1,7,3,0.0,73.7
9989,7c07a71fa1882bf4,ccd1299e0345e0ce,1d00756835ca67c9,2012-08-11,1,0,0,76,0,0,28,8,27,1,0,0,1,0,4,2,23,8,0.3,72.0
9990,4af9088a165c7751,2b4faacc16d66898,6fb1ba67bef41b37,2012-08-11,0,0,0,225,2,0,10,4,9,1,0,0,1,1,1,1,8,3,4.0,116.0
9991,4af9088a165c7751,6fb1ba67bef41b37,2b4faacc16d66898,2012-08-11,1,0,0,225,4,4,37,22,19,18,2,2,16,16,9,9,10,6,101.0,47.0
9992,42f11b82d67585af,150ff4cc642270b9,879f6cae48d25baa,2012-08-11,1,0,0,589,0,0,124,18,108,16,1,1,15,5,13,10,95,13,5.0,584.0
9993,42f11b82d67585af,879f6cae48d25baa,150ff4cc642270b9,2012-08-11,0,0,0,589,4,1,90,26,90,0,0,0,0,0,20,6,70,26,0.0,575.0
9994,19da5aa17c896a1a,af62f99eb7606308,fbf0947399d14323,2012-08-11,1,0,0,17,0,0,11,7,5,6,0,0,6,6,2,2,3,1,4.0,13.0
9995,19da5aa17c896a1a,fbf0947399d14323,af62f99eb7606308,2012-08-11,0,0,0,17,0,0,3,1,3,0,0,0,0,0,1,1,2,1,0.0,13.0
9996,0c58b5f37bfeb65a,0871254cd790c250,6f242453c91a5af0,2012-08-11,1,0,0,283,3,0,27,6,25,2,0,0,2,1,4,0,21,5,28.0,142.1
9997,0c58b5f37bfeb65a,6f242453c91a5af0,0871254cd790c250,2012-08-11,0,2,1,283,2,1,27,12,19,8,0,0,8,5,1,0,18,7,112.9,128.0
9998,d2ea9181abacc2ee,282fa667ff9c51ed,80dbeb1dd5b53e64,2012-08-04,0,0,0,900,1,0,422,120,422,0,0,0,0,0,41,23,381,120,0.0,900.0
9999,d2ea9181abacc2ee,80dbeb1dd5b53e64,282fa667ff9c51ed,2012-08-04,0,0,0,900,0,0,366,96,366,0,0,0,0,0,52,33,314,96,0.0,900.0
10000,9a85303025a077b5,60ba33c3f555a7a3,94527830000ab715,2012-08-04,0,0,0,195,0,0,10,3,9,1,0,0,1,1,3,3,6,2,6.0,41.0
10001,9a85303025a077b5,94527830000ab715,60ba33c3f555a7a3,2012-08-04,0,1,1,195,2,1,9,2,6,3,0,0,3,2,2,1,4,0,148.0,41.0
10002,957b7c74ce120a32,c0ab242c40decc55,f7a7f7118d4b01b6,2012-08-04,0,0,0,392,0,0,32,2,32,0,0,0,0,0,10,5,22,2,0.0,389.0
10003,957b7c74ce120a32,f7a7f7118d4b01b6,c0ab242c40decc55,2012-08-04,1,0,0,392,0,0,31,8,29,2,0,0,2,2,14,13,15,6,3.0,389.0
10004,7e27d9f37c217b63,7f6ef4e1227600bc,902ab9197b83d0db,2012-08-04,0,0,0,88,0,0,16,2,16,0,0,0,0,0,1,0,15,2,0.0,88.0
10005,7e27d9f37c217b63,902ab9197b83d0db,7f6ef4e1227600bc,2012-08-04,0,0,0,88,0,0,12,3,12,0,0,0,0,0,3,1,9,3,0.0,88.0
10006,758ec6b5d55c1b09,6ef65b6a152e49d5,dcdd511ff757f15c,2012-08-04,1,1,1,556,6,2,77,29,65,12,1,1,11,6,6,5,59,23,150.6,192.0
10007,758ec6b5d55c1b09,dcdd511ff757f15c,6ef65b6a152e49d5,2012-08-04,0,0,0,556,3,0,35,4,35,0,0,0,0,0,18,14,17,4,0.0,356.4
10008,4c4e1f7521c27900,3bad7ef643840f67,a54fc2d6fc224dc3,2012-08-04,0,1,1,764,5,2,118,42,110,8,0,0,8,8,3,2,107,34,104.8,592.6
10009,4c4e1f7521c27900,a54fc2d6fc224dc3,3bad7ef643840f67,2012-08-04,1,1,0,764,4,2,177,53,175,2,2,2,0,0,34,27,141,53,40.4,558.2
10010,3e6dfafb8aa780f9,9f842be1a5337be6,cc6f9d1e89f3449a,2012-08-04,1,0,0,900,2,0,94,30,94,0,0,0,0,0,17,11,77,30,0.0,837.0
10011,3e6dfafb8aa780f9,cc6f9d1e89f3449a,9f842be1a5337be6,2012-08-04,0,0,0,900,12,6,116,37,116,0,0,0,0,0,19,15,97,37,0.0,618.0
10012,1e2677e481a587fd,322a56923b396b4d,9fe85152f351e737,2012-08-04,0,0,0,380,2,2,53,13,42,11,3,3,8,6,1,1,41,7,186.1,169.2
10013,1e2677e481a587fd,9fe85152f351e737,322a56923b396b4d,2012-08-04,1,0,0,380,1,1,41,18,38,3,0,0,3,3,3,1,35,15,7.8,180.9
10014,1cbffe3a467d0ded,140745cbbcb023ac,fa315e6c77eee106,2012-08-04,1,0,0,1149,7,4,103,51,86,17,3,3,14,11,19,14,67,40,333.2,439.6
10015,1cbffe3a467d0ded,fa315e6c77eee106,140745cbbcb023ac,2012-08-04,0,1,0,1149,2,1,106,28,102,4,0,0,4,2,43,39,59,26,23.4,704.8
10016,08bd9e03c187f66b,1e35aa8955794580,92437c6775b3f7d1,2012-08-04,0,0,0,226,5,0,43,7,43,0,0,0,0,0,11,9,32,7,0.0,201.2
10017,08bd9e03c187f66b,92437c6775b3f7d1,1e35aa8955794580,2012-08-04,1,0,0,226,0,0,63,12,62,1,0,0,1,1,26,22,36,11,1.8,205.0
10018,fa6775e369b9eec9,5ef0088c1b19beeb,b8592b4a383696cd,2012-07-21,0,1,1,699,9,3,45,8,38,7,0,0,7,3,4,3,34,5,171.8,307.3
10019,fa6775e369b9eec9,b8592b4a383696cd,5ef0088c1b19beeb,2012-07-21,0,0,0,699,5,1,65,23,53,12,0,0,12,6,5,4,48,17,72.7,327.2
10020,ec5e9ce2be2e1586,4b4753d19489297f,bc3ec52ef70fc155,2012-07-21,0,0,0,7,0,0,1,0,1,0,0,0,0,0,0,0,1,0,0.0,5.0
10021,ec5e9ce2be2e1586,bc3ec52ef70fc155,4b4753d19489297f,2012-07-21,1,0,0,7,0,0,2,2,1,1,0,0,1,1,0,0,1,1,2.0,5.0
10022,ccacbe6a4c31cd45,d023ae89a2a4a41e,e5ecaf884b6da2bc,2012-07-21,0,1,0,722,9,5,63,19,48,15,0,0,15,11,12,9,36,8,188.7,374.4
10023,ccacbe6a4c31cd45,e5ecaf884b6da2bc,d023ae89a2a4a41e,2012-07-21,0,0,0,722,0,0,76,21,65,11,0,0,11,7,21,17,44,14,20.6,488.3
10024,c330107229012260,19a8cce18a1cef9e,32ba186f4b0e3267,2012-07-21,0,1,0,900,1,1,83,22,82,1,0,0,1,1,19,15,63,21,8.9,593.3
10025,c330107229012260,32ba186f4b0e3267,19a8cce18a1cef9e,2012-07-21,0,0,0,900,15,1,88,13,81,7,0,0,7,2,35,22,46,11,110.7,717.1
10026,b6620177ac975ff2,c80095f6092271a7,db1f2ed63b54b9a7,2012-07-21,0,0,0,900,9,0,98,11,98,0,0,0,0,0,59,43,39,11,0.0,852.1
10027,b6620177ac975ff2,db1f2ed63b54b9a7,c80095f6092271a7,2012-07-21,0,0,0,900,4,2,77,18,75,2,0,0,2,2,12,8,63,16,40.9,757.0
10028,b616ec23516b7244,706f8e2b34e8e18b,c76ec2bc3a57666a,2012-07-21,0,1,0,900,3,3,53,24,32,21,1,1,20,15,5,4,27,9,375.5,275.7
10029,b616ec23516b7244,c76ec2bc3a57666a,706f8e2b34e8e18b,2012-07-21,0,1,0,900,8,3,24,6,22,2,0,0,2,0,0,0,22,6,177.3,258.5
10030,93ffadd9e41af797,173acb3f920082b8,7ea4a9f07df33a45,2012-07-21,0,0,0,259,1,0,60,6,60,0,0,0,0,0,18,10,42,6,0.0,258.2
10031,93ffadd9e41af797,7ea4a9f07df33a45,173acb3f920082b8,2012-07-21,1,0,0,259,0,0,79,39,77,2,0,0,2,2,15,13,62,37,0.8,257.0
10032,66785060ebaa2387,1eacf73d6a0055dc,ca2efc9d7d523c43,2012-07-21,0,0,0,900,2,0,56,13,56,0,0,0,0,0,25,25,31,13,0.0,477.2
10033,66785060ebaa2387,ca2efc9d7d523c43,1eacf73d6a0055dc,2012-07-21,0,0,0,900,5,0,41,6,36,5,0,0,5,1,9,9,27,5,59.8,541.0
10034,64fa0e558f5d1b24,361d49960a196976,fef3d17e27e916e7,2012-07-21,0,0,0,71,0,0,20,6,20,0,0,0,0,0,3,1,17,6,0.0,68.8
10035,64fa0e558f5d1b24,fef3d17e27e916e7,361d49960a196976,2012-07-21,1,0,0,71,0,0,23,8,20,3,0,0,3,2,3,2,17,6,2.2,68.0
10036,50a381c1eb88dbb0,2c99576fefe53c7c,78114b7199cef90c,2012-07-21,0,0,0,1500,0,0,290,55,290,0,0,0,0,0,54,30,236,55,0.0,1500.0
10037,50a381c1eb88dbb0,78114b7199cef90c,2c99576fefe53c7c,2012-07-21,0,0,0,1500,6,0,178,38,178,0,0,0,0,0,37,22,141,38,0.0,1492.0
10038,3c552514bb9b5c98,523fa774700d7d3f,b13da0b1a3aed3e7,2012-07-21,0,0,0,900,4,0,295,70,295,0,0,0,0,0,54,38,241,70,0.0,891.0
10039,3c552514bb9b5c98,b13da0b1a3aed3e7,523fa774700d7d3f,2012-07-21,0,0,0,900,7,0,137,41,137,0,0,0,0,0,33,27,104,41,0.0,874.0
10040,d6dcbf543d7e303d,7aa3d6964eff4877,c96e2ae6021144a1,2012-07-11,0,3,1,387,0,0,12,4,11,1,0,0,1,1,5,5,6,3,6.5,66.19999999999999
10041,d6dcbf543d7e303d,c96e2ae6021144a1,7aa3d6964eff4877,2012-07-11,0,0,0,387,2,2,22,3,6,16,2,2,14,2,2,2,4,1,307.8,53.5
10042,d37660fceaa8125a,3591d0d5d382a381,d23ccf4a6c221284,2012-07-11,0,2,1,399,1,0,8,2,3,5,1,1,4,1,1,1,2,1,181.7,118.0
10043,d37660fceaa8125a,d23ccf4a6c221284,3591d0d5d382a381,2012-07-11,0,2,0,399,8,1,7,0,6,1,0,0,1,0,3,3,3,0,63.0,91.30000000000001
10044,a914df32b95a1abc,2f13e4020cea5b38,57bf89d42364d39e,2012-07-11,1,0,0,325,0,0,60,14,51,9,4,4,5,3,24,21,27,11,38.7,282.0
10045,a914df32b95a1abc,57bf89d42364d39e,2f13e4020cea5b38,2012-07-11,0,0,0,325,1,0,14,5,14,0,0,0,0,0,1,0,13,5,0.0,286.3
10046,8d2f3e0abb22689f,179f1948dc234f1f,3a8176e15b9887c1,2012-07-11,0,0,0,397,0,0,7,0,7,0,0,0,0,0,1,0,6,0,0.0,178.6
10047,8d2f3e0abb22689f,3a8176e15b9887c1,179f1948dc234f1f,2012-07-11,1,2,0,397,2,2,37,20,16,21,2,2,19,15,6,6,10,5,218.4,85.0
10048,831957c67bfc4486,0c9c0a43d3f3f49d,cc3147b49c7d7d92,2012-07-11,0,0,0,900,17,0,97,11,97,0,0,0,0,0,62,52,35,11,0.0,445.0
10049,831957c67bfc4486,cc3147b49c7d7d92,0c9c0a43d3f3f49d,2012-07-11,0,0,0,900,1,1,101,16,101,0,0,0,0,0,50,33,51,16,0.0,887.0
10050,7287b029f4596be7,8bb6f4479685bbcc,c849740a3ff51931,2012-07-11,0,0,0,153,0,0,19,3,19,0,0,0,0,0,7,5,12,3,0.0,153.0
10051,7287b029f4596be7,c849740a3ff51931,8bb6f4479685bbcc,2012-07-11,0,1,1,153,3,2,16,2,16,0,0,0,0,0,2,1,14,2,0.0,92.0
10052,34e67c2b110f6b6a,6a2f7c151031653d,6bf5a7d3e081ade2,2012-07-11,0,0,0,900,17,6,85,19,79,6,2,2,4,3,35,30,44,16,75.9,495.0
10053,34e67c2b110f6b6a,6bf5a7d3e081ade2,6a2f7c151031653d,2012-07-11,0,0,0,900,0,0,87,13,87,0,0,0,0,0,32,19,55,13,0.0,824.1
10054,1eb7733d880a0b8f,6e0273f9478be71e,d5f820c11a121050,2012-07-11,0,0,0,900,6,0,50,10,48,2,0,0,2,2,22,19,26,8,5.9,452.4
10055,1eb7733d880a0b8f,d5f820c11a121050,6e0273f9478be71e,2012-07-11,0,0,0,900,14,6,70,27,39,31,9,7,22,18,14,14,25,9,365.6,269.1
10056,1085f281dd966d96,b0f316c60f8d3b47,b2e3aca4cd363477,2012-07-11,0,0,0,900,8,1,65,12,65,0,0,0,0,0,9,8,56,12,0.0,563.2
10057,1085f281dd966d96,b2e3aca4cd363477,b0f316c60f8d3b47,2012-07-11,0,0,0,900,6,3,104,48,88,16,4,4,12,12,18,18,70,36,105.8,642.0
10058,0d63a7d3e08df3db,46baf0f57edfa4df,f5431394fb284bb9,2012-07-11,0,0,0,900,2,1,278,45,277,1,0,0,1,1,35,28,242,44,7.9,665.4
10059,0d63a7d3e08df3db,f5431394fb284bb9,46baf0f57edfa4df,2012-07-11,1,0,0,900,9,3,249,80,233,16,2,2,14,8,52,40,181,72,123.6,722.1
10060,0ae4889892f21738,0dba4df5f34d5ff0,8a70ceb3edbe757b,2012-07-11,2,0,0,592,5,2,109,47,93,16,0,0,16,13,31,26,62,34,51.4,468.7
10061,0ae4889892f21738,8a70ceb3edbe757b,0dba4df5f34d5ff0,2012-07-11,1,0,0,592,1,0,72,10,70,2,0,0,2,2,14,13,56,8,33.3,490.6
10062,ded18af0e4eae2f7,032cc3922d871c7f,75e5fec9f72910ef,2012-07-07,0,0,0,900,13,0,101,13,101,0,0,0,0,0,19,12,82,13,0.0,634.0
10063,ded18af0e4eae2f7,75e5fec9f72910ef,032cc3922d871c7f,2012-07-07,0,0,0,900,6,1,87,15,87,0,0,0,0,0,17,13,70,15,0.0,883.0
10064,d1268ffa059f9d42,7be63795363029e8,b5b684eac99ae0a3,2012-07-07,0,0,0,31,0,0,6,0,6,0,0,0,0,0,1,1,5,0,0.0,28.0
10065,d1268ffa059f9d42,b5b684eac99ae0a3,7be63795363029e8,2012-07-07,1,0,0,31,0,0,8,5,4,4,0,0,4,4,3,3,1,1,3.0,28.0
10066,cf04a408cedb37ff,2f732dd9210d301f,fcffee71cff5530e,2012-07-07,0,0,0,900,6,3,128,47,121,7,0,0,7,5,5,2,116,42,88.3,736.0
10067,cf04a408cedb37ff,fcffee71cff5530e,2f732dd9210d301f,2012-07-07,0,0,0,900,0,0,261,54,261,0,0,0,0,0,56,31,205,54,0.0,759.7
10068,8e7b1dfc608a2ef4,15b1b21cd743d652,afc2a7ce0c763bd5,2012-07-07,0,5,0,900,7,4,40,9,20,20,10,10,10,7,10,10,10,2,661.0,239.0
10069,8e7b1dfc608a2ef4,afc2a7ce0c763bd5,15b1b21cd743d652,2012-07-07,0,0,0,900,0,0,57,14,57,0,0,0,0,0,14,13,43,14,0.0,239.0
10070,83526f699d25e4e4,1f454354805b6f75,48d1f690b763934c,2012-07-07,1,0,0,415,0,0,30,11,17,13,1,1,12,8,4,3,13,3,13.7,133.8
10071,83526f699d25e4e4,48d1f690b763934c,1f454354805b6f75,2012-07-07,0,0,0,415,4,1,36,16,16,20,3,2,17,12,4,4,12,4,262.2,47.3
10072,64d4c58a37e1d29b,9fa3bd637edd9aa2,d4f364dd076bb0e2,2012-07-07,0,0,0,900,2,0,133,19,133,0,0,0,0,0,48,32,85,19,0.0,823.4
10073,64d4c58a37e1d29b,d4f364dd076bb0e2,9fa3bd637edd9aa2,2012-07-07,0,0,0,900,2,2,113,27,112,1,0,0,1,0,36,28,76,27,6.6,827.0
10074,61cb2ca1469c83ba,427b5953ac8e3a27,9bcf8603ceb25680,2012-07-07,1,0,0,47,3,1,1,1,0,1,0,0,1,1,0,0,0,0,41.0,6.0
10075,61cb2ca1469c83ba,9bcf8603ceb25680,427b5953ac8e3a27,2012-07-07,0,0,0,47,0,0,8,7,5,3,0,0,3,3,1,1,4,4,0.0,6.0
10076,5c783d455daff573,75e0d3cc2262b732,7a15f3694c5cbc02,2012-07-07,0,0,0,900,7,3,69,20,60,9,0,0,9,9,13,11,47,11,391.9,383.2
10077,5c783d455daff573,7a15f3694c5cbc02,75e0d3cc2262b732,2012-07-07,0,0,0,900,1,0,103,28,100,3,0,0,3,1,8,7,92,27,37.8,382.1
10078,2f5e137118d57d0e,05560764359161e4,7c35f869033901ae,2012-07-07,0,0,0,900,2,0,162,37,162,0,0,0,0,0,8,5,154,37,0.0,893.0
10079,2f5e137118d57d0e,7c35f869033901ae,05560764359161e4,2012-07-07,0,0,0,900,8,0,97,20,97,0,0,0,0,0,29,24,68,20,0.0,784.0
10080,21751a3cc69e5aae,5755960ebd0b16f6,bc7230f231701d66,2012-07-07,0,0,0,900,1,0,148,10,148,0,0,0,0,0,50,30,98,10,0.0,876.0
10081,21751a3cc69e5aae,bc7230f231701d66,5755960ebd0b16f6,2012-07-07,0,0,0,900,2,1,169,14,167,2,0,0,2,1,53,32,114,13,24.0,852.0
10082,0c37ff69a00c0e74,7abe471b61725980,ccd1299e0345e0ce,2012-07-07,0,0,0,900,11,1,74,7,70,4,0,0,4,1,19,11,51,6,84.0,718.7
10083,0c37ff69a00c0e74,ccd1299e0345e0ce,7abe471b61725980,2012-07-07,0,0,0,900,1,1,101,27,89,12,0,0,12,8,12,10,77,19,55.3,733.0
10084,f638f176dd1834c0,2f95a3c6d58b2aad,ed209f6618c82e41,2012-06-23,0,1,0,900,1,0,50,10,44,6,1,1,5,3,10,8,34,7,40.2,292.0
10085,f638f176dd1834c0,ed209f6618c82e41,2f95a3c6d58b2aad,2012-06-23,0,0,0,900,10,5,44,8,27,17,6,4,11,7,10,7,17,1,541.0,318.8
10086,f269d25146eec937,db6d5f691aea3fd3,e363b21261814830,2012-06-23,0,0,0,664,2,2,41,5,34,7,0,0,7,0,16,12,18,5,343.0,271.2
10087,f269d25146eec937,e363b21261814830,db6d5f691aea3fd3,2012-06-23,1,0,0,664,0,0,58,20,53,5,0,0,5,1,12,8,41,19,0.8,319.0
10088,cc3e0c5a0f868502,8bbc0cfc01bc1ba1,c1a5d3843596df92,2012-06-23,0,1,0,641,0,0,81,19,81,0,0,0,0,0,20,14,61,19,0.0,386.7
10089,cc3e0c5a0f868502,c1a5d3843596df92,8bbc0cfc01bc1ba1,2012-06-23,1,0,0,641,4,1,94,42,62,32,2,2,30,24,34,24,28,18,254.3,347.0
10090,c1bf9ca94c1f7f09,970beed85bc46b63,a8283a4f415e1eb9,2012-06-23,0,0,0,261,4,0,4,1,4,0,0,0,0,0,2,2,2,1,0.0,149.0
10091,c1bf9ca94c1f7f09,a8283a4f415e1eb9,970beed85bc46b63,2012-06-23,1,0,0,261,0,0,26,9,11,15,4,4,11,7,9,8,2,2,45.0,192.0
10092,9232fed045b1f4f9,1bcaac2d99b90fce,dbc17725b887860a,2012-06-23,0,0,0,900,2,0,73,25,73,0,0,0,0,0,13,13,60,25,0.0,860.2
10093,9232fed045b1f4f9,dbc17725b887860a,1bcaac2d99b90fce,2012-06-23,2,0,0,900,0,0,111,27,102,9,2,1,7,3,29,14,73,24,39.8,847.0
10094,366de1daf05a2b62,b71ce838b01f2cad,fa37628269132d1a,2012-06-23,0,0,0,900,2,0,76,13,67,9,6,6,3,3,24,17,43,10,186.9,570.4
10095,366de1daf05a2b62,fa37628269132d1a,b71ce838b01f2cad,2012-06-23,0,1,0,900,4,0,83,16,72,11,2,1,9,6,20,15,52,10,59.6,648.1
10096,1c0bf66167c91e01,71002dbc1743b9a7,7cf20446453f852b,2012-06-23,0,0,0,900,2,2,68,21,59,9,1,1,8,6,19,16,40,15,116.0,632.5
10097,1c0bf66167c91e01,7cf20446453f852b,71002dbc1743b9a7,2012-06-23,0,0,0,900,3,1,78,17,68,10,2,2,8,3,16,11,52,14,151.5,587.0
10098,1bfb8faa1edd3867,2937cb502dda0808,a20d7dfaba74c067,2012-06-23,0,0,0,132,0,0,18,2,18,0,0,0,0,0,6,6,12,2,0.0,132.0
10099,1bfb8faa1edd3867,a20d7dfaba74c067,2937cb502dda0808,2012-06-23,0,1,1,132,0,0,21,7,21,0,0,0,0,0,5,4,16,7,0.0,99.0
10100,0239f24134022656,353de740bb6c7e75,492b202d2064e7a9,2012-06-23,0,0,0,148,0,0,16,3,16,0,0,0,0,0,0,0,16,3,0.0,128.0
10101,0239f24134022656,492b202d2064e7a9,353de740bb6c7e75,2012-06-23,1,0,0,148,0,0,58,26,39,19,0,0,19,13,6,5,33,13,10.0,137.0
10102,00c20fa576380ac8,86061eaba822bfea,f95381efb3051d81,2012-06-23,0,0,0,900,6,1,140,19,140,0,0,0,0,0,42,33,98,19,0.0,783.4
10103,00c20fa576380ac8,f95381efb3051d81,86061eaba822bfea,2012-06-23,0,0,0,900,0,0,141,31,139,2,0,0,2,0,43,34,96,31,10.6,826.0
10104,f4af2b4349b7b589,6c2030e0a143a94b,f8fe2053d73d7bcf,2012-06-22,1,0,0,711,0,0,69,19,69,0,0,0,0,0,16,15,53,19,0.0,610.7
10105,f4af2b4349b7b589,f8fe2053d73d7bcf,6c2030e0a143a94b,2012-06-22,0,0,0,711,9,2,43,10,39,4,0,0,4,2,9,4,30,8,52.3,554.0
10106,ecb9c5ae7fd7a5cc,d0c29452d3272603,e9e1acc96536bb4f,2012-06-22,1,3,1,792,4,0,92,40,81,11,0,0,11,9,19,17,62,31,28.6,568.4
10107,ecb9c5ae7fd7a5cc,e9e1acc96536bb4f,d0c29452d3272603,2012-06-22,0,0,0,792,8,2,107,26,90,17,14,14,3,3,39,32,51,23,145.6,352.4
10108,cd055be419f77f3e,10559c53de0b950e,d188a3b817860ec6,2012-06-22,0,0,0,167,2,0,15,2,15,0,0,0,0,0,3,3,12,2,0.0,119.3
10109,cd055be419f77f3e,d188a3b817860ec6,10559c53de0b950e,2012-06-22,0,1,1,167,3,1,16,9,12,4,0,0,4,4,3,3,9,5,22.7,99.0
10110,a497d4a83afe6f2d,31123249b0bbf52e,7bc475b0fc2020ab,2012-06-22,1,0,0,560,3,0,88,30,88,0,0,0,0,0,24,22,64,30,0.0,546.0
10111,a497d4a83afe6f2d,7bc475b0fc2020ab,31123249b0bbf52e,2012-06-22,0,0,0,560,5,1,61,7,61,0,0,0,0,0,14,13,47,7,0.0,336.0
10112,8a1678a54dc82206,3974fa35c917af1d,ef7fa30364cbe7f2,2012-06-22,0,4,0,900,1,0,73,15,68,5,5,5,0,0,23,16,45,15,47.5,647.6
10113,8a1678a54dc82206,ef7fa30364cbe7f2,3974fa35c917af1d,2012-06-22,0,0,0,900,5,4,45,6,43,2,0,0,2,2,20,11,23,4,176.4,411.5
10114,756cae177016ebf1,501b07aec9b8fc2d,f34312c2ccfa0e00,2012-06-22,0,0,0,900,8,4,189,28,189,0,0,0,0,0,50,36,139,28,0.0,668.0
10115,756cae177016ebf1,f34312c2ccfa0e00,501b07aec9b8fc2d,2012-06-22,0,0,0,900,1,0,156,43,156,0,0,0,0,0,24,22,132,43,0.0,894.0
10116,69fd05c73b645a62,32ba186f4b0e3267,8f2939f5fd9cca1e,2012-06-22,0,0,0,900,5,2,59,29,37,22,1,1,21,18,16,9,21,11,363.0,387.7
10117,69fd05c73b645a62,8f2939f5fd9cca1e,32ba186f4b0e3267,2012-06-22,1,4,0,900,1,1,41,9,40,1,0,0,1,1,10,9,30,8,17.3,433.0
10118,40fa0bf9783cdc2e,4f732e58ed907eff,d247691a6c0e9034,2012-06-22,0,0,0,554,6,3,107,24,95,12,2,1,10,6,16,13,79,18,144.9,393.1
10119,40fa0bf9783cdc2e,d247691a6c0e9034,4f732e58ed907eff,2012-06-22,1,0,0,554,1,0,104,39,97,7,0,0,7,4,9,6,88,35,3.9,404.1
10120,2d3cbfb47faf717d,5b5307450405abf0,64959f90b6dd9759,2012-06-22,0,0,0,900,6,5,125,13,100,25,20,20,5,1,26,18,74,12,279.5,587.0
10121,2d3cbfb47faf717d,64959f90b6dd9759,5b5307450405abf0,2012-06-22,0,0,0,900,2,0,60,11,60,0,0,0,0,0,13,7,47,11,0.0,574.5
10122,18efcec3c51750e9,7d96bc577e5178b2,c47df9303d318c67,2012-06-22,0,1,0,1500,9,1,225,35,218,7,7,6,0,0,12,8,206,35,27.2,1430.0
10123,18efcec3c51750e9,c47df9303d318c67,7d96bc577e5178b2,2012-06-22,0,0,0,1500,3,0,321,40,321,0,0,0,0,0,9,5,312,40,0.0,1425.8
10124,179426f56818a1c9,55f80a8aeffcdb33,fbf0947399d14323,2012-06-22,0,0,0,900,3,0,90,14,90,0,0,0,0,0,31,27,59,14,0.0,857.3
10125,179426f56818a1c9,fbf0947399d14323,55f80a8aeffcdb33,2012-06-22,0,0,0,900,3,0,119,31,116,3,0,0,3,0,33,32,83,31,41.7,594.0
10126,00731068c3195f7f,22aa91e402d0fe1f,c0eecd851dbf3146,2012-06-22,1,0,0,149,3,1,15,5,9,6,0,0,6,3,1,0,8,2,64.0,77.0
10127,00731068c3195f7f,c0eecd851dbf3146,22aa91e402d0fe1f,2012-06-22,0,0,0,149,0,0,7,3,6,1,0,0,1,1,2,2,4,2,8.0,61.0
10128,ed697b0ef9d455e4,0b64d0fed453ef7f,fc9a9559a05f2704,2012-06-08,0,0,0,550,4,0,144,32,144,0,0,0,0,0,20,16,124,32,0.0,541.0
10129,ed697b0ef9d455e4,fc9a9559a05f2704,0b64d0fed453ef7f,2012-06-08,1,0,0,550,1,1,188,54,185,3,0,0,3,3,16,7,169,51,9.0,526.0
10130,d1ad8d6ef48f7835,76729a829623e266,7a613f78dd7ee8f8,2012-06-08,0,0,0,900,0,0,146,13,146,0,0,0,0,0,7,5,139,13,0.0,886.0
10131,d1ad8d6ef48f7835,7a613f78dd7ee8f8,76729a829623e266,2012-06-08,0,1,0,900,7,0,132,12,132,0,0,0,0,0,27,14,105,12,0.0,899.0
10132,d08a7d4de3c760ec,0d506315895efffc,e57fdbea1b828202,2012-06-08,0,1,0,900,2,1,109,20,104,5,0,0,5,3,23,21,81,17,39.8,648.3
10133,d08a7d4de3c760ec,e57fdbea1b828202,0d506315895efffc,2012-06-08,0,0,0,900,7,3,99,17,97,2,0,0,2,2,28,20,69,15,12.7,688.2
10134,be6024894ebcb360,d1a1314976c50bef,f5990c11974d8e9c,2012-06-08,0,0,0,296,1,0,35,10,35,0,0,0,0,0,9,9,26,10,0.0,228.7
10135,be6024894ebcb360,f5990c11974d8e9c,d1a1314976c50bef,2012-06-08,1,0,0,296,1,1,28,12,24,4,0,0,4,2,7,6,17,10,58.3,121.0
10136,a6d07c32a1cb9730,917e53fa0adea0d3,bfc2fc38a0e20211,2012-06-08,0,0,0,900,0,0,69,1,69,0,0,0,0,0,7,1,62,1,0.0,345.9
10137,a6d07c32a1cb9730,bfc2fc38a0e20211,917e53fa0adea0d3,2012-06-08,0,1,0,900,7,4,113,59,24,89,0,0,89,52,7,2,17,7,554.1,321.0
10138,873886ee1dee4c9a,0c5c66ddd1886b83,b2a2da86546ddb19,2012-06-08,0,0,0,900,15,2,92,8,91,1,0,0,1,1,34,14,57,7,113.5,672.2
10139,873886ee1dee4c9a,b2a2da86546ddb19,0c5c66ddd1886b83,2012-06-08,0,0,0,900,0,0,111,26,110,1,0,0,1,1,17,9,93,25,0.8,780.5
10140,77b6fd5d0b8c60b4,5866fc86183a9fb8,98f6da59d765ec94,2012-06-08,0,2,1,273,0,0,14,1,14,0,0,0,0,0,12,9,2,1,0.0,240.0
10141,77b6fd5d0b8c60b4,98f6da59d765ec94,5866fc86183a9fb8,2012-06-08,0,0,0,273,7,1,12,2,12,0,0,0,0,0,3,1,9,2,0.0,153.0
10142,2cf065874bcc4144,701e057d63c124d9,8a304bfd6bf04a57,2012-06-08,0,0,0,900,11,1,132,16,131,1,0,0,1,0,55,41,76,16,4.1,715.0
10143,2cf065874bcc4144,8a304bfd6bf04a57,701e057d63c124d9,2012-06-08,1,0,0,900,8,2,153,23,153,0,0,0,0,0,83,67,70,23,0.0,772.9
10144,2ccecfdd7683043e,55f80a8aeffcdb33,edad57b3dddf2168,2012-06-08,0,1,1,201,1,1,9,2,8,1,0,0,1,1,5,4,3,1,51.7,46.0
10145,2ccecfdd7683043e,edad57b3dddf2168,55f80a8aeffcdb33,2012-06-08,0,0,0,201,0,0,17,6,17,0,0,0,0,0,1,1,16,6,0.0,149.3
10146,2771872dd02e5d19,5431dccc09118234,fd5b6598a3b70c0a,2012-06-08,0,0,0,900,7,3,64,15,52,12,3,2,9,7,23,18,29,8,203.5,382.9
10147,2771872dd02e5d19,fd5b6598a3b70c0a,5431dccc09118234,2012-06-08,0,0,0,900,5,1,70,19,56,14,2,1,12,5,8,5,48,14,127.1,469.5
10148,1984570de7f0c89e,4b47e71384a9522f,9b198c73e3d0d289,2012-06-08,2,0,0,66,0,0,42,25,27,15,0,0,15,9,1,1,26,16,10.2,47.0
10149,1984570de7f0c89e,9b198c73e3d0d289,4b47e71384a9522f,2012-06-08,0,0,0,66,4,0,8,3,8,0,0,0,0,0,2,2,6,3,0.0,55.8
10150,13a6496a09ae821e,236a37d96d476164,4f736494fc733095,2012-06-08,0,0,0,900,10,3,51,18,31,20,1,1,19,13,17,13,14,5,388.6,220.0
10151,13a6496a09ae821e,4f736494fc733095,236a37d96d476164,2012-06-08,0,0,0,900,0,0,37,3,37,0,0,0,0,0,16,14,21,3,0.0,511.4
10152,fe1ce9e3a38a734b,150ff4cc642270b9,de12bd65e2f46478,2012-06-01,1,0,0,900,0,0,267,86,260,7,0,0,7,5,43,32,217,81,19.6,844.0
10153,fe1ce9e3a38a734b,de12bd65e2f46478,150ff4cc642270b9,2012-06-01,0,0,0,900,17,0,108,19,108,0,0,0,0,0,13,8,95,19,0.0,820.4
10154,fa8c1f3d27fc349c,b8aef0faf4ce9b31,ff4c3ab594c7fac3,2012-06-01,1,0,0,473,0,0,93,23,82,11,0,0,11,8,11,10,71,15,20.5,445.0
10155,fa8c1f3d27fc349c,ff4c3ab594c7fac3,b8aef0faf4ce9b31,2012-06-01,0,0,0,473,2,0,90,32,90,0,0,0,0,0,10,7,80,32,0.0,447.5
10156,e8bb812cd91d9c28,a36556bb1565e32d,c3bd649a9194e50c,2012-06-01,1,0,0,119,0,0,28,8,26,2,0,0,2,2,2,2,24,6,2.5,114.0
10157,e8bb812cd91d9c28,c3bd649a9194e50c,a36556bb1565e32d,2012-06-01,0,0,0,119,0,0,29,8,29,0,0,0,0,0,7,5,22,8,0.0,116.5
10158,8e4439cdc98d0644,7bd94b60d7521e4a,af62f99eb7606308,2012-06-01,0,2,0,258,3,0,24,3,24,0,0,0,0,0,6,3,18,3,0.0,113.6
10159,8e4439cdc98d0644,af62f99eb7606308,7bd94b60d7521e4a,2012-06-01,0,1,1,258,0,0,26,8,20,6,1,1,5,4,10,9,10,4,92.4,104.0
10160,8422c70a72eb9291,8b69839f3555a67b,d81ac739417d7f53,2012-06-01,1,0,0,400,1,0,31,10,29,2,0,0,2,1,6,3,23,9,5.3,193.9
10161,8422c70a72eb9291,d81ac739417d7f53,8b69839f3555a67b,2012-06-01,1,0,0,400,0,0,50,15,40,10,0,0,10,2,4,4,36,13,177.1,146.7
10162,64e7c4ee81d46900,879f6cae48d25baa,8b260672a21d1fd6,2012-06-01,1,0,0,619,3,1,155,44,147,8,0,0,8,3,17,10,130,41,28.3,566.0
10163,64e7c4ee81d46900,8b260672a21d1fd6,879f6cae48d25baa,2012-06-01,0,0,0,619,4,2,101,20,101,0,0,0,0,0,24,16,77,20,0.0,538.7
10164,2a7cf1a89de3709e,08e908ed6d18d6a0,b35a159f525764eb,2012-06-01,0,1,1,243,0,0,49,5,49,0,0,0,0,0,19,7,30,5,0.0,243.0
10165,2a7cf1a89de3709e,b35a159f525764eb,08e908ed6d18d6a0,2012-06-01,0,0,0,243,1,1,27,1,27,0,0,0,0,0,13,5,14,1,0.0,207.0
10166,1c245dc63a0b9d51,59279a7c978f7da0,c58f51dedb310998,2012-06-01,0,0,0,167,0,0,16,6,16,0,0,0,0,0,3,2,13,6,0.0,167.0
10167,1c245dc63a0b9d51,c58f51dedb310998,59279a7c978f7da0,2012-06-01,0,1,1,167,3,1,15,5,15,0,0,0,0,0,4,4,11,5,0.0,102.0
10168,0b5c7c95b0316276,07225ba28ae309b6,b0a6124751a56bc4,2012-06-01,0,1,1,462,2,1,76,21,72,4,1,0,3,2,23,21,49,19,18.2,403.0
10169,0b5c7c95b0316276,b0a6124751a56bc4,07225ba28ae309b6,2012-06-01,0,1,0,462,2,1,74,22,74,0,0,0,0,0,11,5,63,22,0.0,376.8
10170,06a28491fe26baa6,1d1b85389a05df69,5f99b2bafb10305f,2012-06-01,0,2,0,900,4,1,40,11,35,5,1,1,4,3,5,4,30,8,252.5,101.0
10171,06a28491fe26baa6,5f99b2bafb10305f,1d1b85389a05df69,2012-06-01,0,0,0,900,5,4,30,11,21,9,2,2,7,7,7,4,14,4,496.0,151.5
10172,de8e1dd07ad49c94,5d7bdab5e03e3216,b2f88c04c4dd43ce,2012-05-26,0,1,0,900,7,4,53,25,31,22,1,1,21,13,3,3,28,12,607.0,152.5
10173,de8e1dd07ad49c94,b2f88c04c4dd43ce,5d7bdab5e03e3216,2012-05-26,0,2,0,900,0,0,34,11,33,1,0,0,1,1,3,3,30,10,2.5,288.0
10174,d5457867cbd0caf7,361d49960a196976,e0b74df14f52cd15,2012-05-26,0,0,0,900,3,1,80,22,73,7,0,0,7,5,7,6,66,17,119.6,544.8
10175,d5457867cbd0caf7,e0b74df14f52cd15,361d49960a196976,2012-05-26,0,0,0,900,5,2,67,23,55,12,1,1,11,5,15,14,40,18,167.2,376.4
10176,cd2a60453f8ac133,85980f5da429c0a6,d28dee5c705991df,2012-05-26,0,0,0,494,0,0,49,10,49,0,0,0,0,0,27,22,22,10,0.0,316.0
10177,cd2a60453f8ac133,d28dee5c705991df,85980f5da429c0a6,2012-05-26,1,0,0,494,2,2,84,26,72,12,1,1,11,10,7,5,65,16,178.0,316.0
10178,b187bdcc2ceba00f,92a9aa9c93192871,c2e3e67b5911bfb7,2012-05-26,0,1,0,900,6,1,88,27,58,30,7,7,23,15,4,2,54,12,379.4,268.4
10179,b187bdcc2ceba00f,c2e3e67b5911bfb7,92a9aa9c93192871,2012-05-26,0,0,0,900,0,0,47,20,24,23,1,1,22,12,2,2,22,8,239.6,270.6
10180,a8dc7400f270a144,e6c5908910cc26e4,ebc1f40e00e0c481,2012-05-26,0,0,0,65,0,0,7,2,7,0,0,0,0,0,2,2,5,2,0.0,12.0
10181,a8dc7400f270a144,ebc1f40e00e0c481,e6c5908910cc26e4,2012-05-26,0,1,1,65,0,0,0,0,0,0,0,0,0,0,0,0,0,0,0.0,65.0
10182,a6a1adfeab7f7bb7,7ff97850e8c32bda,b959e8c7fd8390d2,2012-05-26,0,1,1,113,0,0,30,14,21,9,0,0,9,4,2,1,19,10,60.3,46.0
10183,a6a1adfeab7f7bb7,b959e8c7fd8390d2,7ff97850e8c32bda,2012-05-26,0,0,0,113,1,0,19,1,19,0,0,0,0,0,6,4,13,1,0.0,52.7
10184,9cdeb62aa9092713,64a50dad704d1d49,a54fc2d6fc224dc3,2012-05-26,0,0,0,203,0,0,17,1,17,0,0,0,0,0,11,10,6,1,0.0,132.0
10185,9cdeb62aa9092713,a54fc2d6fc224dc3,64a50dad704d1d49,2012-05-26,1,0,0,203,2,2,35,17,18,17,0,0,17,9,3,3,15,8,71.0,132.0
10186,8238c5f16d0b39c3,473ce3aa581251a2,84ac950d4c1722dd,2012-05-26,1,0,0,231,2,0,29,15,24,5,0,0,5,4,4,3,20,11,44.0,143.0
10187,8238c5f16d0b39c3,84ac950d4c1722dd,473ce3aa581251a2,2012-05-26,0,0,0,231,0,0,38,8,38,0,0,0,0,0,12,9,26,8,0.0,187.0
10188,41e6ace08a2679e1,1ff9589f9065a9ed,63def5a5662a6917,2012-05-26,0,0,0,484,4,0,37,5,37,0,0,0,0,0,14,12,23,5,0.0,457.0
10189,41e6ace08a2679e1,63def5a5662a6917,1ff9589f9065a9ed,2012-05-26,1,0,0,484,0,0,89,44,84,5,0,0,5,3,19,15,65,41,18.0,466.0
10190,3fc1ebe73920a2a7,6f81b6de2557739a,7b143a54451263d9,2012-05-26,0,0,0,114,0,0,5,1,5,0,0,0,0,0,2,1,3,1,0.0,23.0
10191,3fc1ebe73920a2a7,7b143a54451263d9,6f81b6de2557739a,2012-05-26,0,2,1,114,0,0,4,1,4,0,0,0,0,0,0,0,4,1,0.0,113.0
10192,1a699da1b1b5ef85,0ff11cc094e887bc,8349d55cdecd393a,2012-05-26,1,0,0,216,1,1,50,28,0,50,0,0,50,28,0,0,0,0,209.0,7.0
10193,1a699da1b1b5ef85,8349d55cdecd393a,0ff11cc094e887bc,2012-05-26,0,0,0,216,0,0,2,0,1,1,0,0,1,0,1,1,0,0,0.0,7.0
10194,00cf159d5e637238,3f7c14c7eca7195d,cbd6f1abf955e628,2012-05-26,1,0,0,51,0,0,4,1,4,0,0,0,0,0,1,1,3,1,0.0,49.0
10195,00cf159d5e637238,cbd6f1abf955e628,3f7c14c7eca7195d,2012-05-26,0,0,0,51,0,0,8,0,8,0,0,0,0,0,5,3,3,0,0.0,51.0
10196,fc95c49b69a8d476,528c24b99fbaab79,a8ea84cbe1655f0a,2012-05-15,0,0,0,900,0,0,154,25,154,0,0,0,0,0,32,26,122,25,0.0,900.0
10197,fc95c49b69a8d476,a8ea84cbe1655f0a,528c24b99fbaab79,2012-05-15,0,0,0,900,2,0,152,21,152,0,0,0,0,0,19,10,133,21,0.0,900.0
10198,e0e41464c1bc7ee1,97a8f39186f489db,b4eeac608fc82f88,2012-05-15,0,0,0,900,3,0,52,2,52,0,0,0,0,0,24,16,28,2,0.0,597.7
10199,e0e41464c1bc7ee1,b4eeac608fc82f88,97a8f39186f489db,2012-05-15,1,0,0,900,0,0,93,30,63,30,3,3,27,16,28,17,35,14,291.3,599.0
10200,df5ab14481442365,182f2b78582de3d8,7be63795363029e8,2012-05-15,0,1,0,185,2,2,14,6,10,4,0,0,4,3,3,1,7,3,104.0,55.0
10201,df5ab14481442365,7be63795363029e8,182f2b78582de3d8,2012-05-15,0,2,1,185,0,0,7,1,7,0,0,0,0,0,0,0,7,1,0.0,79.0
10202,b4407dd3627c1675,7ea4a9f07df33a45,d18dbcb0f8e2b55d,2012-05-15,1,0,0,900,0,0,173,48,170,3,0,0,3,1,29,20,141,47,0.2,888.0
10203,b4407dd3627c1675,d18dbcb0f8e2b55d,7ea4a9f07df33a45,2012-05-15,0,0,0,900,10,3,178,16,176,2,1,1,1,1,39,24,137,15,11.0,844.8
10204,ade59be2e9bc1108,6a2f7c151031653d,ece280745f8727b8,2012-05-15,1,1,1,100,0,0,10,4,6,4,0,0,4,3,1,1,5,1,35.0,65.0
10205,ade59be2e9bc1108,ece280745f8727b8,6a2f7c151031653d,2012-05-15,0,0,0,100,1,0,12,1,12,0,0,0,0,0,1,1,11,1,0.0,65.0
10206,a8ec9c513d28c25c,029eaff01e6bb8f0,c451d67c09c55418,2012-05-15,0,0,0,967,4,0,127,44,127,0,0,0,0,0,16,12,111,44,0.0,529.4
10207,a8ec9c513d28c25c,c451d67c09c55418,029eaff01e6bb8f0,2012-05-15,0,3,1,967,4,4,154,59,141,13,1,1,12,8,17,14,124,51,206.6,665.0
10208,57bbe424b0d6837c,2be6596a9db33bf5,4d44f37107f01b9b,2012-05-15,0,0,0,50,1,0,8,1,8,0,0,0,0,0,0,0,8,1,0.0,47.0
10209,57bbe424b0d6837c,4d44f37107f01b9b,2be6596a9db33bf5,2012-05-15,1,0,0,50,0,0,11,5,10,1,0,0,1,1,0,0,10,4,1.0,49.0
10210,49818fb1520ce956,18968f97ad34f15c,1d00756835ca67c9,2012-05-15,0,0,0,900,3,0,115,24,115,0,0,0,0,0,34,22,81,24,0.0,899.0
10211,49818fb1520ce956,1d00756835ca67c9,18968f97ad34f15c,2012-05-15,0,0,0,900,3,1,192,35,192,0,0,0,0,0,57,52,135,35,0.0,869.0
10212,4655930eb83446c7,4f853e98886283cf,a26198ba5093147e,2012-05-15,0,1,0,900,3,0,61,14,60,1,0,0,1,0,20,13,40,14,8.8,740.8
10213,4655930eb83446c7,a26198ba5093147e,4f853e98886283cf,2012-05-15,0,1,0,900,7,3,113,30,101,12,4,3,8,7,40,35,61,23,124.2,477.2
10214,3b1461ff02a3f98e,0c6d9ea8306c029e,aed06011bf62237b,2012-05-15,0,0,0,900,3,2,159,13,159,0,0,0,0,0,45,26,114,13,0.0,753.5
10215,3b1461ff02a3f98e,aed06011bf62237b,0c6d9ea8306c029e,2012-05-15,0,0,0,900,3,1,83,17,82,1,0,0,1,1,25,15,57,16,8.5,866.0
10216,303db84673492cd6,1fb80f46d3c105d9,53278852bcd91e11,2012-05-15,0,0,0,900,1,0,137,72,137,0,0,0,0,0,28,26,109,72,0.0,679.0
10217,303db84673492cd6,53278852bcd91e11,1fb80f46d3c105d9,2012-05-15,0,0,0,900,4,1,80,30,77,3,0,0,3,2,7,6,70,28,55.0,533.0
10218,0b4ac9bcf5dbb382,2650e2f846a30f64,ee624ee2a18f2a43,2012-05-15,0,1,0,900,3,1,83,14,83,0,0,0,0,0,32,22,51,14,0.0,704.0
10219,0b4ac9bcf5dbb382,ee624ee2a18f2a43,2650e2f846a30f64,2012-05-15,0,0,0,900,14,4,61,19,60,1,0,0,1,1,16,13,44,18,84.0,396.0
10220,e257f0f5224ef6ab,99506df1af6c8b3b,c96d9178c9ed9e62,2012-05-05,0,0,0,900,4,2,233,54,232,1,0,0,1,0,33,26,199,54,1.7,888.0
10221,e257f0f5224ef6ab,c96d9178c9ed9e62,99506df1af6c8b3b,2012-05-05,0,0,0,900,5,0,225,64,225,0,0,0,0,0,33,15,192,64,0.0,896.3
10222,db51d17ea03da745,8355922d564b152c,d1941565abf50b16,2012-05-05,0,2,1,549,1,0,98,29,97,1,0,0,1,1,24,17,73,28,5.2,392.0
10223,db51d17ea03da745,d1941565abf50b16,8355922d564b152c,2012-05-05,0,0,0,549,5,1,71,11,71,0,0,0,0,0,20,14,51,11,0.0,468.8
10224,c7be6a466d1d0a1e,658c3465581ae46b,e6c5908910cc26e4,2012-05-05,0,1,0,278,1,0,22,11,21,1,0,0,1,1,4,4,17,10,18.4,131.0
10225,c7be6a466d1d0a1e,e6c5908910cc26e4,658c3465581ae46b,2012-05-05,1,0,0,278,0,0,71,32,71,0,0,0,0,0,8,7,63,32,0.0,217.6
10226,c039953c2f438832,03c9994c5b8958ec,d1e7fc58d4225cdf,2012-05-05,0,0,0,900,6,1,84,20,84,0,0,0,0,0,10,9,74,20,0.0,810.1
10227,c039953c2f438832,d1e7fc58d4225cdf,03c9994c5b8958ec,2012-05-05,0,0,0,900,3,1,136,29,130,6,0,0,6,3,27,23,103,26,38.9,725.0
10228,a5fa3bf3dc91eb88,0941df56f6ac954b,dd37fd509af89f15,2012-05-05,0,0,0,900,6,2,120,32,120,0,0,0,0,0,26,23,94,32,0.0,675.4
10229,a5fa3bf3dc91eb88,dd37fd509af89f15,0941df56f6ac954b,2012-05-05,0,0,0,900,2,1,89,23,79,10,1,1,9,8,12,9,67,15,73.6,694.0
10230,a28c80463d7d0c03,5b2d7906aa894274,d23ccf4a6c221284,2012-05-05,0,0,0,367,3,1,27,9,27,0,0,0,0,0,4,2,23,9,0.0,175.0
10231,a28c80463d7d0c03,d23ccf4a6c221284,5b2d7906aa894274,2012-05-05,0,2,1,367,4,2,39,13,32,7,0,0,7,6,7,3,25,7,35.0,302.0
10232,920665daa1261dbc,28f3c2258a1d8874,a01e84abefd85ec0,2012-05-05,1,0,0,900,7,2,154,55,130,24,1,1,23,13,16,12,114,42,211.1,548.5
10233,920665daa1261dbc,a01e84abefd85ec0,28f3c2258a1d8874,2012-05-05,0,0,0,900,3,1,95,20,92,3,1,1,2,2,17,12,75,18,52.5,583.9
10234,704a089fde021153,4130a743d9d22163,8ddf9c51c5fdea75,2012-05-05,1,1,0,258,0,0,37,19,3,34,1,1,33,19,0,0,3,0,134.0,124.0
10235,704a089fde021153,8ddf9c51c5fdea75,4130a743d9d22163,2012-05-05,0,1,0,258,1,1,1,0,1,0,0,0,0,0,0,0,1,0,0.0,117.0
10236,539e0008bb634f1b,b72a60a0cadff408,c268b2cfebccf652,2012-05-05,0,1,1,594,2,2,132,52,112,20,2,1,18,11,17,12,95,41,179.2,364.8
10237,539e0008bb634f1b,c268b2cfebccf652,b72a60a0cadff408,2012-05-05,0,0,0,594,0,0,212,65,209,3,0,0,3,3,47,31,162,62,5.2,400.8
10238,1f290005cc147afb,22a92d7f62195791,511e82663651438d,2012-05-05,0,0,0,900,1,0,176,23,176,0,0,0,0,0,33,22,143,23,0.0,900.0
10239,1f290005cc147afb,511e82663651438d,22a92d7f62195791,2012-05-05,1,0,0,900,2,0,183,28,183,0,0,0,0,0,65,39,118,28,0.0,899.0
10240,151f9966cae7682c,173acb3f920082b8,e4aaaa34535e32b6,2012-05-05,0,2,1,299,5,1,42,14,41,1,0,0,1,1,13,12,28,13,3.8,245.1
10241,151f9966cae7682c,e4aaaa34535e32b6,173acb3f920082b8,2012-05-05,0,0,0,299,1,1,43,15,40,3,1,1,2,2,8,8,32,13,19.9,169.2
10242,0387bc11a0a0c325,6f242453c91a5af0,8e5bfd4e82352340,2012-05-05,0,1,0,900,9,8,85,33,30,55,5,4,50,28,11,8,19,5,681.0,112.8
10243,0387bc11a0a0c325,8e5bfd4e82352340,6f242453c91a5af0,2012-05-05,0,0,0,900,2,0,59,17,31,28,3,3,25,11,10,7,21,6,7.2,210.0
10244,eb5cd79e00dd5cd2,0a97691039c4bbfb,cc84b68f862b466f,2012-04-21,0,0,0,900,0,0,210,96,210,0,0,0,0,0,22,14,188,96,0.0,812.0
10245,eb5cd79e00dd5cd2,cc84b68f862b466f,0a97691039c4bbfb,2012-04-21,2,0,0,900,0,0,284,69,259,25,0,0,25,11,31,15,228,58,88.0,812.0
10246,eaf8782e4e03139b,4a1329cc8eb0928a,81801f57bd0a7c41,2012-04-21,0,0,0,900,3,0,78,9,77,1,0,0,1,0,19,9,58,9,0.2,898.8
10247,eaf8782e4e03139b,81801f57bd0a7c41,4a1329cc8eb0928a,2012-04-21,0,0,0,900,0,0,136,15,135,1,0,0,1,0,28,9,107,15,0.2,898.8
10248,c1c8b38d315d487b,7a15f3694c5cbc02,cf9d24e4bd0cf2ce,2012-04-21,0,0,0,900,0,0,87,25,87,0,0,0,0,0,13,8,74,25,0.0,469.5
10249,c1c8b38d315d487b,cf9d24e4bd0cf2ce,7a15f3694c5cbc02,2012-04-21,0,0,0,900,11,5,107,50,64,43,0,0,43,38,27,24,37,12,418.5,316.0
10250,bf5a5b23a49fa17c,31123249b0bbf52e,4a28cb716c19157a,2012-04-21,0,1,0,900,13,5,77,20,56,21,8,8,13,8,10,8,46,12,424.4,394.4
10251,bf5a5b23a49fa17c,4a28cb716c19157a,31123249b0bbf52e,2012-04-21,0,0,0,900,0,0,133,53,130,3,0,0,3,3,18,14,112,50,20.6,427.6
10252,ad101f8850eff427,83fd97284f4bb4a4,86f582852a5b240a,2012-04-21,0,1,0,900,2,0,133,24,133,0,0,0,0,0,39,32,94,24,0.0,840.0
10253,ad101f8850eff427,86f582852a5b240a,83fd97284f4bb4a4,2012-04-21,0,0,0,900,5,1,119,24,119,0,0,0,0,0,44,43,75,24,0.0,566.0
10254,a6c02fb0b18e916c,3236bf606fe9fa5b,fdf18227faa596dd,2012-04-21,0,1,1,149,2,1,8,2,7,1,0,0,1,0,3,2,4,2,31.3,55.0
10255,a6c02fb0b18e916c,fdf18227faa596dd,3236bf606fe9fa5b,2012-04-21,0,0,0,149,0,0,3,0,3,0,0,0,0,0,0,0,3,0,0.0,117.7
10256,9dc5b5f29d9ff028,07f72a2a7591b409,ee779c43a8926d52,2012-04-21,0,0,0,1500,2,1,214,68,212,2,0,0,2,1,60,37,152,67,4.4,1438.1
10257,9dc5b5f29d9ff028,ee779c43a8926d52,07f72a2a7591b409,2012-04-21,0,0,0,1500,4,0,151,16,148,3,0,0,3,0,47,29,101,16,1.9,1486.6
10258,4966e9d7479c8d8d,6cadfd8f1d9e7685,cbd5d3cdd862e90e,2012-04-21,0,0,0,440,0,0,22,2,22,0,0,0,0,0,5,4,17,2,0.0,73.0
10259,4966e9d7479c8d8d,cbd5d3cdd862e90e,6cadfd8f1d9e7685,2012-04-21,1,0,0,440,2,2,69,45,9,60,1,1,59,43,2,1,7,2,351.0,89.0
10260,41d170c5da83c8be,89a407032911e27e,bd58d34e39b7b12a,2012-04-21,0,0,0,70,0,0,17,9,17,0,0,0,0,0,0,0,17,9,0.0,60.8
10261,41d170c5da83c8be,bd58d34e39b7b12a,89a407032911e27e,2012-04-21,1,0,0,70,0,0,17,6,14,3,0,0,3,1,2,2,12,5,1.2,68.0
10262,33a93002fef6c89d,33b2f68ef95252e0,d0314416a7f26527,2012-04-21,0,0,0,198,0,0,29,6,29,0,0,0,0,0,3,2,26,6,0.0,196.0
10263,33a93002fef6c89d,d0314416a7f26527,33b2f68ef95252e0,2012-04-21,1,0,0,198,0,0,59,13,56,3,0,0,3,2,4,3,52,11,2.0,196.0
10264,2bb3a036759d79f2,6bf5a7d3e081ade2,c21a036b4e012f1c,2012-04-21,0,0,0,900,0,0,152,29,152,0,0,0,0,0,68,44,84,29,0.0,900.0
10265,2bb3a036759d79f2,c21a036b4e012f1c,6bf5a7d3e081ade2,2012-04-21,0,0,0,900,0,0,116,14,116,0,0,0,0,0,50,25,66,14,0.0,900.0
10266,06eb7492a27bb19a,cd12227edd3f134b,e5ecaf884b6da2bc,2012-04-21,0,1,0,900,6,3,46,26,35,11,1,1,10,9,2,1,33,17,350.0,499.1
10267,06eb7492a27bb19a,e5ecaf884b6da2bc,cd12227edd3f134b,2012-04-21,2,0,0,900,2,0,123,38,110,13,3,3,10,8,35,27,75,30,50.9,456.0
10268,a90cabf2913fc6ef,0e21976afc92e4d1,3591d0d5d382a381,2012-04-14,0,1,0,402,0,0,14,10,7,7,0,0,7,7,3,1,4,3,133.0,51.0
10269,a90cabf2913fc6ef,3591d0d5d382a381,0e21976afc92e4d1,2012-04-14,0,1,1,402,2,2,30,27,3,27,0,0,27,26,1,1,2,1,218.0,51.0
10270,a7e1e349980063c9,afc2a7ce0c763bd5,e25bcbcdaf6537a1,2012-04-14,0,0,0,388,2,0,64,17,62,2,0,0,2,2,23,19,39,15,4.0,372.0
10271,a7e1e349980063c9,e25bcbcdaf6537a1,afc2a7ce0c763bd5,2012-04-14,0,1,1,388,7,3,1,0,1,0,0,0,0,0,1,1,0,0,0.0,249.0
10272,a2308473bcd77da8,19a8cce18a1cef9e,c9f6385af6df66d7,2012-04-14,0,1,1,273,0,0,43,16,40,3,0,0,3,2,7,5,33,14,8.6,172.5
10273,a2308473bcd77da8,c9f6385af6df66d7,19a8cce18a1cef9e,2012-04-14,0,0,0,273,3,1,18,7,15,3,0,0,3,3,5,4,10,4,57.5,149.4
10274,990bf4ef60890853,579fcdfcabd23a7b,7f955f71fa2ce7ac,2012-04-14,1,0,0,146,0,0,33,14,24,9,0,0,9,6,4,4,20,8,40.2,70.0
10275,990bf4ef60890853,7f955f71fa2ce7ac,579fcdfcabd23a7b,2012-04-14,0,0,0,146,0,0,14,5,14,0,0,0,0,0,2,2,12,5,0.0,105.8
10276,93096cfccdbf4fe8,2924886ee9c4c527,3c6976f8182d9527,2012-04-14,0,0,0,900,0,0,108,21,106,2,0,0,2,0,28,17,78,21,0.0,889.4
10277,93096cfccdbf4fe8,3c6976f8182d9527,2924886ee9c4c527,2012-04-14,1,0,0,900,1,1,283,50,280,3,0,0,3,1,34,26,246,49,10.6,861.0
10278,8aa637fc26a01581,0bcfe2513cb3bc39,43563a32c3f10e95,2012-04-14,0,1,0,900,4,2,6,1,6,0,0,0,0,0,1,0,5,1,0.0,135.0
10279,8aa637fc26a01581,43563a32c3f10e95,0bcfe2513cb3bc39,2012-04-14,0,0,0,900,2,2,50,31,13,37,13,13,24,23,4,4,9,8,326.0,574.0
10280,8757fbfa0857415f,30a09e43f15f1d75,aec185309b4843d0,2012-04-14,0,0,0,42,0,0,2,0,2,0,0,0,0,0,0,0,2,0,0.0,42.0
10281,8757fbfa0857415f,aec185309b4843d0,30a09e43f15f1d75,2012-04-14,1,0,0,42,0,0,4,3,4,0,0,0,0,0,0,0,4,3,0.0,40.0
10282,806761834799c352,c945adc22c2bfe8f,c96e2ae6021144a1,2012-04-14,1,1,1,545,5,4,67,34,27,40,1,1,39,23,2,1,25,11,313.5,187.0
10283,806761834799c352,c96e2ae6021144a1,c945adc22c2bfe8f,2012-04-14,0,1,0,545,4,1,57,18,53,4,0,0,4,3,13,5,40,15,21.0,168.5
10284,589fd70f6f8b747c,98ec9f385cca47fc,fea8acf9bfcf09ec,2012-04-14,0,0,0,456,0,0,54,22,51,3,0,0,3,2,8,6,43,20,1.8,372.7
10285,589fd70f6f8b747c,fea8acf9bfcf09ec,98ec9f385cca47fc,2012-04-14,0,3,1,456,4,1,67,19,57,10,1,1,9,6,17,17,40,13,74.3,246.2
10286,3368c2419e259992,1a7745388839e52b,322a56923b396b4d,2012-04-14,0,1,1,580,3,3,7,4,2,5,1,1,4,4,1,1,1,0,366.0,117.1
10287,3368c2419e259992,322a56923b396b4d,1a7745388839e52b,2012-04-14,0,1,0,580,0,0,25,8,13,12,0,0,12,8,7,7,6,0,96.9,109.0
10288,2dc181c1473eb269,3a24769a4855040a,5f87a5c00b3d17ed,2012-04-14,0,0,0,900,0,0,125,11,125,0,0,0,0,0,67,38,58,11,0.0,900.0
10289,2dc181c1473eb269,5f87a5c00b3d17ed,3a24769a4855040a,2012-04-14,0,0,0,900,6,0,203,31,203,0,0,0,0,0,60,37,143,31,0.0,867.0
10290,0890d21317c9aa2d,53f84637dfffab7a,f59e9e49ef85b469,2012-04-14,0,0,0,900,1,0,69,15,69,0,0,0,0,0,22,21,47,15,0.0,507.8
10291,0890d21317c9aa2d,f59e9e49ef85b469,53f84637dfffab7a,2012-04-14,0,0,0,900,6,4,86,19,62,24,12,10,12,8,18,15,44,11,383.2,389.0
10292,b42d4c3c701945bf,31ee470ef5dc8d7f,8b69839f3555a67b,2012-03-02,0,0,0,852,3,2,118,42,114,4,0,0,4,1,27,20,87,41,120.8,701.0
10293,b42d4c3c701945bf,8b69839f3555a67b,31ee470ef5dc8d7f,2012-03-02,0,1,1,852,7,1,118,34,118,0,0,0,0,0,14,13,104,34,0.0,582.2
10294,b218d6a420abb67b,4b4753d19489297f,879b8df81523d91b,2012-03-02,1,0,0,299,4,2,45,24,12,33,0,0,33,21,1,1,11,3,135.7,144.3
10295,b218d6a420abb67b,879b8df81523d91b,4b4753d19489297f,2012-03-02,0,0,0,299,0,0,22,4,20,2,0,0,2,1,1,1,19,3,6.7,153.3
10296,a00b98f41c05ae6c,7339d340aa2889cb,8a70ceb3edbe757b,2012-03-02,0,1,0,900,7,3,63,20,57,6,0,0,6,6,23,16,34,14,179.1,509.5
10297,a00b98f41c05ae6c,8a70ceb3edbe757b,7339d340aa2889cb,2012-03-02,0,0,0,900,2,1,79,30,69,10,0,0,10,9,11,6,58,21,181.5,484.9
10298,6ba485fc7b8f38ee,ca2efc9d7d523c43,dcdd511ff757f15c,2012-03-02,1,0,0,533,0,0,113,57,108,5,0,0,5,2,8,7,100,55,36.8,452.0
10299,6ba485fc7b8f38ee,dcdd511ff757f15c,ca2efc9d7d523c43,2012-03-02,0,1,0,533,1,0,62,15,62,0,0,0,0,0,14,14,48,15,0.0,491.2
10300,60f53ad3f114da6e,361d49960a196976,51b1e2fd9872005b,2012-03-02,1,2,1,125,0,0,21,11,20,1,0,0,1,1,3,3,17,10,3.8,106.0
10301,60f53ad3f114da6e,51b1e2fd9872005b,361d49960a196976,2012-03-02,0,0,0,125,0,0,12,4,12,0,0,0,0,0,5,5,7,4,0.0,101.2
10302,5c55530a258a9e41,701e057d63c124d9,8a304bfd6bf04a57,2012-03-02,0,0,0,900,9,4,144,31,126,18,1,1,17,12,44,29,82,19,113.0,674.0
10303,5c55530a258a9e41,8a304bfd6bf04a57,701e057d63c124d9,2012-03-02,0,0,0,900,4,0,145,44,145,0,0,0,0,0,37,31,108,44,0.0,742.0
10304,54b7b3378e394070,282fa667ff9c51ed,d188a3b817860ec6,2012-03-02,0,0,0,900,5,1,152,44,149,3,0,0,3,2,35,28,114,42,22.2,737.0
10305,54b7b3378e394070,d188a3b817860ec6,282fa667ff9c51ed,2012-03-02,0,1,0,900,6,1,221,50,221,0,0,0,0,0,32,31,189,50,0.0,799.8
10306,3a2bd4fe6f08bc17,8f2939f5fd9cca1e,e57fdbea1b828202,2012-03-02,0,1,1,55,1,1,3,2,3,0,0,0,0,0,1,1,2,2,0.0,49.0
10307,3a2bd4fe6f08bc17,e57fdbea1b828202,8f2939f5fd9cca1e,2012-03-02,0,0,0,55,0,0,5,1,5,0,0,0,0,0,1,1,4,1,0.0,52.0
10308,33f0817701e49bf1,11f8860028b68fcf,f5431394fb284bb9,2012-03-02,0,0,0,128,0,0,12,0,12,0,0,0,0,0,0,0,12,0,0.0,92.8
10309,33f0817701e49bf1,f5431394fb284bb9,11f8860028b68fcf,2012-03-02,1,0,0,128,0,0,33,20,25,8,0,0,8,7,2,2,23,13,35.2,62.0
10310,058d32372a2271fd,80eacd4da0617c57,c34e5849184b08c3,2012-03-02,1,1,0,311,5,1,50,8,44,6,0,0,6,4,21,10,23,4,128.2,140.0
10311,058d32372a2271fd,c34e5849184b08c3,80eacd4da0617c57,2012-03-02,0,0,0,311,0,0,18,5,18,0,0,0,0,0,5,3,13,5,0.0,182.8
10312,01e5e4099f03f20e,05560764359161e4,523fa774700d7d3f,2012-03-02,0,0,0,900,0,0,155,55,155,0,0,0,0,0,8,5,147,55,0.0,898.0
10313,01e5e4099f03f20e,523fa774700d7d3f,05560764359161e4,2012-03-02,0,0,0,900,8,0,167,31,167,0,0,0,0,0,38,27,129,31,0.0,862.0
10314,fb57dcc651894ae9,7c35f869033901ae,f1f9e48a0d150757,2012-02-25,0,0,0,900,6,3,242,86,230,12,2,1,10,5,50,37,180,81,52.9,684.0
10315,fb57dcc651894ae9,f1f9e48a0d150757,7c35f869033901ae,2012-02-25,0,1,0,900,1,1,148,29,148,0,0,0,0,0,36,18,112,29,0.0,835.1
10316,eac1c31f1b3d11f3,acff437707625fc7,c80095f6092271a7,2012-02-25,0,0,0,654,2,1,75,26,58,17,1,1,16,9,2,2,56,17,241.0,410.9
10317,eac1c31f1b3d11f3,c80095f6092271a7,acff437707625fc7,2012-02-25,1,1,0,654,1,0,93,36,88,5,0,0,5,5,14,6,74,31,2.1,406.0
10318,a196dce12754e34e,4834ff149dc9542a,8bb6f4479685bbcc,2012-02-25,0,0,0,269,2,1,49,19,49,0,0,0,0,0,4,2,45,19,0.0,230.0
10319,a196dce12754e34e,8bb6f4479685bbcc,4834ff149dc9542a,2012-02-25,1,2,1,269,1,0,30,9,30,0,0,0,0,0,6,5,24,9,0.0,265.0
10320,9b4bff38430a01eb,3bad7ef643840f67,cbb682f5fcc44bfc,2012-02-25,0,0,0,81,0,0,8,0,8,0,0,0,0,0,0,0,8,0,0.0,79.0
10321,9b4bff38430a01eb,cbb682f5fcc44bfc,3bad7ef643840f67,2012-02-25,1,0,0,81,0,0,20,8,16,4,0,0,4,3,3,1,13,5,2.0,79.0
10322,84e800acc2aacd8e,57bf89d42364d39e,c23e3d4875340d8d,2012-02-25,2,0,0,332,2,1,24,15,13,11,0,0,11,8,0,0,13,7,251.0,81.0
10323,84e800acc2aacd8e,c23e3d4875340d8d,57bf89d42364d39e,2012-02-25,0,1,0,332,0,0,19,3,19,0,0,0,0,0,3,3,16,3,0.0,80.0
10324,7c307d98ed135d32,c0ab242c40decc55,ffc088e64fab57e9,2012-02-25,0,0,0,900,9,4,101,27,68,33,11,9,22,16,19,19,49,11,378.1,367.8
10325,7c307d98ed135d32,ffc088e64fab57e9,c0ab242c40decc55,2012-02-25,0,0,0,900,4,1,39,8,37,2,0,0,2,1,10,8,27,7,5.2,500.9
10326,6bcf5381dd8de85b,4304992c2acc187b,ef7fa30364cbe7f2,2012-02-25,0,1,0,900,0,0,78,10,78,0,0,0,0,0,33,16,45,10,0.0,407.3
10327,6bcf5381dd8de85b,ef7fa30364cbe7f2,4304992c2acc187b,2012-02-25,0,2,0,900,5,2,111,48,70,41,4,3,37,31,21,16,49,17,477.7,399.0
10328,53d2a57daaae700b,b0550072e5f0afa7,fe435e440b5de0ff,2012-02-25,0,0,0,900,4,2,97,29,97,0,0,0,0,0,5,4,92,29,0.0,822.7
10329,53d2a57daaae700b,fe435e440b5de0ff,b0550072e5f0afa7,2012-02-25,0,0,0,900,14,2,201,49,200,1,0,0,1,1,59,42,141,48,9.3,677.0
10330,43b494c32b7f18cb,2676b28836a5a836,f2688492b9a525a3,2012-02-25,0,3,0,1500,1,1,264,50,251,13,1,1,12,7,51,36,200,43,20.0,1394.1
10331,43b494c32b7f18cb,f2688492b9a525a3,2676b28836a5a836,2012-02-25,0,0,0,1500,12,5,190,33,183,7,0,0,7,5,58,35,125,28,68.9,1352.0
10332,319053a9de63ab85,1eacf73d6a0055dc,eef9b891edbd4604,2012-02-25,0,0,0,131,0,0,12,2,12,0,0,0,0,0,5,3,7,2,0.0,105.0
10333,319053a9de63ab85,eef9b891edbd4604,1eacf73d6a0055dc,2012-02-25,1,0,0,131,0,0,16,8,15,1,0,0,1,1,2,2,13,7,18.0,113.0
10334,3101c8d54df53e27,48e093ea1f43a053,b2e3aca4cd363477,2012-02-25,0,0,0,900,4,2,88,20,63,25,3,2,22,12,11,6,52,8,327.7,415.0
10335,3101c8d54df53e27,b2e3aca4cd363477,48e093ea1f43a053,2012-02-25,0,0,0,900,1,0,77,21,77,0,0,0,0,0,19,16,58,21,0.0,489.3
10336,1b4f87d607b3964d,2b4faacc16d66898,3be081c29bf734d9,2012-02-25,1,1,0,441,4,1,66,31,66,0,0,0,0,0,2,1,64,31,0.0,343.5
10337,1b4f87d607b3964d,3be081c29bf734d9,2b4faacc16d66898,2012-02-25,1,0,0,441,0,0,107,34,99,8,0,0,8,7,20,14,79,27,9.5,415.0
10338,f10d3d4ffd5a4922,bd21a1e3d41c97ee,d5f820c11a121050,2012-02-15,0,0,0,900,6,2,97,28,84,13,3,3,10,9,33,31,51,19,153.6,489.0
10339,f10d3d4ffd5a4922,d5f820c11a121050,bd21a1e3d41c97ee,2012-02-15,1,0,0,900,5,0,84,34,61,23,4,3,19,15,19,18,42,19,92.0,598.4
10340,e93d07a18ca847c8,cbd6f1abf955e628,ebc1f40e00e0c481,2012-02-15,0,0,0,532,0,0,74,16,74,0,0,0,0,0,41,35,33,16,0.0,471.0
10341,e93d07a18ca847c8,ebc1f40e00e0c481,cbd6f1abf955e628,2012-02-15,1,0,0,532,1,1,81,26,69,12,0,0,12,8,22,21,47,18,55.0,477.0
10342,adb35d212e716b8a,706f8e2b34e8e18b,9b198c73e3d0d289,2012-02-15,0,0,0,900,0,0,115,16,114,1,0,0,1,0,30,22,84,16,0.1,761.4
10343,adb35d212e716b8a,9b198c73e3d0d289,706f8e2b34e8e18b,2012-02-15,0,0,0,900,15,4,111,24,98,13,7,5,6,5,26,21,72,19,137.6,645.9
10344,796a7e1fa80af990,6ef65b6a152e49d5,d28dee5c705991df,2012-02-15,0,0,0,43,0,0,18,7,18,0,0,0,0,0,0,0,18,7,0.0,39.0
10345,796a7e1fa80af990,d28dee5c705991df,6ef65b6a152e49d5,2012-02-15,1,0,0,43,0,0,17,8,14,3,0,0,3,3,0,0,14,5,4.0,39.0
10346,74e92a66b29674a9,5755960ebd0b16f6,7bd94b60d7521e4a,2012-02-15,0,2,1,225,1,1,35,21,12,23,2,2,21,19,3,2,9,2,123.6,93.3
10347,74e92a66b29674a9,7bd94b60d7521e4a,5755960ebd0b16f6,2012-02-15,0,3,0,225,0,0,55,17,51,4,0,0,4,1,17,14,34,16,2.7,88.4
10348,638a999dab6fe310,4b47e71384a9522f,7a613f78dd7ee8f8,2012-02-15,0,0,0,900,0,0,170,49,150,20,6,5,14,11,32,29,118,38,26.2,841.0
10349,638a999dab6fe310,7a613f78dd7ee8f8,4b47e71384a9522f,2012-02-15,0,0,0,900,11,0,68,15,68,0,0,0,0,0,15,13,53,15,0.0,864.8
10350,5f7a1ba6e016b249,92aafa8f4b26269b,c849740a3ff51931,2012-02-15,0,1,0,900,0,0,33,10,26,7,0,0,7,4,2,1,24,6,0.0,158.0
10351,5f7a1ba6e016b249,c849740a3ff51931,92aafa8f4b26269b,2012-02-15,0,5,0,900,7,3,114,76,15,99,5,5,94,71,4,4,11,5,742.0,158.0
10352,3e50773520e7a218,82e7929bf6c2b689,d81ac739417d7f53,2012-02-15,0,0,0,900,1,0,114,17,112,2,0,0,2,2,22,12,90,15,27.2,788.3
10353,3e50773520e7a218,d81ac739417d7f53,82e7929bf6c2b689,2012-02-15,1,0,0,900,8,2,124,44,115,9,0,0,9,4,22,18,93,40,43.7,770.8
10354,2341651d1043e2c0,b0a6124751a56bc4,d403b1a6f278c95e,2012-02-15,1,0,0,92,1,1,28,13,19,9,0,0,9,9,7,5,12,4,6.3,85.0
10355,2341651d1043e2c0,d403b1a6f278c95e,b0a6124751a56bc4,2012-02-15,0,0,0,92,0,0,16,4,16,0,0,0,0,0,4,3,12,4,0.0,85.7
10356,d019250cc6d93527,7aa3d6964eff4877,bbfca6d5c27d9cd8,2012-02-04,0,7,0,900,1,1,89,35,87,2,0,0,2,1,26,20,61,34,182.0,426.4
10357,d019250cc6d93527,bbfca6d5c27d9cd8,7aa3d6964eff4877,2012-02-04,1,0,0,900,0,0,81,24,63,18,1,1,17,9,21,16,42,15,109.6,578.0
10358,cee1fb8ac703f34f,236a37d96d476164,dd37fd509af89f15,2012-02-04,0,0,0,900,5,1,119,30,119,0,0,0,0,0,15,11,104,30,0.0,730.8
10359,cee1fb8ac703f34f,dd37fd509af89f15,236a37d96d476164,2012-02-04,0,0,0,900,3,2,95,22,94,1,0,0,1,1,11,11,83,21,11.2,743.0
10360,bd340a13bc3df8a1,31123249b0bbf52e,8c8c92a12621d7e0,2012-02-04,1,0,0,379,3,1,71,24,67,4,0,0,4,4,29,24,38,20,19.1,298.0
10361,bd340a13bc3df8a1,8c8c92a12621d7e0,31123249b0bbf52e,2012-02-04,0,0,0,379,0,0,82,8,82,0,0,0,0,0,14,12,68,8,0.0,289.9
10362,7e57d7848f9faacf,06f36cf4bd97ec77,5abf827d62f98fee,2012-02-04,0,2,1,403,4,2,57,10,57,0,0,0,0,0,21,18,36,10,0.0,320.0
10363,7e57d7848f9faacf,5abf827d62f98fee,06f36cf4bd97ec77,2012-02-04,0,0,0,403,0,0,36,16,36,0,0,0,0,0,0,0,36,16,0.0,224.0
10364,6fbe7dffff5f5f1e,0b64d0fed453ef7f,2c99576fefe53c7c,2012-02-04,0,0,0,900,7,0,206,52,206,0,0,0,0,0,27,21,179,52,0.0,889.0
10365,6fbe7dffff5f5f1e,2c99576fefe53c7c,0b64d0fed453ef7f,2012-02-04,0,0,0,900,0,0,299,68,299,0,0,0,0,0,49,36,250,68,0.0,785.0
10366,6ecc59654c2f519f,76729a829623e266,d023ae89a2a4a41e,2012-02-04,0,0,0,900,1,0,169,50,169,0,0,0,0,0,20,17,149,50,0.0,781.5
10367,6ecc59654c2f519f,d023ae89a2a4a41e,76729a829623e266,2012-02-04,0,0,0,900,3,2,158,30,147,11,1,1,10,9,56,43,91,21,118.5,760.0
10368,6bde0b88f21304d4,3f7c14c7eca7195d,492b202d2064e7a9,2012-02-04,0,1,0,900,0,0,69,18,68,1,0,0,1,1,9,8,59,17,16.4,736.0
10369,6bde0b88f21304d4,492b202d2064e7a9,3f7c14c7eca7195d,2012-02-04,0,0,0,900,1,0,136,47,136,0,0,0,0,0,48,44,88,47,0.0,819.6
10370,5510b86a35c5614b,0dba4df5f34d5ff0,b7f38813485745da,2012-02-04,0,2,0,900,16,6,72,25,70,2,0,0,2,1,16,11,54,24,36.6,367.3
10371,5510b86a35c5614b,b7f38813485745da,0dba4df5f34d5ff0,2012-02-04,1,0,0,900,0,0,62,24,38,24,1,1,23,17,9,5,29,7,148.7,640.4
10372,40c080d0f86f1f1f,4a28cb716c19157a,cc3147b49c7d7d92,2012-02-04,1,0,0,253,0,0,38,9,36,2,0,0,2,2,15,13,21,7,1.0,252.0
10373,40c080d0f86f1f1f,cc3147b49c7d7d92,4a28cb716c19157a,2012-02-04,0,0,0,253,0,0,22,0,22,0,0,0,0,0,17,8,5,0,0.0,252.0
10374,09a2909e1848be52,f57a8a52ca401ed9,f9f07bb5a43535ed,2012-02-04,0,0,0,1500,3,1,246,57,245,1,1,1,0,0,68,47,177,57,26.0,1396.0
10375,09a2909e1848be52,f9f07bb5a43535ed,f57a8a52ca401ed9,2012-02-04,0,0,0,1500,0,0,320,52,320,0,0,0,0,0,128,99,192,52,0.0,1470.0
10376,099a2db0470d456b,029eaff01e6bb8f0,150ff4cc642270b9,2012-02-04,0,3,1,203,3,1,25,6,23,2,0,0,2,2,6,5,17,4,44.5,114.0
10377,099a2db0470d456b,150ff4cc642270b9,029eaff01e6bb8f0,2012-02-04,0,0,0,203,0,0,32,8,32,0,0,0,0,0,6,3,26,8,0.0,151.5
10378,fd230ba169b3f2b6,46baf0f57edfa4df,e6c5908910cc26e4,2012-01-28,0,0,0,264,3,0,71,11,71,0,0,0,0,0,14,11,57,11,0.0,260.0
10379,fd230ba169b3f2b6,e6c5908910cc26e4,46baf0f57edfa4df,2012-01-28,1,0,0,264,0,0,92,49,92,0,0,0,0,0,17,16,75,49,0.0,199.0
10380,e8a167bb84082832,511e82663651438d,75e0d3cc2262b732,2012-01-28,0,0,0,900,1,1,136,44,130,6,0,0,6,3,23,20,107,41,61.2,441.9
10381,e8a167bb84082832,75e0d3cc2262b732,511e82663651438d,2012-01-28,0,0,0,900,12,1,92,49,63,29,0,0,29,25,13,7,50,24,193.1,605.8
10382,e7861d4e2b29193f,6fb1ba67bef41b37,e5c9de15bb58b1c6,2012-01-28,0,0,0,600,8,2,76,28,76,0,0,0,0,0,15,11,61,28,0.0,436.7
10383,e7861d4e2b29193f,e5c9de15bb58b1c6,6fb1ba67bef41b37,2012-01-28,1,1,0,600,2,2,97,65,86,11,0,0,11,9,3,3,83,56,103.3,309.0
10384,e0df5f84686586a1,902ab9197b83d0db,ee779c43a8926d52,2012-01-28,0,0,0,1500,9,2,197,21,197,0,0,0,0,0,52,30,145,21,0.0,1206.3
10385,e0df5f84686586a1,ee779c43a8926d52,902ab9197b83d0db,2012-01-28,0,0,0,1500,4,3,162,56,144,18,3,2,15,12,8,4,136,44,166.7,1074.0
10386,ca263e46051261e2,3c0437fbeda06962,d247691a6c0e9034,2012-01-28,0,0,0,442,1,0,99,15,98,1,0,0,1,1,36,20,62,14,0.6,385.2
10387,ca263e46051261e2,d247691a6c0e9034,3c0437fbeda06962,2012-01-28,1,0,0,442,2,2,66,24,53,13,3,3,10,7,18,16,35,17,49.8,372.4
10388,c63a050af0692daf,0577808d22dfe79c,353de740bb6c7e75,2012-01-28,0,0,0,900,0,0,43,18,37,6,0,0,6,2,13,13,24,16,0.9,307.9
10389,c63a050af0692daf,353de740bb6c7e75,0577808d22dfe79c,2012-01-28,0,0,0,900,10,6,37,16,27,10,3,3,7,6,3,2,24,10,589.1,251.1
10390,ba75be28158d424c,3a8176e15b9887c1,427b5953ac8e3a27,2012-01-28,0,0,0,900,6,4,166,43,164,2,0,0,2,2,21,15,143,41,11.5,802.0
10391,ba75be28158d424c,427b5953ac8e3a27,3a8176e15b9887c1,2012-01-28,0,0,0,900,7,0,169,35,169,0,0,0,0,0,24,16,145,35,0.0,888.5
10392,81c5c897717a1ef6,2b93ebd9f5417ad2,48d1f690b763934c,2012-01-28,0,0,0,900,3,1,86,17,83,3,0,0,3,2,18,13,65,15,34.4,428.0
10393,81c5c897717a1ef6,48d1f690b763934c,2b93ebd9f5417ad2,2012-01-28,0,0,0,900,7,4,97,24,77,20,2,1,18,10,19,15,58,14,220.0,414.6
10394,7a4e5bcd7336d203,07225ba28ae309b6,53f84637dfffab7a,2012-01-28,0,2,1,103,1,1,12,2,5,7,1,1,6,2,5,3,0,0,35.0,68.0
10395,7a4e5bcd7336d203,53f84637dfffab7a,07225ba28ae309b6,2012-01-28,0,0,0,103,0,0,4,0,4,0,0,0,0,0,3,2,1,0,0.0,62.0
10396,7a37fd92b26d15c8,6c2030e0a143a94b,e4277e87a789d687,2012-01-28,0,2,1,668,1,0,128,24,127,1,0,0,1,0,25,20,102,24,1.0,662.0
10397,7a37fd92b26d15c8,e4277e87a789d687,6c2030e0a143a94b,2012-01-28,0,0,0,668,0,0,126,16,126,0,0,0,0,0,26,14,100,16,0.0,667.0
10398,fc91f1e448f35797,658c3465581ae46b,80779d7441af1b52,2012-01-20,1,0,0,218,0,0,13,10,9,4,0,0,4,4,3,2,6,6,25.0,112.0
10399,fc91f1e448f35797,80779d7441af1b52,658c3465581ae46b,2012-01-20,0,1,0,218,3,2,19,3,17,2,0,0,2,1,1,0,16,2,81.0,112.0
10400,f4bdf10856c1760e,361d49960a196976,de12bd65e2f46478,2012-01-20,0,1,1,97,1,1,24,16,12,12,0,0,12,11,3,3,9,5,45.0,52.0
10401,f4bdf10856c1760e,de12bd65e2f46478,361d49960a196976,2012-01-20,0,0,0,97,0,0,7,3,7,0,0,0,0,0,1,1,6,3,0.0,52.0
10402,d391ca8154bcf507,84ac950d4c1722dd,d1a1314976c50bef,2012-01-20,0,0,0,184,0,0,46,11,46,0,0,0,0,0,13,13,33,11,0.0,174.0
10403,d391ca8154bcf507,d1a1314976c50bef,84ac950d4c1722dd,2012-01-20,0,1,1,184,3,1,20,3,20,0,0,0,0,0,3,2,17,3,0.0,115.0
10404,be7b9301e7c689c1,22edaf53ad59a967,98f6da59d765ec94,2012-01-20,0,3,0,900,1,0,11,2,11,0,0,0,0,0,1,1,10,2,0.0,130.5
10405,be7b9301e7c689c1,98f6da59d765ec94,22edaf53ad59a967,2012-01-20,0,0,0,900,5,2,26,8,6,20,14,14,6,5,2,2,4,3,750.5,112.0
10406,90d50fb7e2bf789e,ccd1299e0345e0ce,d1941565abf50b16,2012-01-20,0,0,0,184,0,0,26,12,20,6,0,0,6,5,5,4,15,7,0.5,183.0
10407,90d50fb7e2bf789e,d1941565abf50b16,ccd1299e0345e0ce,2012-01-20,0,1,1,184,3,1,12,2,12,0,0,0,0,0,5,2,7,2,0.0,124.5
10408,8360accf6f70ebc4,032cc3922d871c7f,ece280745f8727b8,2012-01-20,1,1,1,728,9,3,77,32,51,26,0,0,26,17,5,3,46,15,310.3,370.0
10409,8360accf6f70ebc4,ece280745f8727b8,032cc3922d871c7f,2012-01-20,0,0,0,728,2,0,44,9,44,0,0,0,0,0,7,4,37,9,0.0,412.7
10410,77c1e127c1be9983,bc7230f231701d66,edad57b3dddf2168,2012-01-20,0,0,0,900,3,1,152,37,152,0,0,0,0,0,57,48,95,37,0.0,766.0
10411,77c1e127c1be9983,edad57b3dddf2168,bc7230f231701d66,2012-01-20,0,0,0,900,3,0,167,43,167,0,0,0,0,0,36,25,131,43,0.0,717.0
10412,37e0251af7b18742,0871254cd790c250,7abe471b61725980,2012-01-20,0,0,0,243,3,2,21,5,21,0,0,0,0,0,3,2,18,5,0.0,107.2
10413,37e0251af7b18742,7abe471b61725980,0871254cd790c250,2012-01-20,0,1,1,243,4,1,13,5,8,5,0,0,5,4,1,1,7,1,55.8,176.0
10414,26cdaf7cf575f656,696002b59f09d73b,e4aaaa34535e32b6,2012-01-20,0,0,0,22,0,0,4,3,4,0,0,0,0,0,0,0,4,3,0.0,22.0
10415,26cdaf7cf575f656,e4aaaa34535e32b6,696002b59f09d73b,2012-01-20,1,0,0,22,0,0,23,11,23,0,0,0,0,0,0,0,23,11,0.0,21.0
10416,0071c5d16e6e07f6,cb46dface0e28a2c,f59f1d3a2ff13edd,2012-01-20,1,0,0,391,0,0,17,6,8,9,0,0,9,6,0,0,8,0,58.0,55.0
10417,0071c5d16e6e07f6,f59f1d3a2ff13edd,cb46dface0e28a2c,2012-01-20,0,0,0,391,5,2,9,3,4,5,3,3,2,2,0,0,4,1,278.0,55.0
10418,f126491f024c1563,e9e1acc96536bb4f,f5990c11974d8e9c,2012-01-14,0,0,0,82,0,0,8,1,8,0,0,0,0,0,2,1,6,1,0.0,79.8
10419,f126491f024c1563,f5990c11974d8e9c,e9e1acc96536bb4f,2012-01-14,1,0,0,82,0,0,24,6,18,6,0,0,6,3,5,5,13,3,2.2,79.0
10420,c715c165cb3469d2,5b2d7906aa894274,8ddf9c51c5fdea75,2012-01-14,0,0,0,63,0,0,6,0,6,0,0,0,0,0,1,0,5,0,0.0,61.0
10421,c715c165cb3469d2,8ddf9c51c5fdea75,5b2d7906aa894274,2012-01-14,0,1,1,63,1,0,8,0,8,0,0,0,0,0,5,4,3,0,0.0,62.0
10422,b2a91be41c3233cd,4f853e98886283cf,5866fc86183a9fb8,2012-01-14,0,0,0,29,2,0,0,0,0,0,0,0,0,0,0,0,0,0,0.0,25.0
10423,b2a91be41c3233cd,5866fc86183a9fb8,4f853e98886283cf,2012-01-14,0,0,0,29,0,0,10,7,2,8,0,0,8,7,1,1,1,0,4.0,25.0
10424,9afcb091777f6a83,b5b684eac99ae0a3,d0f3959b4a9747e6,2012-01-14,0,0,0,299,7,0,23,1,23,0,0,0,0,0,14,12,9,1,0.0,242.8
10425,9afcb091777f6a83,d0f3959b4a9747e6,b5b684eac99ae0a3,2012-01-14,1,0,0,299,0,0,23,6,20,3,0,0,3,3,9,5,11,3,1.2,297.0
10426,977e37adadd1b8ad,501b07aec9b8fc2d,8a59d346dc976a10,2012-01-14,0,0,0,900,0,0,172,18,172,0,0,0,0,0,35,27,137,18,0.0,879.0
10427,977e37adadd1b8ad,8a59d346dc976a10,501b07aec9b8fc2d,2012-01-14,0,0,0,900,11,2,128,22,128,0,0,0,0,0,36,28,92,22,0.0,756.0
10428,7bb603674999e675,71002dbc1743b9a7,fef3d17e27e916e7,2012-01-14,0,0,0,900,0,0,122,36,115,7,0,0,7,4,22,17,93,32,97.4,658.7
10429,7bb603674999e675,fef3d17e27e916e7,71002dbc1743b9a7,2012-01-14,0,0,0,900,3,0,153,21,146,7,1,1,6,2,21,15,125,19,74.3,664.6
10430,50bdcb20286690ff,0ee783aa00e468f0,365fee2da473b177,2012-01-14,0,1,1,289,0,0,29,14,16,13,0,0,13,11,1,0,15,3,49.3,111.4
10431,50bdcb20286690ff,365fee2da473b177,0ee783aa00e468f0,2012-01-14,0,0,0,289,8,2,16,3,12,4,0,0,4,1,2,1,10,2,105.6,107.7
10432,11e7f12ecb2d1597,33011768c3c4dc9a,64a50dad704d1d49,2012-01-14,0,0,0,722,6,2,105,15,105,0,0,0,0,0,14,11,91,15,0.0,706.0
10433,11e7f12ecb2d1597,64a50dad704d1d49,33011768c3c4dc9a,2012-01-14,1,0,0,722,0,0,129,14,129,0,0,0,0,0,68,33,61,14,0.0,721.0
10434,0be68308b5d63a47,2f95a3c6d58b2aad,9f842be1a5337be6,2012-01-14,0,2,0,900,0,0,137,46,123,14,2,2,12,12,14,12,109,34,226.6,641.0
10435,0be68308b5d63a47,9f842be1a5337be6,2f95a3c6d58b2aad,2012-01-14,0,0,0,900,4,1,48,20,48,0,0,0,0,0,6,4,42,20,0.0,502.4
10436,0695d1f42b1550a2,270b89c00ef0c55c,acd9513399a8b09b,2012-01-14,0,1,1,202,2,2,7,0,6,1,1,1,0,0,1,1,5,0,81.0,121.0
10437,0695d1f42b1550a2,acd9513399a8b09b,270b89c00ef0c55c,2012-01-14,0,0,0,202,0,0,14,0,14,0,0,0,0,0,2,0,12,0,0.0,121.0
10438,eeef3df8adb8acc7,80dbeb1dd5b53e64,893d51aaf024eddd,2011-12-30,0,0,0,900,0,0,42,11,39,3,0,0,3,1,8,5,31,10,21.0,241.89999999999998
10439,eeef3df8adb8acc7,893d51aaf024eddd,80dbeb1dd5b53e64,2011-12-30,0,2,0,900,20,11,115,69,37,78,2,2,76,58,11,10,26,11,623.1,168.0
10440,d940ffe543c4e38b,1d00756835ca67c9,8355922d564b152c,2011-12-30,0,0,0,900,0,0,182,56,182,0,0,0,0,0,46,40,136,56,0.0,896.0
10441,d940ffe543c4e38b,8355922d564b152c,1d00756835ca67c9,2011-12-30,0,0,0,900,2,0,362,199,362,0,0,0,0,0,47,39,315,199,0.0,836.0
10442,b9508f47504ccc59,0941df56f6ac954b,6f018c039b4d5d80,2011-12-30,1,0,0,12,0,0,2,2,1,1,0,0,1,1,0,0,1,1,2.0,10.0
10443,b9508f47504ccc59,6f018c039b4d5d80,0941df56f6ac954b,2011-12-30,0,0,0,12,0,0,1,0,1,0,0,0,0,0,0,0,1,0,0.0,10.0
10444,972034fcd94ca83b,0d506315895efffc,9bcf8603ceb25680,2011-12-30,0,0,0,900,2,0,121,18,119,2,0,0,2,2,20,14,99,16,28.7,694.2
10445,972034fcd94ca83b,9bcf8603ceb25680,0d506315895efffc,2011-12-30,1,0,0,900,4,2,124,28,121,3,0,0,3,1,35,25,86,27,76.8,743.3
10446,68137e9ff22d426b,6bf5a7d3e081ade2,d1e7fc58d4225cdf,2011-12-30,0,1,0,900,2,0,98,22,98,0,0,0,0,0,28,22,70,22,0.0,829.1
10447,68137e9ff22d426b,d1e7fc58d4225cdf,6bf5a7d3e081ade2,2011-12-30,0,0,0,900,18,6,71,11,68,3,1,0,2,1,25,22,43,10,51.9,416.0
10448,607722017a9d7e22,3c6976f8182d9527,ccdd90bd1fc7dab6,2011-12-30,1,0,0,133,0,0,21,7,15,6,0,0,6,4,4,3,11,3,4.0,129.0
10449,607722017a9d7e22,ccdd90bd1fc7dab6,3c6976f8182d9527,2011-12-30,0,0,0,133,0,0,8,4,8,0,0,0,0,0,1,1,7,4,0.0,129.0
10450,5c3325b7da3f7828,513c6f1715e547a8,b4ad3a06ee4d660c,2011-12-30,0,0,0,146,1,0,18,3,18,0,0,0,0,0,4,3,14,3,0.0,138.8
10451,5c3325b7da3f7828,b4ad3a06ee4d660c,513c6f1715e547a8,2011-12-30,1,0,0,146,0,0,24,11,15,9,0,0,9,4,8,8,7,7,7.2,130.0
10452,46bea6d63ffe17e4,6f81b6de2557739a,83fd97284f4bb4a4,2011-12-30,0,2,0,900,9,3,35,13,18,17,3,3,14,10,6,1,12,3,643.2,206.5
10453,46bea6d63ffe17e4,83fd97284f4bb4a4,6f81b6de2557739a,2011-12-30,0,4,0,900,0,0,18,5,17,1,0,0,1,1,4,2,13,4,12.5,181.79999999999995
10454,434411f139e51760,4f732e58ed907eff,d0d7160824278840,2011-12-30,0,0,0,900,1,1,89,28,89,0,0,0,0,0,34,24,55,28,0.0,720.4
10455,434411f139e51760,d0d7160824278840,4f732e58ed907eff,2011-12-30,0,0,0,900,18,3,69,32,66,3,0,0,3,1,17,11,49,31,63.6,561.0
10456,2f715933d0626544,3a24769a4855040a,cc6f9d1e89f3449a,2011-12-30,0,0,0,900,0,0,91,9,91,0,0,0,0,0,47,33,44,9,0.0,809.8
10457,2f715933d0626544,cc6f9d1e89f3449a,3a24769a4855040a,2011-12-30,0,0,0,900,17,2,56,12,53,3,0,0,3,3,10,7,43,9,35.2,689.0
10458,fef109b9f26585b3,92aafa8f4b26269b,b4eeac608fc82f88,2011-12-10,0,2,0,900,1,0,163,21,160,3,1,1,2,2,50,25,110,19,38.0,824.0
10459,fef109b9f26585b3,b4eeac608fc82f88,92aafa8f4b26269b,2011-12-10,0,0,0,900,6,2,90,9,90,0,0,0,0,0,43,24,47,9,0.0,761.0
10460,fd0c847858bd346f,8a8a84b743ae7699,c21a036b4e012f1c,2011-12-10,0,1,1,178,3,1,32,20,0,32,0,0,32,20,0,0,0,0,166.0,12.0
10461,fd0c847858bd346f,c21a036b4e012f1c,8a8a84b743ae7699,2011-12-10,0,0,0,178,0,0,0,0,0,0,0,0,0,0,0,0,0,0,0.0,12.0
10462,e094423979fc7c6a,03c9994c5b8958ec,c76ec2bc3a57666a,2011-12-10,1,0,0,576,6,1,80,42,58,22,0,0,22,17,17,13,41,25,152.2,403.0
10463,e094423979fc7c6a,c76ec2bc3a57666a,03c9994c5b8958ec,2011-12-10,0,0,0,576,3,0,131,10,131,0,0,0,0,0,11,7,120,10,0.0,407.8
10464,e03ec6b24fca2386,53278852bcd91e11,59583ff832fe9d68,2011-12-10,1,0,0,35,0,0,31,20,22,9,0,0,9,9,1,1,21,11,2.8,30.0
10465,e03ec6b24fca2386,59583ff832fe9d68,53278852bcd91e11,2011-12-10,0,0,0,35,0,0,8,3,8,0,0,0,0,0,1,1,7,3,0.0,32.2
10466,dbe53d31f4c1ccf7,32ba186f4b0e3267,56116a79e4deed06,2011-12-10,0,0,0,900,12,2,39,14,35,4,1,1,3,3,14,8,21,11,119.8,361.0
10467,dbe53d31f4c1ccf7,56116a79e4deed06,32ba186f4b0e3267,2011-12-10,0,3,0,900,3,0,47,13,47,0,0,0,0,0,20,15,27,13,0.0,695.2
10468,d6d812269487071e,210935fd21670f6d,e57fdbea1b828202,2011-12-10,0,0,0,370,2,1,27,13,7,20,3,3,17,10,2,1,5,3,232.4,113.8
10469,d6d812269487071e,e57fdbea1b828202,210935fd21670f6d,2011-12-10,1,0,0,370,1,0,47,27,18,29,0,0,29,26,9,6,9,1,12.2,124.6
10470,92d0c39f0df77c7e,1ff9589f9065a9ed,ee9d73f4fee9cbdd,2011-12-10,0,1,1,218,2,1,8,1,8,0,0,0,0,0,5,5,3,1,0.0,123.0
10471,92d0c39f0df77c7e,ee9d73f4fee9cbdd,1ff9589f9065a9ed,2011-12-10,0,1,0,218,1,0,27,16,24,3,0,0,3,3,5,5,19,13,22.0,108.0
10472,8abe79e6d300b639,0a97691039c4bbfb,c451d67c09c55418,2011-12-10,0,0,0,7,0,0,1,0,1,0,0,0,0,0,0,0,1,0,0.0,4.0
10473,8abe79e6d300b639,c451d67c09c55418,0a97691039c4bbfb,2011-12-10,1,0,0,7,0,0,10,6,2,8,0,0,8,5,0,0,2,1,3.0,4.0
10474,834968d130e1f0e9,07f72a2a7591b409,f7a7f7118d4b01b6,2011-12-10,1,1,1,566,2,1,53,6,49,4,0,0,4,3,32,18,17,3,26.8,479.0
10475,834968d130e1f0e9,f7a7f7118d4b01b6,07f72a2a7591b409,2011-12-10,0,0,0,566,1,0,38,7,38,0,0,0,0,0,9,6,29,7,0.0,539.2
10476,76d18b94f580be6e,05560764359161e4,23459ee7e373b98f,2011-12-10,3,1,0,191,1,1,32,20,27,5,0,0,5,4,1,1,26,16,28.8,145.0
10477,76d18b94f580be6e,23459ee7e373b98f,05560764359161e4,2011-12-10,0,0,0,191,1,0,25,0,25,0,0,0,0,0,13,9,12,0,0.0,157.2
10478,70995170c27c4143,6fb1ba67bef41b37,cf9d24e4bd0cf2ce,2011-12-10,0,3,0,900,0,0,31,9,30,1,0,0,1,1,4,1,26,8,9.0,235.79999999999995
10479,70995170c27c4143,cf9d24e4bd0cf2ce,6fb1ba67bef41b37,2011-12-10,0,0,0,900,7,5,85,23,32,53,9,7,44,20,17,16,15,3,619.2,190.0
10480,69d6d58d58cb81e3,2f732dd9210d301f,73e09f837f3b5ecc,2011-12-10,0,0,0,195,1,0,17,7,17,0,0,0,0,0,3,2,14,7,0.0,69.9
10481,69d6d58d58cb81e3,73e09f837f3b5ecc,2f732dd9210d301f,2011-12-10,1,0,0,195,0,0,90,26,36,54,28,25,26,12,3,3,33,14,69.1,99.0
10482,f182b13c6e07dfb1,2b93ebd9f5417ad2,b2f88c04c4dd43ce,2011-12-03,1,0,0,814,0,0,192,86,154,38,7,6,31,20,11,10,143,66,132.7,590.1
10483,f182b13c6e07dfb1,b2f88c04c4dd43ce,2b93ebd9f5417ad2,2011-12-03,0,0,0,814,11,1,119,17,116,3,1,1,2,2,12,9,104,15,31.9,532.3
10484,c302f24082239f82,173acb3f920082b8,b0f316c60f8d3b47,2011-12-03,1,2,1,622,5,2,53,16,45,8,0,0,8,7,21,20,24,9,44.0,320.4
10485,c302f24082239f82,b0f316c60f8d3b47,173acb3f920082b8,2011-12-03,0,0,0,622,1,0,58,25,53,5,1,1,4,4,9,8,44,21,213.6,279.0
10486,b28aad0fdc0b8cc0,5ef0088c1b19beeb,e503aa5c252a1b4d,2011-12-03,0,1,1,518,3,3,53,13,52,1,0,0,1,1,12,10,40,12,185.0,291.8
10487,b28aad0fdc0b8cc0,e503aa5c252a1b4d,5ef0088c1b19beeb,2011-12-03,0,1,0,518,1,0,55,10,52,3,3,3,0,0,5,5,47,10,41.2,278.0
10488,9a3908ab337c5f3f,99506df1af6c8b3b,c849740a3ff51931,2011-12-03,1,0,0,114,0,0,24,6,22,2,0,0,2,2,3,1,19,4,3.0,111.0
10489,9a3908ab337c5f3f,c849740a3ff51931,99506df1af6c8b3b,2011-12-03,0,0,0,114,0,0,21,0,21,0,0,0,0,0,8,2,13,0,0.0,111.0
10490,9821faf6a5d6fd0d,1cecc8fe6748a532,81801f57bd0a7c41,2011-12-03,0,0,0,900,6,0,140,39,139,1,0,0,1,1,39,34,100,38,1.7,876.0
10491,9821faf6a5d6fd0d,81801f57bd0a7c41,1cecc8fe6748a532,2011-12-03,0,0,0,900,1,1,197,61,197,0,0,0,0,0,38,27,159,61,0.0,856.3
10492,72481ce1897251cd,55f80a8aeffcdb33,7bd94b60d7521e4a,2011-12-03,0,0,0,69,0,0,10,1,10,0,0,0,0,0,3,2,7,1,0.0,22.0
10493,72481ce1897251cd,7bd94b60d7521e4a,55f80a8aeffcdb33,2011-12-03,1,0,0,69,0,0,34,19,17,17,0,0,17,14,5,2,12,5,47.0,22.0
10494,6e85d8d17c3eed58,6f242453c91a5af0,c2e3e67b5911bfb7,2011-12-03,1,0,0,291,1,1,78,22,51,27,0,0,27,10,3,3,48,12,47.1,221.3
10495,6e85d8d17c3eed58,c2e3e67b5911bfb7,6f242453c91a5af0,2011-12-03,1,1,1,291,1,1,39,10,37,2,0,0,2,2,12,9,25,8,8.7,217.9
10496,381b2df85ac06615,22a92d7f62195791,5f04e3d58d9ce982,2011-12-03,0,1,0,900,1,1,232,38,232,0,0,0,0,0,33,23,199,38,0.0,890.0
10497,381b2df85ac06615,5f04e3d58d9ce982,22a92d7f62195791,2011-12-03,0,0,0,900,3,0,150,28,150,0,0,0,0,0,36,17,114,28,0.0,897.0
10498,25783a9abbfee4fc,b72a60a0cadff408,ffc3e6daaa6da0b7,2011-12-03,0,0,0,718,2,0,29,3,29,0,0,0,0,0,6,3,23,3,0.0,278.7
10499,25783a9abbfee4fc,ffc3e6daaa6da0b7,b72a60a0cadff408,2011-12-03,1,0,0,718,6,4,140,50,57,83,25,19,58,34,13,13,44,16,439.3,157.0
10500,21ebc940f3dfde82,48e96d9cea6d4ab0,d188a3b817860ec6,2011-12-03,0,0,0,900,6,4,62,18,55,7,1,1,6,5,25,24,30,13,112.2,435.0
10501,21ebc940f3dfde82,d188a3b817860ec6,48e96d9cea6d4ab0,2011-12-03,0,2,0,900,1,0,133,36,133,0,0,0,0,0,41,36,92,36,0.0,764.8
10502,f754d17d5047d536,3a8176e15b9887c1,4d44f37107f01b9b,2011-11-19,0,1,1,127,1,1,6,2,6,0,0,0,0,0,2,1,4,2,0.0,40.0
10503,f754d17d5047d536,4d44f37107f01b9b,3a8176e15b9887c1,2011-11-19,0,0,0,127,0,0,7,2,7,0,0,0,0,0,0,0,7,2,0.0,127.0
10504,a117805ab030b194,6a2f7c151031653d,75e5fec9f72910ef,2011-11-19,0,0,0,900,8,0,96,13,96,0,0,0,0,0,19,12,77,13,0.0,758.4
10505,a117805ab030b194,75e5fec9f72910ef,6a2f7c151031653d,2011-11-19,0,0,0,900,4,2,128,45,127,1,0,0,1,0,11,11,116,45,20.6,797.0
10506,89820fae001dd151,5b5307450405abf0,8b69839f3555a67b,2011-11-19,0,0,0,900,3,1,170,39,170,0,0,0,0,0,33,22,137,39,0.0,804.0
10507,89820fae001dd151,8b69839f3555a67b,5b5307450405abf0,2011-11-19,0,1,0,900,9,3,147,34,143,4,3,3,1,1,5,1,138,33,59.0,605.0
10508,73fd4982ef7aae44,78114b7199cef90c,b26d3e3746fb4024,2011-11-19,1,1,1,387,1,1,61,31,37,24,2,2,22,16,5,3,32,15,133.4,248.0
10509,73fd4982ef7aae44,b26d3e3746fb4024,78114b7199cef90c,2011-11-19,0,0,0,387,0,0,68,7,68,0,0,0,0,0,7,6,61,7,0.0,253.6
10510,52f77a9f9eb66ab7,d0314416a7f26527,d18dbcb0f8e2b55d,2011-11-19,2,0,0,56,0,0,24,11,17,7,0,0,7,6,2,1,15,5,6.1,49.0
10511,52f77a9f9eb66ab7,d18dbcb0f8e2b55d,d0314416a7f26527,2011-11-19,0,0,0,56,0,0,8,3,8,0,0,0,0,0,4,3,4,3,0.0,49.9
10512,50ffbc85d3c50604,b959e8c7fd8390d2,c6a33ff198aaaeeb,2011-11-19,0,0,0,900,0,0,53,15,53,0,0,0,0,0,20,16,33,15,0.0,524.5
10513,50ffbc85d3c50604,c6a33ff198aaaeeb,b959e8c7fd8390d2,2011-11-19,0,1,0,900,6,4,74,18,55,19,4,2,15,7,19,16,36,11,317.5,265.0
10514,421842986f10851e,31123249b0bbf52e,fd5b6598a3b70c0a,2011-11-19,0,0,0,342,1,1,34,4,34,0,0,0,0,0,19,15,15,4,0.0,264.3
10515,421842986f10851e,fd5b6598a3b70c0a,31123249b0bbf52e,2011-11-19,0,1,1,342,5,1,49,14,47,2,0,0,2,2,8,3,39,12,21.7,179.0
10516,39e7bb2a0842b8a1,d1e7fc58d4225cdf,e2b8186b618b00c4,2011-11-19,1,0,0,292,3,3,34,17,2,32,3,3,29,17,2,2,0,0,276.0,16.0
10517,39e7bb2a0842b8a1,e2b8186b618b00c4,d1e7fc58d4225cdf,2011-11-19,0,0,0,292,0,0,4,3,2,2,0,0,2,2,0,0,2,1,0.0,16.0
10518,30c574f33700010a,a1f6999fe57236e0,d4f364dd076bb0e2,2011-11-19,1,0,0,589,0,0,104,31,103,1,0,0,1,0,16,12,87,31,0.6,576.0
10519,30c574f33700010a,d4f364dd076bb0e2,a1f6999fe57236e0,2011-11-19,0,0,0,589,1,0,81,13,81,0,0,0,0,0,27,19,54,13,0.0,588.4
10520,2f5ced39b8208e46,497ba5b12a4bfc47,c0ab242c40decc55,2011-11-19,0,0,0,77,0,0,13,1,13,0,0,0,0,0,1,0,12,1,0.0,77.0
10521,2f5ced39b8208e46,c0ab242c40decc55,497ba5b12a4bfc47,2011-11-19,1,0,0,77,0,0,14,6,14,0,0,0,0,0,1,0,13,6,0.0,76.0
10522,206db35805bb83dc,140745cbbcb023ac,1ccf4e7caff270df,2011-11-19,0,1,0,1500,10,5,194,80,137,57,2,2,55,32,20,14,117,48,342.0,860.0
10523,206db35805bb83dc,1ccf4e7caff270df,140745cbbcb023ac,2011-11-19,1,1,0,1500,4,1,141,55,119,22,3,3,19,14,19,19,100,41,94.0,893.0
10524,10f54096561f587d,33b2f68ef95252e0,8cb76103cd8a1562,2011-11-19,0,0,0,900,1,0,122,23,122,0,0,0,0,0,45,41,77,23,0.0,675.2
10525,10f54096561f587d,8cb76103cd8a1562,33b2f68ef95252e0,2011-11-19,0,0,0,900,3,1,69,7,67,2,0,0,2,1,29,24,38,6,21.8,715.0
10526,f0666193c544be4a,4834ff149dc9542a,6546af7ab545b90c,2011-11-12,0,0,0,900,4,1,28,7,25,3,1,1,2,1,8,7,17,6,125.0,406.4
10527,f0666193c544be4a,6546af7ab545b90c,4834ff149dc9542a,2011-11-12,0,1,0,900,3,2,18,7,11,7,2,2,5,5,7,6,4,2,243.6,427.0
10528,db690563ae7fa070,029eaff01e6bb8f0,8e5bfd4e82352340,2011-11-12,0,1,1,392,1,1,47,14,30,17,0,0,17,5,6,3,24,9,148.8,217.0
10529,db690563ae7fa070,8e5bfd4e82352340,029eaff01e6bb8f0,2011-11-12,0,1,0,392,2,0,34,1,34,0,0,0,0,0,22,13,12,1,0.0,243.2
10530,bc7743819590b193,322a56923b396b4d,83a477a7dba1ca58,2011-11-12,1,0,0,94,0,0,20,6,19,1,0,0,1,1,0,0,19,5,2.0,92.0
10531,bc7743819590b193,83a477a7dba1ca58,322a56923b396b4d,2011-11-12,0,0,0,94,0,0,21,2,21,0,0,0,0,0,4,4,17,2,0.0,92.0
10532,9eed1b277c76f576,5df17b3620145578,7aa3d6964eff4877,2011-11-12,0,0,0,900,4,2,58,8,58,0,0,0,0,0,25,16,33,8,0.0,765.5
10533,9eed1b277c76f576,7aa3d6964eff4877,5df17b3620145578,2011-11-12,0,1,0,900,0,0,174,59,170,4,1,1,3,2,47,42,123,57,18.5,849.0
10534,8208afe1e52b02e9,51b1e2fd9872005b,960d6cae8879ba2b,2011-11-12,0,0,0,714,5,1,92,12,85,7,4,3,3,3,39,35,46,9,94.8,428.0
10535,8208afe1e52b02e9,960d6cae8879ba2b,51b1e2fd9872005b,2011-11-12,2,0,0,714,0,0,99,23,84,15,1,1,14,12,21,15,63,11,15.0,595.2
10536,78294f5d5e0f2b13,0ff11cc094e887bc,63def5a5662a6917,2011-11-12,0,0,0,64,1,0,14,3,14,0,0,0,0,0,5,4,9,3,0.0,56.0
10537,78294f5d5e0f2b13,63def5a5662a6917,0ff11cc094e887bc,2011-11-12,1,0,0,64,0,0,13,6,8,5,0,0,5,4,3,2,5,2,8.0,56.0
10538,5254658d4e4126c9,2676b28836a5a836,c47df9303d318c67,2011-11-12,1,0,0,900,7,2,89,16,75,14,6,5,8,7,27,19,48,9,120.3,453.0
10539,5254658d4e4126c9,c47df9303d318c67,2676b28836a5a836,2011-11-12,0,4,0,900,9,2,40,4,40,0,0,0,0,0,13,7,27,4,0.0,610.7
10540,48c6c45d9628bb79,11f8860028b68fcf,668222c99c5c311d,2011-11-12,0,0,0,900,0,0,99,25,99,0,0,0,0,0,36,34,63,25,0.0,765.6
10541,48c6c45d9628bb79,668222c99c5c311d,11f8860028b68fcf,2011-11-12,0,0,0,900,10,1,39,19,38,1,0,0,1,1,0,0,38,18,82.4,488.0
10542,42a353676554ecf2,236a37d96d476164,c7011de4765d2497,2011-11-12,0,0,0,900,1,0,144,51,141,3,3,3,0,0,25,21,116,51,6.4,864.0
10543,42a353676554ecf2,c7011de4765d2497,236a37d96d476164,2011-11-12,0,0,0,900,4,0,145,46,145,0,0,0,0,0,21,17,124,46,0.0,830.6
10544,0f22781ab4635414,3974fa35c917af1d,d247691a6c0e9034,2011-11-12,0,1,1,436,4,2,30,2,20,10,4,4,6,2,6,3,14,0,174.0,234.0
10545,0f22781ab4635414,d247691a6c0e9034,3974fa35c917af1d,2011-11-12,0,1,0,436,1,1,43,10,41,2,1,1,1,1,13,6,28,9,28.0,220.0
10546,e623355d7f897b92,1a7745388839e52b,e56daf7725a0b5ab,2011-11-05,0,2,0,900,9,6,38,18,27,11,1,1,10,8,9,8,18,10,291.2,297.6
10547,e623355d7f897b92,e56daf7725a0b5ab,1a7745388839e52b,2011-11-05,1,1,0,900,2,0,64,13,50,14,4,1,10,4,20,14,30,9,46.4,492.8
10548,da876a1ab4b8eb48,43563a32c3f10e95,4b4753d19489297f,2011-11-05,0,0,0,489,0,0,37,9,31,6,1,1,5,3,9,7,22,6,15.0,229.0
10549,da876a1ab4b8eb48,4b4753d19489297f,43563a32c3f10e95,2011-11-05,0,3,1,489,6,2,38,17,13,25,0,0,25,15,0,0,13,2,245.0,229.0
10550,b7799cdf8a6470ea,6ef65b6a152e49d5,a7d687e6ecb30981,2011-11-05,0,0,0,900,5,3,23,13,10,13,0,0,13,8,1,1,9,5,659.0,104.80000000000001
10551,b7799cdf8a6470ea,a7d687e6ecb30981,6ef65b6a152e49d5,2011-11-05,0,2,0,900,0,0,40,15,18,22,8,8,14,13,6,6,12,2,136.2,80.0
10552,92030ef8b5796b0a,33011768c3c4dc9a,6224e8d0a34264eb,2011-11-05,0,1,1,17,0,0,6,3,6,0,0,0,0,0,2,2,4,3,0.0,17.0
10553,92030ef8b5796b0a,6224e8d0a34264eb,33011768c3c4dc9a,2011-11-05,0,0,0,17,0,0,3,0,3,0,0,0,0,0,0,0,3,0,0.0,9.0
10554,77862f580ce9bca8,9f842be1a5337be6,f59e9e49ef85b469,2011-11-05,0,3,0,900,10,4,59,20,41,18,1,1,17,11,5,4,36,9,351.4,403.7
10555,77862f580ce9bca8,f59e9e49ef85b469,9f842be1a5337be6,2011-11-05,0,0,0,900,3,2,115,23,112,3,0,0,3,1,14,9,98,22,8.3,498.6
10556,7360ec204d4e0e10,6cadfd8f1d9e7685,8c8c92a12621d7e0,2011-11-05,2,0,0,40,0,0,16,9,9,7,0,0,7,3,2,2,7,6,5.4,33.0
10557,7360ec204d4e0e10,8c8c92a12621d7e0,6cadfd8f1d9e7685,2011-11-05,0,0,0,40,1,0,10,0,10,0,0,0,0,0,3,1,7,0,0.0,34.6
10558,3fad8fd8b6e4465d,179f1948dc234f1f,d43a048a880efdff,2011-11-05,1,0,0,600,9,5,74,22,20,54,12,11,42,18,6,6,14,4,322.3,190.6
10559,3fad8fd8b6e4465d,d43a048a880efdff,179f1948dc234f1f,2011-11-05,0,2,0,600,2,2,35,8,28,7,0,0,7,2,5,4,23,6,33.4,191.7
10560,3ed2190f1d604432,8bb6f4479685bbcc,b2e3aca4cd363477,2011-11-05,0,2,0,900,9,4,56,10,50,6,0,0,6,3,23,19,27,7,80.9,372.5
10561,3ed2190f1d604432,b2e3aca4cd363477,8bb6f4479685bbcc,2011-11-05,0,1,0,900,3,2,89,35,66,23,1,1,22,13,20,16,46,22,190.5,438.1
10562,3ca05de15ddd658b,2c99576fefe53c7c,c945adc22c2bfe8f,2011-11-05,1,1,1,249,1,0,98,29,84,14,0,0,14,4,16,8,68,25,46.0,203.0
10563,3ca05de15ddd658b,c945adc22c2bfe8f,2c99576fefe53c7c,2011-11-05,0,0,0,249,0,0,56,9,56,0,0,0,0,0,6,1,50,9,0.0,203.0
10564,30d0cab706e43838,31ee470ef5dc8d7f,c9f6385af6df66d7,2011-11-05,1,1,1,212,0,0,45,17,31,14,0,0,14,12,10,8,21,5,28.9,181.0
10565,30d0cab706e43838,c9f6385af6df66d7,31ee470ef5dc8d7f,2011-11-05,0,0,0,212,0,0,38,9,38,0,0,0,0,0,6,5,32,9,0.0,143.1
10566,f19a56ecc6c150e3,3591d0d5d382a381,6c2030e0a143a94b,2011-10-29,1,0,0,900,6,3,74,23,58,16,4,3,12,9,29,25,29,14,110.8,616.0
10567,f19a56ecc6c150e3,6c2030e0a143a94b,3591d0d5d382a381,2011-10-29,0,1,0,900,5,0,47,9,47,0,0,0,0,0,20,13,27,9,0.0,429.2
10568,f141416b02a31f4e,1d00756835ca67c9,5f87a5c00b3d17ed,2011-10-29,2,1,1,142,0,0,23,5,22,1,0,0,1,1,7,4,15,4,1.4,132.0
10569,f141416b02a31f4e,5f87a5c00b3d17ed,1d00756835ca67c9,2011-10-29,0,0,0,142,2,0,21,6,21,0,0,0,0,0,8,6,13,6,0.0,102.6
10570,ce05150d524a1829,1eacf73d6a0055dc,ba280572acfba13f,2011-10-29,0,0,0,900,2,2,126,23,112,14,5,4,9,8,31,17,81,15,210.0,570.0
10571,ce05150d524a1829,ba280572acfba13f,1eacf73d6a0055dc,2011-10-29,0,0,0,900,0,0,55,15,55,0,0,0,0,0,9,6,46,15,0.0,688.0
10572,baf123a5b5fc674c,22aa91e402d0fe1f,a66395395b5f1394,2011-10-29,0,4,0,900,14,8,77,50,38,39,2,2,37,29,7,7,31,21,647.7,136.0
10573,baf123a5b5fc674c,a66395395b5f1394,22aa91e402d0fe1f,2011-10-29,0,0,0,900,0,0,27,4,27,0,0,0,0,0,2,2,25,4,0.0,221.29999999999995
10574,9574c1ed9ad25816,3f7c14c7eca7195d,c32fb8c0f6471a4d,2011-10-29,1,0,0,690,2,2,75,28,54,21,1,1,20,17,5,3,49,11,214.2,435.0
10575,9574c1ed9ad25816,c32fb8c0f6471a4d,3f7c14c7eca7195d,2011-10-29,0,0,0,690,1,0,59,23,59,0,0,0,0,0,8,7,51,23,0.0,449.8
10576,8aefe4de7a490de6,20205040232ed0f3,4304992c2acc187b,2011-10-29,0,0,0,165,0,0,21,1,21,0,0,0,0,0,6,5,15,1,0.0,165.0
10577,8aefe4de7a490de6,4304992c2acc187b,20205040232ed0f3,2011-10-29,1,0,0,165,0,0,66,16,66,0,0,0,0,0,3,1,63,16,0.0,165.0
10578,3ce9fb5e3bdee7b0,a08d909a5be6f410,fa315e6c77eee106,2011-10-29,1,2,0,900,3,1,55,13,46,9,1,1,8,3,10,7,36,10,50.9,565.2
10579,3ce9fb5e3bdee7b0,fa315e6c77eee106,a08d909a5be6f410,2011-10-29,0,0,0,900,2,1,65,8,55,10,4,2,6,4,35,23,20,4,204.8,419.1
10580,332432834ece3bc7,0b64d0fed453ef7f,a8ea84cbe1655f0a,2011-10-29,0,0,0,900,5,5,103,27,92,11,1,1,10,6,17,14,75,21,165.7,416.4
10581,332432834ece3bc7,a8ea84cbe1655f0a,0b64d0fed453ef7f,2011-10-29,0,1,0,900,3,0,126,22,119,7,3,3,4,1,26,16,93,21,16.6,696.3
10582,1a28928b8d7b4c11,5abf827d62f98fee,e4277e87a789d687,2011-10-29,0,0,0,900,3,3,82,23,66,16,1,0,15,7,5,3,61,16,331.3,548.0
10583,1a28928b8d7b4c11,e4277e87a789d687,5abf827d62f98fee,2011-10-29,0,0,0,900,0,0,72,14,72,0,0,0,0,0,5,4,67,14,0.0,568.7
10584,0583a3d402bed6e4,73c7cfa551289285,f57a8a52ca401ed9,2011-10-29,0,0,0,900,4,1,164,76,160,4,0,0,4,2,15,12,145,74,14.5,813.0
10585,0583a3d402bed6e4,f57a8a52ca401ed9,73c7cfa551289285,2011-10-29,0,0,0,900,0,0,350,136,350,0,0,0,0,0,54,42,296,136,0.0,682.5
10586,040f9c9b470f3e6b,3c0437fbeda06962,ef7fa30364cbe7f2,2011-10-29,0,0,0,900,2,2,104,20,98,6,2,1,4,3,24,14,74,17,63.9,469.4
10587,040f9c9b470f3e6b,ef7fa30364cbe7f2,3c0437fbeda06962,2011-10-29,0,0,0,900,7,2,49,13,40,9,2,2,7,5,12,9,28,8,217.6,425.1
10588,b16534d6bb279b2a,d5f820c11a121050,f59f1d3a2ff13edd,2011-10-08,2,0,0,900,0,0,140,41,135,5,0,0,5,2,31,17,104,39,5.2,870.0
10589,b16534d6bb279b2a,f59f1d3a2ff13edd,d5f820c11a121050,2011-10-08,0,0,0,900,0,0,102,13,102,0,0,0,0,0,2,1,100,13,0.0,894.8
10590,a730a20ab0c61499,92a9aa9c93192871,c23e3d4875340d8d,2011-10-08,0,3,0,900,6,1,49,24,13,36,4,3,32,22,0,0,13,2,789.0,66.0
10591,a730a20ab0c61499,c23e3d4875340d8d,92a9aa9c93192871,2011-10-08,0,3,0,900,0,0,18,2,17,1,0,0,1,0,0,0,17,2,45.0,66.0
10592,a369d5ca5aef8b25,3bad7ef643840f67,ccd1299e0345e0ce,2011-10-08,0,1,1,47,0,0,6,2,6,0,0,0,0,0,0,0,6,2,0.0,28.0
10593,a369d5ca5aef8b25,ccd1299e0345e0ce,3bad7ef643840f67,2011-10-08,0,0,0,47,0,0,6,2,6,0,0,0,0,0,1,1,5,2,0.0,47.0
10594,9274af24eb96e4b1,46baf0f57edfa4df,d28dee5c705991df,2011-10-08,0,0,0,900,2,1,152,36,140,12,0,0,12,7,22,16,118,29,25.8,645.9
10595,9274af24eb96e4b1,d28dee5c705991df,46baf0f57edfa4df,2011-10-08,0,0,0,900,7,4,142,38,123,19,3,3,16,9,30,27,93,29,198.1,509.2
10596,8a660069ae42edc2,7d96bc577e5178b2,f2688492b9a525a3,2011-10-08,1,0,0,1134,2,0,170,36,167,3,0,0,3,2,12,6,155,34,2.8,1110.5
10597,8a660069ae42edc2,f2688492b9a525a3,7d96bc577e5178b2,2011-10-08,1,0,0,1134,11,0,176,39,172,4,0,0,4,3,39,22,133,36,7.5,1116.2
10598,80538f958af30aa0,80dbeb1dd5b53e64,917e53fa0adea0d3,2011-10-08,0,0,0,900,1,1,339,131,337,2,0,0,2,1,50,43,287,130,93.0,807.0
10599,80538f958af30aa0,917e53fa0adea0d3,80dbeb1dd5b53e64,2011-10-08,1,0,0,900,2,0,374,56,374,0,0,0,0,0,53,44,321,56,0.0,781.0
10600,63ee688385bf7c69,48d1f690b763934c,579fcdfcabd23a7b,2011-10-08,0,1,1,531,6,4,38,14,10,28,13,10,15,12,4,4,6,2,377.6,59.0
10601,63ee688385bf7c69,579fcdfcabd23a7b,48d1f690b763934c,2011-10-08,0,0,0,531,0,0,8,0,8,0,0,0,0,0,2,2,6,0,0.0,135.39999999999998
10602,5f4284409503d874,427b5953ac8e3a27,f8dc544e7077d014,2011-10-08,0,0,0,900,11,4,67,16,52,15,1,1,14,8,8,7,44,8,377.0,347.0
10603,5f4284409503d874,f8dc544e7077d014,427b5953ac8e3a27,2011-10-08,0,0,0,900,1,0,56,9,56,0,0,0,0,0,11,9,45,9,0.0,494.0
10604,24d92c89c893db42,18968f97ad34f15c,cbb682f5fcc44bfc,2011-10-08,0,0,0,900,8,3,47,5,44,3,1,0,2,1,16,12,28,4,125.4,632.3
10605,24d92c89c893db42,cbb682f5fcc44bfc,18968f97ad34f15c,2011-10-08,0,0,0,900,9,6,47,9,46,1,0,0,1,0,13,12,33,9,58.7,363.6
10606,21d2958e13389511,cb139171ed1b69fe,d0f3959b4a9747e6,2011-10-08,0,0,0,1500,19,1,128,11,128,0,0,0,0,0,50,29,78,11,0.0,977.0
10607,21d2958e13389511,d0f3959b4a9747e6,cb139171ed1b69fe,2011-10-08,0,0,0,1500,0,0,115,38,107,8,2,2,6,4,20,11,87,34,156.0,1149.0
10608,14b450e4ff3c5b97,5b2d7906aa894274,f1f9e48a0d150757,2011-10-08,0,0,0,900,11,1,164,69,163,1,0,0,1,0,12,9,151,69,17.3,688.0
10609,14b450e4ff3c5b97,f1f9e48a0d150757,5b2d7906aa894274,2011-10-08,0,1,0,900,0,0,164,21,156,8,8,8,0,0,46,27,110,21,4.0,872.7
10610,f914dd2414f9a0ae,365fee2da473b177,98f6da59d765ec94,2011-10-01,1,0,0,169,0,0,20,10,6,14,3,3,11,10,3,3,3,0,134.0,35.0
10611,f914dd2414f9a0ae,98f6da59d765ec94,365fee2da473b177,2011-10-01,0,0,0,169,1,0,2,0,2,0,0,0,0,0,1,1,1,0,0.0,35.0
10612,e2433610f128d963,10f3ba6cd2f44a97,8a304bfd6bf04a57,2011-10-01,0,1,0,1500,19,10,120,26,113,7,4,4,3,1,33,30,80,25,166.5,739.0
10613,e2433610f128d963,8a304bfd6bf04a57,10f3ba6cd2f44a97,2011-10-01,0,0,0,1500,6,1,177,28,177,0,0,0,0,0,48,35,129,28,0.0,1156.5
10614,d7f151f529543431,bc7230f231701d66,ecdf14f4f8643d39,2011-10-01,1,0,0,592,0,0,84,11,80,4,1,1,3,3,29,19,51,8,14.5,534.0
10615,d7f151f529543431,ecdf14f4f8643d39,bc7230f231701d66,2011-10-01,0,0,0,592,3,0,77,9,77,0,0,0,0,0,13,8,64,9,0.0,533.5
10616,cdedc8f026307dd7,75e0d3cc2262b732,a26198ba5093147e,2011-10-01,0,2,0,732,3,1,60,10,60,0,0,0,0,0,0,0,60,10,0.0,354.1
10617,cdedc8f026307dd7,a26198ba5093147e,75e0d3cc2262b732,2011-10-01,0,3,1,732,2,2,64,20,54,10,0,0,10,5,5,4,49,15,212.9,434.0
10618,8bd1f8cb9aa06dcf,696002b59f09d73b,92aafa8f4b26269b,2011-10-01,0,0,0,77,0,0,3,0,3,0,0,0,0,0,0,0,3,0,0.0,73.0
10619,8bd1f8cb9aa06dcf,92aafa8f4b26269b,696002b59f09d73b,2011-10-01,2,0,0,77,0,0,28,6,26,2,0,0,2,1,4,3,22,5,4.0,73.0
10620,765a1fde5ee12784,15b1b21cd743d652,5f04e3d58d9ce982,2011-10-01,0,0,0,464,3,0,117,14,117,0,0,0,0,0,25,8,92,14,0.0,403.5
10621,765a1fde5ee12784,5f04e3d58d9ce982,15b1b21cd743d652,2011-10-01,2,0,0,464,0,0,108,29,95,13,0,0,13,12,19,13,76,17,17.5,429.0
10622,6aa873e65d880322,511e82663651438d,7b143a54451263d9,2011-10-01,0,0,0,180,0,0,26,6,25,1,0,0,1,1,3,2,22,5,37.0,143.0
10623,6aa873e65d880322,7b143a54451263d9,511e82663651438d,2011-10-01,0,3,1,180,3,0,16,2,16,0,0,0,0,0,0,0,16,2,0.0,138.0
10624,425e856cac6f521b,cd12227edd3f134b,d1a1314976c50bef,2011-10-01,0,0,0,600,2,0,83,22,83,0,0,0,0,0,22,19,61,22,0.0,380.0
10625,425e856cac6f521b,d1a1314976c50bef,cd12227edd3f134b,2011-10-01,1,1,0,600,0,0,159,73,159,0,0,0,0,0,21,20,138,73,0.0,558.0
10626,3542b1fd47163fcd,86f582852a5b240a,eb29176b03dfa888,2011-10-01,0,1,0,900,6,2,107,54,106,1,0,0,1,1,12,12,94,53,12.4,578.9
10627,3542b1fd47163fcd,eb29176b03dfa888,86f582852a5b240a,2011-10-01,0,1,0,900,7,2,141,58,135,6,0,0,6,5,36,35,99,53,24.1,642.6
10628,008d1123cc90f003,658c3465581ae46b,ebc1f40e00e0c481,2011-10-01,0,0,0,502,0,0,45,8,44,1,1,1,0,0,25,21,19,8,24.0,478.0
10629,008d1123cc90f003,ebc1f40e00e0c481,658c3465581ae46b,2011-10-01,0,1,1,502,0,0,82,10,82,0,0,0,0,0,27,21,55,10,0.0,475.0
10630,fde66b153c65e25d,3be081c29bf734d9,8355922d564b152c,2011-09-24,0,0,0,267,1,0,23,1,21,2,0,0,2,1,7,3,14,0,37.0,230.0
10631,fde66b153c65e25d,8355922d564b152c,3be081c29bf734d9,2011-09-24,1,3,1,267,0,0,73,34,73,0,0,0,0,0,2,2,71,34,0.0,207.0
10632,eb5b6287ba73640d,48e093ea1f43a053,5df17b3620145578,2011-09-24,2,0,0,570,1,1,129,50,121,8,0,0,8,3,25,20,96,47,28.8,415.0
10633,eb5b6287ba73640d,5df17b3620145578,48e093ea1f43a053,2011-09-24,0,0,0,570,0,0,51,10,51,0,0,0,0,0,22,19,29,10,0.0,501.2
10634,d7d7c9ce3d812eca,cc84b68f862b466f,d0d7160824278840,2011-09-24,0,2,0,900,0,0,26,9,26,0,0,0,0,0,1,1,25,9,0.0,474.2
10635,d7d7c9ce3d812eca,d0d7160824278840,cc84b68f862b466f,2011-09-24,0,0,0,900,8,3,90,40,36,54,17,14,37,30,14,9,22,10,410.8,474.0
10636,cca58aece2816dd1,bd58d34e39b7b12a,eef9b891edbd4604,2011-09-24,0,0,0,900,14,2,50,19,38,12,0,0,12,10,0,0,38,9,131.0,430.1
10637,cca58aece2816dd1,eef9b891edbd4604,bd58d34e39b7b12a,2011-09-24,0,1,0,900,4,2,95,44,69,26,1,1,25,18,2,2,67,26,338.9,391.0
10638,9cb967c62498ff02,3236bf606fe9fa5b,a7d687e6ecb30981,2011-09-24,0,0,0,900,3,3,93,24,73,20,1,1,19,11,22,20,51,13,272.0,492.0
10639,9cb967c62498ff02,a7d687e6ecb30981,3236bf606fe9fa5b,2011-09-24,0,1,0,900,0,0,57,12,57,0,0,0,0,0,14,10,43,12,0.0,604.0
10640,8af87933e6409e24,b13da0b1a3aed3e7,c80095f6092271a7,2011-09-24,0,0,0,900,2,0,82,13,75,7,6,6,1,1,17,10,58,12,65.8,639.1
10641,8af87933e6409e24,c80095f6092271a7,b13da0b1a3aed3e7,2011-09-24,0,2,0,900,6,4,84,31,71,13,0,0,13,9,22,15,49,22,72.9,649.2
10642,8133b11f2b7ad634,621a6c59f88a44fe,dd37fd509af89f15,2011-09-24,0,0,0,299,0,0,53,14,53,0,0,0,0,0,0,0,53,14,0.0,288.0
10643,8133b11f2b7ad634,dd37fd509af89f15,621a6c59f88a44fe,2011-09-24,1,0,0,299,1,0,51,23,40,11,0,0,11,11,5,3,35,12,11.0,282.0
10644,3f7c7917a57d2782,22a92d7f62195791,f2c8ebbeafd45f2b,2011-09-24,1,0,0,300,0,0,82,22,82,0,0,0,0,0,15,9,67,22,0.0,298.0
10645,3f7c7917a57d2782,f2c8ebbeafd45f2b,22a92d7f62195791,2011-09-24,0,0,0,300,0,0,49,3,49,0,0,0,0,0,14,8,35,3,0.0,300.0
10646,38591fb67eb2a6c3,744e098e065cfdbe,f5431394fb284bb9,2011-09-24,0,0,0,47,3,0,3,0,3,0,0,0,0,0,0,0,3,0,0.0,40.3
10647,38591fb67eb2a6c3,f5431394fb284bb9,744e098e065cfdbe,2011-09-24,1,0,0,47,0,0,7,5,3,4,0,0,4,4,0,0,3,1,6.7,37.0
10648,181ce41897b37352,07f72a2a7591b409,ffc088e64fab57e9,2011-09-24,0,2,1,974,6,2,117,18,108,9,1,1,8,6,54,42,54,12,68.1,762.0
10649,181ce41897b37352,ffc088e64fab57e9,07f72a2a7591b409,2011-09-24,0,0,0,974,1,0,44,6,44,0,0,0,0,0,13,10,31,6,0.0,889.9
10650,fdc82a98c68588c4,e2b8186b618b00c4,e5c9de15bb58b1c6,2011-09-17,0,0,0,900,5,0,206,19,206,0,0,0,0,0,37,16,169,19,0.0,888.0
10651,fdc82a98c68588c4,e5c9de15bb58b1c6,e2b8186b618b00c4,2011-09-17,0,1,0,900,0,0,351,87,351,0,0,0,0,0,15,5,336,87,0.0,888.0
10652,be5cdd4872fbd0b7,83a477a7dba1ca58,fd5b6598a3b70c0a,2011-09-17,0,0,0,372,0,0,27,2,27,0,0,0,0,0,13,10,14,2,0.0,318.8
10653,be5cdd4872fbd0b7,fd5b6598a3b70c0a,83a477a7dba1ca58,2011-09-17,1,1,1,372,2,0,107,25,93,14,2,1,12,7,27,15,66,18,53.2,220.0
10654,b4daedb1e0c4ee02,99bd87a300079ed9,b0a6124751a56bc4,2011-09-17,0,0,0,900,0,0,110,23,110,0,0,0,0,0,19,17,91,23,0.0,866.0
10655,b4daedb1e0c4ee02,b0a6124751a56bc4,99bd87a300079ed9,2011-09-17,0,0,0,900,20,1,59,11,59,0,0,0,0,0,19,12,40,11,0.0,381.0
10656,a7fca585b4fd4255,2be6596a9db33bf5,4130a743d9d22163,2011-09-17,0,0,0,228,3,0,7,0,7,0,0,0,0,0,2,2,5,0,0.0,31.099999999999994
10657,a7fca585b4fd4255,4130a743d9d22163,2be6596a9db33bf5,2011-09-17,1,0,0,228,0,0,39,24,5,34,0,0,34,24,1,1,4,0,171.9,51.0
10658,5dc4552c9288441a,7be63795363029e8,d403b1a6f278c95e,2011-09-17,0,1,0,529,0,0,43,10,43,0,0,0,0,0,8,5,35,10,0.0,156.0
10659,5dc4552c9288441a,d403b1a6f278c95e,7be63795363029e8,2011-09-17,0,4,1,529,2,2,48,14,35,13,1,1,12,8,8,3,27,6,341.0,188.0
10660,558b54d28a662cca,5431dccc09118234,d023ae89a2a4a41e,2011-09-17,0,0,0,900,3,1,66,18,43,23,8,8,15,10,16,13,27,8,198.9,315.4
10661,558b54d28a662cca,d023ae89a2a4a41e,5431dccc09118234,2011-09-17,0,0,0,900,4,4,51,10,28,23,12,12,11,5,5,4,23,5,290.6,284.1
10662,35cfe0b894b93332,e6147d5ab3685899,fbf0947399d14323,2011-09-17,0,0,0,160,0,0,3,1,3,0,0,0,0,0,0,0,3,1,0.0,127.5
10663,35cfe0b894b93332,fbf0947399d14323,e6147d5ab3685899,2011-09-17,0,1,1,160,2,2,12,1,11,1,1,1,0,0,5,5,6,1,32.5,30.0
10664,1fa175b6a35e95e2,d81ac739417d7f53,fe435e440b5de0ff,2011-09-17,1,0,0,53,0,0,16,7,10,6,0,0,6,5,3,2,7,2,3.0,49.0
10665,1fa175b6a35e95e2,fe435e440b5de0ff,d81ac739417d7f53,2011-09-17,0,0,0,53,1,0,13,0,13,0,0,0,0,0,1,1,12,0,0.0,43.0
10666,1f70cf05ec46f065,e56daf7725a0b5ab,ee624ee2a18f2a43,2011-09-17,0,2,0,900,13,2,73,20,61,12,3,3,9,8,20,18,41,12,80.6,403.5
10667,1f70cf05ec46f065,ee624ee2a18f2a43,e56daf7725a0b5ab,2011-09-17,0,0,0,900,3,3,63,34,41,22,2,2,20,19,6,6,35,15,234.5,414.4
10668,11141cf97c6156b6,8f2939f5fd9cca1e,c0c36a5b3d5bbdd5,2011-09-17,0,2,1,232,4,3,7,2,5,2,0,0,2,2,3,2,2,0,130.7,12.0
10669,11141cf97c6156b6,c0c36a5b3d5bbdd5,8f2939f5fd9cca1e,2011-09-17,0,1,0,232,0,0,4,0,3,1,0,0,1,0,1,0,2,0,24.0,77.30000000000001
10670,0f5f1f5828ebd9c5,960d6cae8879ba2b,e26882820f9e8df5,2011-09-17,0,0,0,900,1,1,137,20,137,0,0,0,0,0,64,60,73,20,0.0,862.0
10671,0f5f1f5828ebd9c5,e26882820f9e8df5,960d6cae8879ba2b,2011-09-17,0,0,0,900,13,2,129,7,129,0,0,0,0,0,59,44,70,7,0.0,613.0
10672,032a61c6f9439b1d,523fa774700d7d3f,aed06011bf62237b,2011-09-17,0,1,0,900,7,2,201,36,196,5,0,0,5,4,43,26,153,32,17.8,843.0
10673,032a61c6f9439b1d,aed06011bf62237b,523fa774700d7d3f,2011-09-17,1,0,0,900,2,1,134,35,134,0,0,0,0,0,16,15,118,35,0.0,862.2
10674,fa3294fe655440dd,4f732e58ed907eff,64a50dad704d1d49,2011-08-27,0,0,0,900,6,0,186,47,186,0,0,0,0,0,20,13,166,47,0.0,860.9
10675,fa3294fe655440dd,64a50dad704d1d49,4f732e58ed907eff,2011-08-27,1,0,0,900,1,0,190,29,189,1,0,0,1,0,40,26,149,29,0.1,899.0
10676,e7da014d4dfc5bf3,140745cbbcb023ac,fcffee71cff5530e,2011-08-27,1,0,0,113,0,0,29,16,18,11,0,0,11,8,0,0,18,8,6.4,106.0
10677,e7da014d4dfc5bf3,fcffee71cff5530e,140745cbbcb023ac,2011-08-27,0,0,0,113,0,0,19,1,19,0,0,0,0,0,7,2,12,1,0.0,106.6
10678,c8fbe7ade97e2055,89a407032911e27e,ee9d73f4fee9cbdd,2011-08-27,0,0,0,189,0,0,45,7,45,0,0,0,0,0,6,4,39,7,0.0,165.6
10679,c8fbe7ade97e2055,ee9d73f4fee9cbdd,89a407032911e27e,2011-08-27,1,0,0,189,2,0,35,12,34,1,0,0,1,1,4,3,30,11,3.4,172.0
10680,9d379b41d86d7c7f,5866fc86183a9fb8,7bc475b0fc2020ab,2011-08-27,1,0,0,40,0,0,9,4,4,5,0,0,5,3,0,0,4,1,5.0,35.0
10681,9d379b41d86d7c7f,7bc475b0fc2020ab,5866fc86183a9fb8,2011-08-27,0,0,0,40,0,0,7,2,7,0,0,0,0,0,2,2,5,2,0.0,35.0
10682,89cc8f4a69e9ea0e,1f454354805b6f75,acff437707625fc7,2011-08-27,2,0,0,424,0,0,61,29,43,18,3,3,15,11,14,11,29,18,22.0,391.0
10683,89cc8f4a69e9ea0e,acff437707625fc7,1f454354805b6f75,2011-08-27,0,0,0,424,1,0,43,11,43,0,0,0,0,0,5,5,38,11,0.0,291.0
10684,8938fad6ec08499d,30a09e43f15f1d75,8f3df4c579cfbb69,2011-08-27,0,1,0,900,6,6,69,13,65,4,0,0,4,2,10,6,55,11,295.0,568.0
10685,8938fad6ec08499d,8f3df4c579cfbb69,30a09e43f15f1d75,2011-08-27,0,0,0,900,0,0,120,14,119,1,0,0,1,1,19,9,100,13,37.0,568.0
10686,8782dca7c99717a6,1d4bbaabd8b60173,24b033b3daf1c9df,2011-08-27,1,0,0,253,1,0,51,29,41,10,0,0,10,7,0,0,41,22,3.8,247.0
10687,8782dca7c99717a6,24b033b3daf1c9df,1d4bbaabd8b60173,2011-08-27,0,0,0,253,0,0,46,7,46,0,0,0,0,0,8,8,38,7,0.0,249.2
10688,7b1d63d0e3e12804,2f13e4020cea5b38,528c24b99fbaab79,2011-08-27,0,0,0,900,8,3,101,32,89,12,0,0,12,11,24,21,65,21,153.9,605.0
10689,7b1d63d0e3e12804,528c24b99fbaab79,2f13e4020cea5b38,2011-08-27,0,1,0,900,0,0,85,15,85,0,0,0,0,0,24,13,61,15,0.0,742.1
10690,7036a87673c98a13,2f95a3c6d58b2aad,71002dbc1743b9a7,2011-08-27,0,0,0,900,6,6,52,12,43,9,3,2,6,4,11,8,32,8,325.5,376.0
10691,7036a87673c98a13,71002dbc1743b9a7,2f95a3c6d58b2aad,2011-08-27,0,0,0,900,0,0,47,14,39,8,1,1,7,5,19,14,20,9,90.0,439.5
10692,6265ffd51a18ff21,8a59d346dc976a10,f34312c2ccfa0e00,2011-08-27,1,0,0,471,7,3,26,8,10,16,0,0,16,6,2,2,8,2,403.0,68.0
10693,6265ffd51a18ff21,f34312c2ccfa0e00,8a59d346dc976a10,2011-08-27,0,0,0,471,0,0,9,1,9,0,0,0,0,0,2,2,7,1,0.0,67.0
10694,1fb62d8192128dc1,b4eeac608fc82f88,eea0274e153256a0,2011-08-27,0,0,0,900,6,2,106,11,105,1,0,0,1,1,42,26,63,10,14.8,771.8
10695,1fb62d8192128dc1,eea0274e153256a0,b4eeac608fc82f88,2011-08-27,0,1,0,900,7,3,102,28,91,11,0,0,11,6,6,5,85,22,69.2,734.2
10696,15b62b191eb6dacf,8ddf9c51c5fdea75,d0c29452d3272603,2011-08-27,1,0,0,900,2,2,111,45,82,29,3,2,26,15,20,20,62,30,283.8,577.0
10697,15b62b191eb6dacf,d0c29452d3272603,8ddf9c51c5fdea75,2011-08-27,1,0,0,900,0,0,97,37,97,0,0,0,0,0,5,5,92,37,0.0,578.2
10698,aa4aa75f0065a687,473ce3aa581251a2,91acd6910b802a9e,2011-08-14,0,0,0,856,2,1,238,53,238,0,0,0,0,0,10,8,228,53,0.0,849.0
10699,aa4aa75f0065a687,91acd6910b802a9e,473ce3aa581251a2,2011-08-14,0,1,1,856,0,0,271,81,271,0,0,0,0,0,62,46,209,81,0.0,836.0
10700,a39286bf0a443ff0,bd21a1e3d41c97ee,d23ccf4a6c221284,2011-08-14,0,0,0,900,6,6,52,10,42,10,4,4,6,4,26,26,16,6,235.8,122.0
10701,a39286bf0a443ff0,d23ccf4a6c221284,bd21a1e3d41c97ee,2011-08-14,0,1,0,900,4,0,24,6,24,0,0,0,0,0,2,2,22,6,0.0,628.2
10702,74773b56e0b31c6b,23459ee7e373b98f,5d7bdab5e03e3216,2011-08-14,1,0,0,518,0,0,113,41,57,56,4,2,52,27,11,10,46,14,219.0,124.0
10703,74773b56e0b31c6b,5d7bdab5e03e3216,23459ee7e373b98f,2011-08-14,0,1,0,518,7,3,40,14,30,10,0,0,10,5,6,5,24,9,175.0,124.0
10704,5169aaf0ce80d1f8,2676b28836a5a836,d1941565abf50b16,2011-08-14,0,2,0,900,7,7,132,40,69,63,17,10,46,28,15,15,54,12,522.5,277.6
10705,5169aaf0ce80d1f8,d1941565abf50b16,2676b28836a5a836,2011-08-14,0,6,0,900,0,0,44,10,43,1,0,0,1,1,8,4,35,9,0.4,374.5
10706,475c55534f9e08ee,282fa667ff9c51ed,d25b93992f285953,2011-08-14,1,2,1,458,0,0,76,17,66,10,10,9,0,0,7,6,59,17,49.0,409.0
10707,475c55534f9e08ee,d25b93992f285953,282fa667ff9c51ed,2011-08-14,0,0,0,458,0,0,61,11,61,0,0,0,0,0,19,17,42,11,0.0,402.0
10708,345f0bd50451a321,7aa3d6964eff4877,893d51aaf024eddd,2011-08-14,0,0,0,492,0,0,25,8,12,13,2,2,11,5,4,3,8,3,100.2,90.0
10709,345f0bd50451a321,893d51aaf024eddd,7aa3d6964eff4877,2011-08-14,0,2,1,492,9,5,7,2,4,3,0,0,3,2,1,0,3,0,271.0,120.8
10710,295c2e1ae2d54287,07225ba28ae309b6,1d00756835ca67c9,2011-08-14,0,0,0,181,0,0,29,5,29,0,0,0,0,0,10,5,19,5,0.0,169.9
10711,295c2e1ae2d54287,1d00756835ca67c9,07225ba28ae309b6,2011-08-14,1,0,0,181,0,0,60,22,36,24,0,0,24,15,11,8,25,7,11.1,169.0
10712,23243c27deb4d596,06f36cf4bd97ec77,7339d340aa2889cb,2011-08-14,0,3,1,255,1,1,6,2,5,1,0,0,1,1,0,0,5,1,6.0,38.0
10713,23243c27deb4d596,7339d340aa2889cb,06f36cf4bd97ec77,2011-08-14,0,0,0,255,3,1,13,6,3,10,5,5,5,4,1,1,2,2,205.0,44.0
10714,0fd5485e64712df9,80eacd4da0617c57,fc9a9559a05f2704,2011-08-14,0,0,0,900,6,0,144,28,143,1,1,1,0,0,67,37,76,28,0.8,891.0
10715,0fd5485e64712df9,fc9a9559a05f2704,80eacd4da0617c57,2011-08-14,0,0,0,900,1,0,71,12,71,0,0,0,0,0,15,12,56,12,0.0,879.2
10716,09c1d4c96efd0545,2650e2f846a30f64,84ac950d4c1722dd,2011-08-14,0,0,0,900,8,0,256,45,256,0,0,0,0,0,86,50,170,45,0.0,834.6
10717,09c1d4c96efd0545,84ac950d4c1722dd,2650e2f846a30f64,2011-08-14,0,0,0,900,2,1,328,96,326,2,0,0,2,1,45,27,281,95,6.4,801.0
10718,096d656048f85b18,02500fb9fd79a974,bbfca6d5c27d9cd8,2011-08-14,0,0,0,350,8,1,1,1,1,0,0,0,0,0,0,0,1,1,0.0,168.5
10719,096d656048f85b18,bbfca6d5c27d9cd8,02500fb9fd79a974,2011-08-14,1,1,0,350,0,0,39,15,14,25,5,5,20,13,3,3,11,2,111.5,234.0
10720,03938272fb7c3971,6f81b6de2557739a,d1e7fc58d4225cdf,2011-08-14,0,6,0,900,5,3,16,4,13,3,0,0,3,3,3,2,10,1,467.0,284.2
10721,03938272fb7c3971,d1e7fc58d4225cdf,6f81b6de2557739a,2011-08-14,0,0,0,900,4,1,30,2,18,12,12,12,0,0,8,8,10,2,148.8,247.0
10722,eb3093e235f048c8,0ee783aa00e468f0,b0550072e5f0afa7,2011-08-06,2,0,0,112,0,0,25,11,15,10,0,0,10,6,3,1,12,5,6.0,103.0
10723,eb3093e235f048c8,b0550072e5f0afa7,0ee783aa00e468f0,2011-08-06,0,0,0,112,0,0,9,0,9,0,0,0,0,0,3,1,6,0,0.0,106.0
10724,e516a0e035fd57f7,94527830000ab715,b5b684eac99ae0a3,2011-08-06,0,0,0,900,5,0,87,8,87,0,0,0,0,0,17,7,70,8,0.0,637.8
10725,e516a0e035fd57f7,b5b684eac99ae0a3,94527830000ab715,2011-08-06,0,0,0,900,5,5,72,20,60,12,0,0,12,10,30,15,30,10,262.2,616.0
10726,de41ca23c9a13bfb,5755960ebd0b16f6,8cb76103cd8a1562,2011-08-06,0,0,0,900,1,0,181,25,181,0,0,0,0,0,64,36,117,25,0.0,846.4
10727,de41ca23c9a13bfb,8cb76103cd8a1562,5755960ebd0b16f6,2011-08-06,0,1,0,900,4,2,116,23,114,2,0,0,2,1,18,8,96,22,52.6,716.0
10728,c299ca1bc07857d5,cbd5d3cdd862e90e,f5990c11974d8e9c,2011-08-06,1,2,0,234,0,0,37,21,11,26,1,1,25,18,2,2,9,3,101.2,109.8
10729,c299ca1bc07857d5,f5990c11974d8e9c,cbd5d3cdd862e90e,2011-08-06,0,0,0,234,4,2,17,1,16,1,0,0,1,0,2,2,14,1,15.2,71.8
10730,ba2f30fb7143a6b1,0dba4df5f34d5ff0,c7011de4765d2497,2011-08-06,0,0,0,900,1,0,123,17,123,0,0,0,0,0,41,26,82,17,0.0,857.2
10731,ba2f30fb7143a6b1,c7011de4765d2497,0dba4df5f34d5ff0,2011-08-06,0,0,0,900,12,3,67,11,65,2,0,0,2,1,5,2,60,10,38.8,745.0
10732,9468f58f8abf78df,80dbeb1dd5b53e64,e0b74df14f52cd15,2011-08-06,0,0,0,900,0,0,120,26,120,0,0,0,0,0,16,12,104,26,0.0,479.2
10733,9468f58f8abf78df,e0b74df14f52cd15,80dbeb1dd5b53e64,2011-08-06,0,0,0,900,18,5,123,48,88,35,0,0,35,29,23,12,65,19,420.8,383.0
10734,87cc38e9d565f819,0941df56f6ac954b,236a37d96d476164,2011-08-06,0,0,0,900,6,1,121,31,121,0,0,0,0,0,29,23,92,31,0.0,773.4
10735,87cc38e9d565f819,236a37d96d476164,0941df56f6ac954b,2011-08-06,0,0,0,900,4,1,99,25,96,3,0,0,3,3,18,12,78,22,14.6,710.0
10736,68ac97071275099f,2f732dd9210d301f,ee779c43a8926d52,2011-08-06,0,1,0,588,1,1,27,4,27,0,0,0,0,0,6,1,21,4,0.0,307.4
10737,68ac97071275099f,ee779c43a8926d52,2f732dd9210d301f,2011-08-06,1,0,0,588,1,1,97,42,48,49,1,1,48,27,5,5,43,15,216.6,283.0
10738,48ac0e2cf3681cca,3c6976f8182d9527,98b80a717b9bda17,2011-08-06,1,0,0,514,0,0,98,30,79,19,0,0,19,13,10,7,69,17,16.1,492.0
10739,48ac0e2cf3681cca,98b80a717b9bda17,3c6976f8182d9527,2011-08-06,0,0,0,514,6,0,34,12,34,0,0,0,0,0,6,1,28,12,0.0,497.9
10740,27593cd1cda3cc2f,32ba186f4b0e3267,8a8a84b743ae7699,2011-08-06,1,0,0,268,0,0,24,18,0,24,1,1,23,18,0,0,0,0,127.0,141.0
10741,27593cd1cda3cc2f,8a8a84b743ae7699,32ba186f4b0e3267,2011-08-06,0,1,0,268,1,1,1,0,1,0,0,0,0,0,0,0,1,0,0.0,5.0
10742,04df2fbb108b23c1,05560764359161e4,cb46dface0e28a2c,2011-08-06,1,1,0,900,3,2,89,29,63,26,0,0,26,14,10,6,53,15,207.4,425.9
10743,04df2fbb108b23c1,cb46dface0e28a2c,05560764359161e4,2011-08-06,0,0,0,900,2,1,70,15,60,10,3,3,7,4,9,7,51,11,139.1,386.6
10744,ec20620c294a49a4,0c6d9ea8306c029e,d5f820c11a121050,2011-07-02,0,0,0,900,4,1,33,5,33,0,0,0,0,0,9,8,24,5,0.0,798.1
10745,ec20620c294a49a4,d5f820c11a121050,0c6d9ea8306c029e,2011-07-02,0,2,0,900,15,2,66,13,63,3,1,1,2,2,35,29,28,11,43.9,241.0
10746,d8287db48ec356df,6bf5a7d3e081ade2,b45d6b73f4ca4467,2011-07-02,0,0,0,900,3,2,211,61,211,0,0,0,0,0,71,55,140,61,0.0,834.0
10747,d8287db48ec356df,b45d6b73f4ca4467,6bf5a7d3e081ade2,2011-07-02,0,0,0,900,1,0,114,8,114,0,0,0,0,0,22,7,92,8,0.0,875.0
10748,d5d6ae85ebcfd160,9bcf8603ceb25680,f9f07bb5a43535ed,2011-07-02,0,0,0,178,1,1,6,1,6,0,0,0,0,0,1,0,5,1,0.0,155.0
10749,d5d6ae85ebcfd160,f9f07bb5a43535ed,9bcf8603ceb25680,2011-07-02,1,1,0,178,0,0,21,7,15,6,0,0,6,5,4,1,11,2,9.0,169.0
10750,be79dafe6c0b7671,5f87a5c00b3d17ed,eb29176b03dfa888,2011-07-02,0,0,0,900,1,1,111,14,110,1,0,0,1,0,26,17,84,14,5.9,390.4
10751,be79dafe6c0b7671,eb29176b03dfa888,5f87a5c00b3d17ed,2011-07-02,0,2,0,900,16,5,73,18,47,26,0,0,26,12,15,8,32,6,421.6,440.1
10752,a0d1be5413e301dd,48e093ea1f43a053,b26d3e3746fb4024,2011-07-02,0,0,0,900,0,0,89,10,89,0,0,0,0,0,12,4,77,10,0.0,876.0
10753,a0d1be5413e301dd,b26d3e3746fb4024,48e093ea1f43a053,2011-07-02,0,0,0,900,1,1,86,14,86,0,0,0,0,0,17,15,69,14,0.0,531.0
10754,8f4a445ccb548f15,10f3ba6cd2f44a97,78114b7199cef90c,2011-07-02,0,0,0,1500,13,4,238,50,238,0,0,0,0,0,67,40,171,50,0.0,1363.0
10755,8f4a445ccb548f15,78114b7199cef90c,10f3ba6cd2f44a97,2011-07-02,0,0,0,1500,5,1,170,31,170,0,0,0,0,0,39,19,131,31,0.0,1455.0
10756,65171ae917df102f,6a2f7c151031653d,896c322f56b8be5a,2011-07-02,1,0,0,59,0,0,10,1,10,0,0,0,0,0,2,1,8,1,0.0,56.0
10757,65171ae917df102f,896c322f56b8be5a,6a2f7c151031653d,2011-07-02,0,0,0,59,0,0,24,0,24,0,0,0,0,0,6,2,18,0,0.0,59.0
10758,50ebe7915d9f0cab,a1f6999fe57236e0,d43a048a880efdff,2011-07-02,0,0,0,27,0,0,8,3,8,0,0,0,0,0,0,0,8,3,0.0,25.7
10759,50ebe7915d9f0cab,d43a048a880efdff,a1f6999fe57236e0,2011-07-02,1,0,0,27,0,0,10,7,6,4,0,0,4,4,2,2,4,3,1.3,25.0
10760,34c6c06ba60a9ade,2f732dd9210d301f,c0ab242c40decc55,2011-07-02,1,1,1,116,0,0,16,4,14,2,0,0,2,1,4,2,10,3,6.0,110.0
10761,34c6c06ba60a9ade,c0ab242c40decc55,2f732dd9210d301f,2011-07-02,0,0,0,116,0,0,21,1,21,0,0,0,0,0,8,3,13,1,0.0,101.0
10762,29a1ed2c88c34fe0,97a8f39186f489db,e6147d5ab3685899,2011-07-02,0,4,0,900,5,1,116,36,102,14,1,1,13,7,33,24,69,29,172.7,461.4
10763,29a1ed2c88c34fe0,e6147d5ab3685899,97a8f39186f489db,2011-07-02,0,2,0,900,0,0,83,14,79,4,0,0,4,3,27,17,52,11,216.6,348.3
10764,137d7dea41cacdc6,75e0d3cc2262b732,ccd1299e0345e0ce,2011-07-02,0,0,0,132,0,0,13,1,13,0,0,0,0,0,3,0,10,1,0.0,127.3
10765,137d7dea41cacdc6,ccd1299e0345e0ce,75e0d3cc2262b732,2011-07-02,2,0,0,132,0,0,42,11,35,7,0,0,7,4,12,6,23,7,4.7,126.0
10766,daa06084bcc66645,511e82663651438d,6224e8d0a34264eb,2011-06-26,1,0,0,282,1,1,73,17,57,16,0,0,16,7,16,10,41,10,32.5,217.0
10767,daa06084bcc66645,6224e8d0a34264eb,511e82663651438d,2011-06-26,0,0,0,282,0,0,43,3,43,0,0,0,0,0,17,14,26,3,0.0,238.5
10768,91daeeeea0a83e49,07225ba28ae309b6,6fb1ba67bef41b37,2011-06-26,1,3,0,408,2,1,59,23,46,13,0,0,13,8,12,8,34,15,55.2,158.4
10769,91daeeeea0a83e49,6fb1ba67bef41b37,07225ba28ae309b6,2011-06-26,0,2,0,408,7,2,33,9,29,4,3,2,1,0,6,3,23,9,113.6,210.8
10770,70ddd13934e6c0e9,20205040232ed0f3,cc6f9d1e89f3449a,2011-06-26,0,0,0,900,3,0,125,22,120,5,1,1,4,2,49,44,71,20,42.2,635.5
10771,70ddd13934e6c0e9,cc6f9d1e89f3449a,20205040232ed0f3,2011-06-26,0,0,0,900,12,2,71,17,68,3,0,0,3,2,16,15,52,15,36.5,699.8
10772,6cc8c21becd17ffa,210935fd21670f6d,22edaf53ad59a967,2011-06-26,1,0,0,900,2,1,101,40,57,44,13,13,31,18,15,13,42,22,275.2,556.0
10773,6cc8c21becd17ffa,22edaf53ad59a967,210935fd21670f6d,2011-06-26,0,1,0,900,7,1,66,9,66,0,0,0,0,0,20,14,46,9,0.0,545.8
10774,6b3038fe26a57b80,2721bb808bb2523c,3bad7ef643840f67,2011-06-26,0,0,0,118,0,0,23,4,23,0,0,0,0,0,1,1,22,4,0.0,91.0
10775,6b3038fe26a57b80,3bad7ef643840f67,2721bb808bb2523c,2011-06-26,1,1,1,118,0,0,33,11,21,12,1,1,11,6,0,0,21,5,27.0,91.0
10776,5ad0a7ec5e99955b,31123249b0bbf52e,fc31f896cde2bc2e,2011-06-26,0,3,0,900,4,3,83,26,78,5,2,2,3,1,10,10,68,25,89.2,486.0
10777,5ad0a7ec5e99955b,fc31f896cde2bc2e,31123249b0bbf52e,2011-06-26,0,0,0,900,11,5,35,3,32,3,1,1,2,1,21,16,11,2,200.0,410.8
10778,4d6f492092d827cf,1eacf73d6a0055dc,658c3465581ae46b,2011-06-26,1,0,0,159,2,0,16,5,14,2,0,0,2,2,9,5,5,3,1.0,149.0
10779,4d6f492092d827cf,658c3465581ae46b,1eacf73d6a0055dc,2011-06-26,2,0,0,159,1,0,16,6,8,8,0,0,8,4,2,2,6,2,9.0,149.0
10780,4289bcb551b07bc1,79899ecf62020f6d,be5cfd73617a5b1a,2011-06-26,0,1,0,900,3,0,76,18,76,0,0,0,0,0,14,9,62,18,0.0,641.2
10781,4289bcb551b07bc1,be5cfd73617a5b1a,79899ecf62020f6d,2011-06-26,0,1,0,900,5,3,161,54,154,7,5,5,2,0,5,3,149,54,177.8,646.0
10782,41f186bffee2bb29,80779d7441af1b52,ba280572acfba13f,2011-06-26,0,0,0,568,3,2,90,12,90,0,0,0,0,0,9,5,81,12,0.0,432.5
10783,41f186bffee2bb29,ba280572acfba13f,80779d7441af1b52,2011-06-26,3,0,0,568,0,0,80,25,77,3,0,0,3,2,16,12,61,23,26.5,515.0
10784,16da233dcf7fecc8,3974fa35c917af1d,bfc2fc38a0e20211,2011-06-26,1,0,0,281,3,1,32,9,27,5,0,0,5,1,9,7,18,8,60.6,172.0
10785,16da233dcf7fecc8,bfc2fc38a0e20211,3974fa35c917af1d,2011-06-26,0,0,0,281,1,0,30,4,30,0,0,0,0,0,7,2,23,4,0.0,220.4
10786,0212461ac95ae690,5b5307450405abf0,98f6da59d765ec94,2011-06-26,0,4,0,900,4,2,46,9,40,6,2,2,4,3,9,6,31,6,52.7,493.4
10787,0212461ac95ae690,98f6da59d765ec94,5b5307450405abf0,2011-06-26,0,0,0,900,8,5,26,9,19,7,1,1,6,4,2,1,17,5,239.6,265.3
10788,c1039954c3457fe7,3a24769a4855040a,cb139171ed1b69fe,2011-06-11,1,0,0,900,2,2,104,14,94,10,1,1,9,3,29,16,65,11,69.0,581.6
10789,c1039954c3457fe7,cb139171ed1b69fe,3a24769a4855040a,2011-06-11,0,1,0,900,9,4,111,28,90,21,5,5,16,11,16,9,74,17,180.4,539.0
10790,b3a0fc0a945a31f7,029eaff01e6bb8f0,f59e9e49ef85b469,2011-06-11,0,0,0,900,9,5,146,56,146,0,0,0,0,0,23,21,123,56,0.0,603.0
10791,b3a0fc0a945a31f7,f59e9e49ef85b469,029eaff01e6bb8f0,2011-06-11,0,0,0,900,0,0,161,24,156,5,4,4,1,1,36,29,120,23,17.0,849.0
10792,9f69f6420f21080a,1d00756835ca67c9,d403b1a6f278c95e,2011-06-11,0,0,0,900,1,0,145,25,142,3,1,1,2,0,71,60,71,25,24.0,818.0
10793,9f69f6420f21080a,d403b1a6f278c95e,1d00756835ca67c9,2011-06-11,0,0,0,900,7,1,106,31,103,3,0,0,3,1,21,15,82,30,42.0,820.0
10794,9a18479792f990f7,11f8860028b68fcf,46baf0f57edfa4df,2011-06-11,0,0,0,686,1,0,179,56,179,0,0,0,0,0,21,17,158,56,0.0,612.1
10795,9a18479792f990f7,46baf0f57edfa4df,11f8860028b68fcf,2011-06-11,1,0,0,686,4,1,188,53,181,7,3,3,4,4,39,32,142,49,65.9,366.0
10796,6dc666fd76a3b280,179f1948dc234f1f,427b5953ac8e3a27,2011-06-11,0,1,0,900,7,3,81,19,54,27,19,19,8,4,8,6,46,15,280.5,578.0
10797,6dc666fd76a3b280,427b5953ac8e3a27,179f1948dc234f1f,2011-06-11,0,2,0,900,7,0,78,19,78,0,0,0,0,0,17,13,61,19,0.0,506.5
10798,65ac65daa51720e2,3a8176e15b9887c1,934de214814b8ff4,2011-06-11,0,1,1,294,1,1,17,5,9,8,0,0,8,4,3,2,6,1,180.0,69.0
10799,65ac65daa51720e2,934de214814b8ff4,3a8176e15b9887c1,2011-06-11,0,0,0,294,0,0,12,1,12,0,0,0,0,0,5,4,7,1,0.0,114.0
10800,65270a16c25b59ad,0577808d22dfe79c,cbd6f1abf955e628,2011-06-11,0,0,0,499,4,1,70,28,70,0,0,0,0,0,8,6,62,28,0.0,362.5
10801,65270a16c25b59ad,cbd6f1abf955e628,0577808d22dfe79c,2011-06-11,1,0,0,499,1,1,96,33,73,23,0,0,23,15,26,22,47,18,22.5,455.0
10802,60be440e54760b40,63def5a5662a6917,68dd7b3783c19f9c,2011-06-11,1,0,0,900,2,2,188,73,159,29,3,2,26,17,20,13,139,56,41.2,856.0
10803,60be440e54760b40,68dd7b3783c19f9c,63def5a5662a6917,2011-06-11,0,0,0,900,3,1,86,17,86,0,0,0,0,0,3,3,83,17,0.0,802.8
10804,44e24628e8eda0b1,501b07aec9b8fc2d,5f04e3d58d9ce982,2011-06-11,1,0,0,232,0,0,54,5,54,0,0,0,0,0,11,8,43,5,0.0,230.0
10805,44e24628e8eda0b1,5f04e3d58d9ce982,501b07aec9b8fc2d,2011-06-11,0,0,0,232,2,1,32,8,32,0,0,0,0,0,9,6,23,8,0.0,157.0
10806,29bf7862fb1c28d6,92a9aa9c93192871,9f842be1a5337be6,2011-06-11,0,0,0,900,4,1,288,70,287,1,0,0,1,0,16,8,271,70,5.0,807.0
10807,29bf7862fb1c28d6,9f842be1a5337be6,92a9aa9c93192871,2011-06-11,0,0,0,900,2,1,141,51,140,1,0,0,1,1,14,14,126,50,88.0,807.0
10808,1878e37418f1dfcd,59583ff832fe9d68,5b2d7906aa894274,2011-06-11,0,0,0,900,0,0,126,18,88,38,35,35,3,3,14,13,74,15,283.3,572.0
10809,1878e37418f1dfcd,5b2d7906aa894274,59583ff832fe9d68,2011-06-11,0,0,0,900,17,2,39,11,39,0,0,0,0,0,6,6,33,11,0.0,393.7
10810,06db48a74d81a15e,19a8cce18a1cef9e,b13da0b1a3aed3e7,2011-06-11,1,0,0,813,0,0,56,21,55,1,0,0,1,1,9,9,46,20,2.1,346.1
10811,06db48a74d81a15e,b13da0b1a3aed3e7,19a8cce18a1cef9e,2011-06-11,0,1,1,813,5,5,98,31,70,28,6,6,22,17,26,21,44,14,443.9,271.9
10812,e9fc9dcc549c7f3b,c47df9303d318c67,cbb682f5fcc44bfc,2011-06-04,0,0,0,900,8,5,65,8,46,19,2,2,17,4,9,9,37,4,468.9,262.5
10813,e9fc9dcc549c7f3b,cbb682f5fcc44bfc,c47df9303d318c67,2011-06-04,0,1,0,900,0,0,51,12,49,2,0,0,2,2,4,2,45,10,20.5,390.1
10814,cd0bc692a7bce9e7,22a92d7f62195791,22aa91e402d0fe1f,2011-06-04,1,0,0,234,3,2,38,19,32,6,0,0,6,5,6,2,26,14,49.3,160.0
10815,cd0bc692a7bce9e7,22aa91e402d0fe1f,22a92d7f62195791,2011-06-04,0,0,0,234,0,0,57,10,57,0,0,0,0,0,5,2,52,10,0.0,184.7
10816,ba0b95898baad200,1f9c371c93dfd3a9,e2b8186b618b00c4,2011-06-04,0,0,0,900,1,0,91,17,90,1,0,0,1,1,4,2,86,16,0.0,591.4
10817,ba0b95898baad200,e2b8186b618b00c4,1f9c371c93dfd3a9,2011-06-04,0,0,0,900,9,5,69,21,58,11,3,3,8,2,10,9,48,19,308.6,339.0
10818,a1f9a28339f5e1b2,06f36cf4bd97ec77,89b8d1bf1ff09d1d,2011-06-04,1,0,0,48,0,0,19,11,15,4,0,0,4,4,1,0,14,7,2.4,45.0
10819,a1f9a28339f5e1b2,89b8d1bf1ff09d1d,06f36cf4bd97ec77,2011-06-04,0,0,0,48,0,0,24,9,24,0,0,0,0,0,2,2,22,9,0.0,45.6
10820,7240a9432bf2af67,18968f97ad34f15c,a66395395b5f1394,2011-06-04,0,3,0,900,8,6,88,39,78,10,1,1,9,8,17,15,61,31,171.0,404.0
10821,7240a9432bf2af67,a66395395b5f1394,18968f97ad34f15c,2011-06-04,0,1,0,900,0,0,88,9,88,0,0,0,0,0,32,23,56,9,0.0,701.0
10822,57622ac93e8d8900,0b64d0fed453ef7f,fbf0947399d14323,2011-06-04,1,0,0,241,1,1,28,12,22,6,1,1,5,4,2,2,20,8,51.8,172.0
10823,57622ac93e8d8900,fbf0947399d14323,0b64d0fed453ef7f,2011-06-04,0,0,0,241,0,0,42,10,42,0,0,0,0,0,10,8,32,10,0.0,168.2
10824,35e23b1917b59132,1fb80f46d3c105d9,b959e8c7fd8390d2,2011-06-04,0,2,0,900,2,2,144,45,142,2,0,0,2,1,51,33,91,44,7.5,791.0
10825,35e23b1917b59132,b959e8c7fd8390d2,1fb80f46d3c105d9,2011-06-04,0,0,0,900,14,5,191,43,187,4,0,0,4,3,71,52,116,40,15.0,735.5
10826,33005a28b1226d15,83a477a7dba1ca58,e56daf7725a0b5ab,2011-06-04,0,2,0,900,1,1,108,34,95,13,2,2,11,9,21,21,74,25,78.7,613.7
10827,33005a28b1226d15,e56daf7725a0b5ab,83a477a7dba1ca58,2011-06-04,0,0,0,900,20,7,90,26,87,3,0,0,3,1,18,16,69,25,56.3,408.3
10828,2ebfb072b178649e,3c0437fbeda06962,60ba33c3f555a7a3,2011-06-04,1,0,0,794,0,0,142,64,73,69,10,7,59,40,22,20,51,24,281.4,188.5
10829,2ebfb072b178649e,60ba33c3f555a7a3,3c0437fbeda06962,2011-06-04,0,0,0,794,5,4,28,4,23,5,1,1,4,2,7,6,16,2,242.5,221.60000000000002
10830,1b0887e7533b9b49,56bc9ccb609df534,8c8c92a12621d7e0,2011-06-04,0,0,0,900,2,0,125,18,125,0,0,0,0,0,35,29,90,18,0.0,796.0
10831,1b0887e7533b9b49,8c8c92a12621d7e0,56bc9ccb609df534,2011-06-04,0,0,0,900,0,0,238,29,238,0,0,0,0,0,61,37,177,29,0.0,865.0
10832,07df55cb3cc0ec30,4417980b3e798abf,7ea4a9f07df33a45,2011-06-04,0,2,1,717,5,2,71,14,60,11,4,4,7,7,26,24,34,7,169.1,285.4
10833,07df55cb3cc0ec30,7ea4a9f07df33a45,4417980b3e798abf,2011-06-04,0,3,0,717,1,0,38,10,34,4,0,0,4,3,12,12,22,7,16.6,489.9
10834,c553753c64379c39,1ff9589f9065a9ed,3f7c14c7eca7195d,2011-05-28,0,0,0,900,8,6,65,28,55,10,2,2,8,8,17,16,38,20,105.7,456.0
10835,c553753c64379c39,3f7c14c7eca7195d,1ff9589f9065a9ed,2011-05-28,0,0,0,900,1,0,51,13,51,0,0,0,0,0,9,8,42,13,0.0,554.3
10836,b0cfaf01a155985b,33b2f68ef95252e0,8a304bfd6bf04a57,2011-05-28,0,3,0,900,1,0,19,3,17,2,0,0,2,1,9,7,8,2,49.6,627.0
10837,b0cfaf01a155985b,8a304bfd6bf04a57,33b2f68ef95252e0,2011-05-28,0,0,0,900,5,5,23,2,23,0,0,0,0,0,14,11,9,2,0.0,330.4
10838,9cf91ae875d886df,98b80a717b9bda17,ffc088e64fab57e9,2011-05-28,0,0,0,900,17,0,85,17,85,0,0,0,0,0,22,15,63,17,0.0,825.0
10839,9cf91ae875d886df,ffc088e64fab57e9,98b80a717b9bda17,2011-05-28,0,0,0,900,0,0,128,30,128,0,0,0,0,0,30,25,98,30,0.0,838.0
10840,7956ae951020ce8c,31ee470ef5dc8d7f,5b5307450405abf0,2011-05-28,0,0,0,900,3,1,111,34,111,0,0,0,0,0,9,7,102,34,0.0,828.2
10841,7956ae951020ce8c,5b5307450405abf0,31ee470ef5dc8d7f,2011-05-28,0,0,0,900,14,4,169,30,168,1,0,0,1,1,40,32,128,29,11.8,441.0
10842,727c8004faed648d,3236bf606fe9fa5b,ebc1f40e00e0c481,2011-05-28,1,0,0,251,1,1,36,9,33,3,1,1,2,2,12,7,21,7,31.3,178.0
10843,727c8004faed648d,ebc1f40e00e0c481,3236bf606fe9fa5b,2011-05-28,0,2,0,251,0,0,23,4,23,0,0,0,0,0,8,6,15,4,0.0,180.7
10844,6617170d3659b175,579fcdfcabd23a7b,f8dc544e7077d014,2011-05-28,2,0,0,569,0,0,99,26,75,24,2,2,22,13,24,19,51,13,102.0,467.0
10845,6617170d3659b175,f8dc544e7077d014,579fcdfcabd23a7b,2011-05-28,0,0,0,569,2,0,43,10,43,0,0,0,0,0,5,4,38,10,0.0,452.0
10846,6299412d7bbfbce6,15b1b21cd743d652,75e5fec9f72910ef,2011-05-28,0,0,0,508,3,0,48,4,48,0,0,0,0,0,12,8,36,4,0.0,371.8
10847,6299412d7bbfbce6,75e5fec9f72910ef,15b1b21cd743d652,2011-05-28,1,2,1,508,3,3,56,18,43,13,0,0,13,9,2,1,41,9,122.2,367.0
10848,556952a9520d0ae0,b2e3aca4cd363477,d0314416a7f26527,2011-05-28,0,0,0,900,4,1,85,12,84,1,0,0,1,0,34,32,50,12,24.5,673.0
10849,556952a9520d0ae0,d0314416a7f26527,b2e3aca4cd363477,2011-05-28,0,0,0,900,2,1,67,19,65,2,0,0,2,2,14,13,51,17,129.0,746.5
10850,4cc8bef7c487cf9d,2c99576fefe53c7c,5df17b3620145578,2011-05-28,0,0,0,900,7,6,88,20,84,4,1,1,3,2,32,25,52,18,410.4,382.2
10851,4cc8bef7c487cf9d,5df17b3620145578,2c99576fefe53c7c,2011-05-28,0,0,0,900,1,0,65,10,63,2,1,1,1,0,22,18,41,10,4.8,477.6
10852,3d1a835c15fd8cb2,234f3767ff0e5701,c80095f6092271a7,2011-05-28,0,0,0,900,3,1,45,1,44,1,0,0,1,1,24,19,20,0,8.3,628.4
10853,3d1a835c15fd8cb2,c80095f6092271a7,234f3767ff0e5701,2011-05-28,0,0,0,900,14,7,22,4,19,3,2,2,1,1,13,11,6,3,163.6,291.7
10854,f0e299c134cbac37,0aa92558424ced9e,f7a7f7118d4b01b6,2011-04-30,0,0,0,365,3,0,23,4,23,0,0,0,0,0,2,1,21,4,0.0,358.3
10855,f0e299c134cbac37,f7a7f7118d4b01b6,0aa92558424ced9e,2011-04-30,1,0,0,365,0,0,47,9,46,1,0,0,1,1,7,6,39,8,0.7,363.0
10856,eb8e4c57d131fb46,2676b28836a5a836,cf9d24e4bd0cf2ce,2011-04-30,0,0,0,900,4,3,126,26,102,24,3,2,21,11,35,28,67,15,117.2,434.5
10857,eb8e4c57d131fb46,cf9d24e4bd0cf2ce,2676b28836a5a836,2011-04-30,0,2,0,900,11,4,34,6,27,7,0,0,7,3,8,5,19,3,133.5,515.8
10858,eb6a55ee772dd722,22edaf53ad59a967,56116a79e4deed06,2011-04-30,0,1,0,900,4,1,79,0,79,0,0,0,0,0,15,6,64,0,0.0,625.9
10859,eb6a55ee772dd722,56116a79e4deed06,22edaf53ad59a967,2011-04-30,0,1,0,900,5,4,62,13,60,2,0,0,2,1,18,16,42,12,25.1,611.0
10860,9c3c0818f0c32768,6506c1d34da9c013,fe435e440b5de0ff,2011-04-30,0,0,0,1500,3,2,245,54,240,5,1,0,4,2,54,31,186,52,39.2,1453.0
10861,9c3c0818f0c32768,fe435e440b5de0ff,6506c1d34da9c013,2011-04-30,0,0,0,1500,6,0,401,34,401,0,0,0,0,0,83,44,318,34,0.0,1440.8
10862,8348ff428d1687ab,8e5bfd4e82352340,b4eeac608fc82f88,2011-04-30,0,1,1,271,1,0,48,10,40,8,0,0,8,8,23,16,17,2,11.6,245.0
10863,8348ff428d1687ab,b4eeac608fc82f88,8e5bfd4e82352340,2011-04-30,0,0,0,271,0,0,37,6,37,0,0,0,0,0,14,10,23,6,0.0,219.4
10864,81ec228bf7af0fc1,0d506315895efffc,d81ac739417d7f53,2011-04-30,0,0,0,162,0,0,14,3,14,0,0,0,0,0,1,0,13,3,0.0,159.3
10865,81ec228bf7af0fc1,d81ac739417d7f53,0d506315895efffc,2011-04-30,1,0,0,162,1,1,19,6,18,1,0,0,1,1,6,3,12,5,2.7,154.0
10866,6f0dc5319bf900dc,8355922d564b152c,cbd5d3cdd862e90e,2011-04-30,0,0,0,900,7,0,62,10,62,0,0,0,0,0,29,16,33,10,0.0,582.0
10867,6f0dc5319bf900dc,cbd5d3cdd862e90e,8355922d564b152c,2011-04-30,0,0,0,900,10,7,99,22,77,22,5,3,17,11,28,17,49,11,169.0,585.0
10868,6d83de8d54f75ffc,5755960ebd0b16f6,8a0be41c0380188d,2011-04-30,1,0,0,90,0,0,24,5,15,9,0,0,9,4,6,3,9,1,8.4,77.0
10869,6d83de8d54f75ffc,8a0be41c0380188d,5755960ebd0b16f6,2011-04-30,0,0,0,90,0,0,10,1,10,0,0,0,0,0,6,4,4,1,0.0,81.6
10870,6d3655c731347f94,c21a036b4e012f1c,d7b2c0b53883ee80,2011-04-30,1,0,0,687,0,0,98,31,98,0,0,0,0,0,33,19,65,31,0.0,686.0
10871,6d3655c731347f94,d7b2c0b53883ee80,c21a036b4e012f1c,2011-04-30,0,0,0,687,3,0,141,12,141,0,0,0,0,0,29,13,112,12,0.0,670.0
10872,5aef2af22f5f2fbd,2be6596a9db33bf5,aae99701b21554e4,2011-04-30,0,1,1,97,1,0,1,0,1,0,0,0,0,0,0,0,1,0,0.0,13.0
10873,5aef2af22f5f2fbd,aae99701b21554e4,2be6596a9db33bf5,2011-04-30,0,1,0,97,0,0,5,0,2,3,0,0,3,0,0,0,2,0,45.0,52.0
10874,520de85f6d492264,497ba5b12a4bfc47,ccdd90bd1fc7dab6,2011-04-30,0,0,0,20,0,0,1,1,1,0,0,0,0,0,0,0,1,1,0.0,18.0
10875,520de85f6d492264,ccdd90bd1fc7dab6,497ba5b12a4bfc47,2011-04-30,1,0,0,20,0,0,9,8,6,3,0,0,3,3,0,0,6,5,2.0,18.0
10876,12b94f0229c30ead,0a97691039c4bbfb,d0f3959b4a9747e6,2011-04-30,0,0,0,1500,2,1,181,50,150,31,8,8,23,12,25,13,125,38,249.9,689.0
10877,12b94f0229c30ead,d0f3959b4a9747e6,0a97691039c4bbfb,2011-04-30,1,1,0,1500,9,5,215,72,166,49,0,0,49,28,24,22,142,44,553.0,697.1
10878,de78bdd8c734e8ab,2650e2f846a30f64,322a56923b396b4d,2011-03-26,1,0,0,507,2,2,117,44,71,46,5,5,41,21,19,13,52,23,133.1,270.4
10879,de78bdd8c734e8ab,322a56923b396b4d,2650e2f846a30f64,2011-03-26,0,0,0,507,4,2,57,23,52,5,0,0,5,2,6,4,46,21,45.6,218.9
10880,c67473192bda50d8,bbfca6d5c27d9cd8,d0314416a7f26527,2011-03-26,0,0,0,900,0,0,98,24,93,5,2,2,3,3,24,19,69,21,117.5,562.1
10881,c67473192bda50d8,d0314416a7f26527,bbfca6d5c27d9cd8,2011-03-26,0,3,0,900,5,5,107,35,101,6,0,0,6,3,19,16,82,32,102.9,542.5
10882,bb70048e290f4a86,917e53fa0adea0d3,c451d67c09c55418,2011-03-26,0,0,0,599,1,0,87,10,87,0,0,0,0,0,12,5,75,10,0.0,457.2
10883,bb70048e290f4a86,c451d67c09c55418,917e53fa0adea0d3,2011-03-26,0,1,1,599,2,1,100,22,86,14,0,0,14,8,10,8,76,14,141.8,437.0
10884,a1f4a5fcef50915b,0941df56f6ac954b,8f2939f5fd9cca1e,2011-03-26,1,0,0,95,0,0,8,3,5,3,2,2,1,1,2,2,3,2,15.6,69.0
10885,a1f4a5fcef50915b,8f2939f5fd9cca1e,0941df56f6ac954b,2011-03-26,0,0,0,95,1,0,9,0,9,0,0,0,0,0,3,3,6,0,0.0,48.4
10886,89d39663ff1b890e,d5f820c11a121050,df2bf09c99594848,2011-03-26,0,0,0,900,26,10,75,12,48,27,11,11,16,9,36,36,12,3,326.1,139.0
10887,89d39663ff1b890e,df2bf09c99594848,d5f820c11a121050,2011-03-26,0,0,0,900,2,0,15,6,15,0,0,0,0,0,8,8,7,6,0.0,504.9
10888,774f7eed6b0180be,008dc37cca279def,80779d7441af1b52,2011-03-26,0,0,0,550,2,1,14,6,11,3,2,2,1,1,0,0,11,5,58.5,154.8
10889,774f7eed6b0180be,80779d7441af1b52,008dc37cca279def,2011-03-26,0,2,1,550,2,1,46,16,21,25,1,1,24,14,5,5,16,2,317.2,123.5
10890,70e78fcf793bc82b,353de740bb6c7e75,7691a80e6ca3e55b,2011-03-26,1,0,0,600,6,3,30,12,30,0,0,0,0,0,3,2,27,12,0.0,394.0
10891,70e78fcf793bc82b,7691a80e6ca3e55b,353de740bb6c7e75,2011-03-26,0,0,0,600,0,0,60,22,60,0,0,0,0,0,8,5,52,22,0.0,600.0
10892,60f3232bc7a73b15,365fee2da473b177,473ce3aa581251a2,2011-03-26,1,2,0,900,5,4,36,17,10,26,2,1,24,12,2,2,8,5,641.6,135.0
10893,60f3232bc7a73b15,473ce3aa581251a2,365fee2da473b177,2011-03-26,0,3,0,900,1,0,13,1,13,0,0,0,0,0,3,1,10,1,0.0,258.4
10894,60d27c73e4a20318,28f3c2258a1d8874,baed16f18348908e,2011-03-26,0,4,0,900,6,3,85,28,68,17,2,2,15,8,14,13,54,20,145.6,443.5
10895,60d27c73e4a20318,baed16f18348908e,28f3c2258a1d8874,2011-03-26,0,0,0,900,7,3,80,15,66,14,6,6,8,7,32,27,34,8,199.5,298.4
10896,28f57f60a46654f6,51b1e2fd9872005b,7aa3d6964eff4877,2011-03-26,0,1,1,198,5,3,10,7,4,6,0,0,6,6,2,2,2,1,147.4,26.0
10897,28f57f60a46654f6,7aa3d6964eff4877,51b1e2fd9872005b,2011-03-26,0,0,0,198,0,0,7,2,7,0,0,0,0,0,0,0,7,2,0.0,50.599999999999994
10898,28b405fe1552ccad,73e09f837f3b5ecc,902ab9197b83d0db,2011-03-26,0,0,0,900,0,0,54,7,54,0,0,0,0,0,2,1,52,7,0.0,592.5
10899,28b405fe1552ccad,902ab9197b83d0db,73e09f837f3b5ecc,2011-03-26,0,0,0,900,11,4,101,18,71,30,12,8,18,12,22,16,49,6,307.5,531.0
10900,04d97700dbdaef5e,28f62d866c59c709,6fb1ba67bef41b37,2011-03-26,0,1,0,744,6,4,61,43,59,2,0,0,2,2,3,3,56,41,67.5,462.8
10901,04d97700dbdaef5e,6fb1ba67bef41b37,28f62d866c59c709,2011-03-26,0,1,1,744,3,0,91,30,84,7,7,7,0,0,18,14,66,30,11.2,660.5
10902,e595cb4bfc26193b,75e5fec9f72910ef,aa1952ec0b3dd8e1,2011-03-19,0,0,0,900,7,2,103,29,100,3,0,0,3,2,16,15,84,27,46.9,616.8
10903,e595cb4bfc26193b,aa1952ec0b3dd8e1,75e5fec9f72910ef,2011-03-19,0,0,0,900,6,1,120,30,110,10,5,5,5,5,12,12,98,25,111.2,664.1
10904,e1563825c36aad26,24b033b3daf1c9df,a08d909a5be6f410,2011-03-19,1,0,0,135,0,0,63,27,14,49,0,0,49,24,2,2,12,3,59.0,76.0
10905,e1563825c36aad26,a08d909a5be6f410,24b033b3daf1c9df,2011-03-19,0,0,0,135,2,0,7,2,7,0,0,0,0,0,0,0,7,2,0.0,76.0
10906,dd3ea525fe1898f1,78114b7199cef90c,fc9a9559a05f2704,2011-03-19,0,0,0,900,11,2,110,36,62,48,4,4,44,15,17,9,45,21,272.0,549.9
10907,dd3ea525fe1898f1,fc9a9559a05f2704,78114b7199cef90c,2011-03-19,0,0,0,900,3,1,71,8,68,3,0,0,3,1,6,3,62,7,44.1,525.0
10908,dc2a3aeac1441991,07f72a2a7591b409,140745cbbcb023ac,2011-03-19,1,0,0,757,3,3,113,50,62,51,8,8,43,31,22,17,40,19,380.5,287.0
10909,dc2a3aeac1441991,140745cbbcb023ac,07f72a2a7591b409,2011-03-19,0,0,0,757,0,0,40,6,40,0,0,0,0,0,8,3,32,6,0.0,371.5
10910,a8cf22bc7d05c0a1,91186547a7f3f758,f5990c11974d8e9c,2011-03-19,0,0,0,900,18,1,84,13,77,7,7,7,0,0,38,28,39,13,128.5,584.6
10911,a8cf22bc7d05c0a1,f5990c11974d8e9c,91186547a7f3f758,2011-03-19,0,1,0,900,3,1,73,12,72,1,1,1,0,0,28,23,44,12,3.4,716.5
10912,42e7cc48c31d8f29,64a50dad704d1d49,6bf5a7d3e081ade2,2011-03-19,0,0,0,900,2,2,151,26,151,0,0,0,0,0,34,20,117,26,0.0,837.8
10913,42e7cc48c31d8f29,6bf5a7d3e081ade2,64a50dad704d1d49,2011-03-19,0,0,0,900,1,1,188,34,180,8,2,1,6,3,62,37,118,31,17.2,872.0
10914,376beb49aadb06d6,a8e6a69796280f17,d0c29452d3272603,2011-03-19,0,0,0,900,3,3,78,41,52,26,0,0,26,20,7,6,45,21,392.7,462.0
10915,376beb49aadb06d6,d0c29452d3272603,a8e6a69796280f17,2011-03-19,0,2,0,900,6,2,38,7,38,0,0,0,0,0,5,3,33,7,0.0,388.3
10916,2a28ce0035468735,d1941565abf50b16,ece280745f8727b8,2011-03-19,1,2,0,735,1,1,131,30,122,9,0,0,9,8,20,13,102,22,109.1,499.0
10917,2a28ce0035468735,ece280745f8727b8,d1941565abf50b16,2011-03-19,0,0,0,735,3,1,130,14,129,1,0,0,1,1,16,12,113,13,30.0,565.9
10918,18b31990d1808419,2f13e4020cea5b38,99bd87a300079ed9,2011-03-19,0,0,0,152,0,0,20,3,20,0,0,0,0,0,8,6,12,3,0.0,152.0
10919,18b31990d1808419,99bd87a300079ed9,2f13e4020cea5b38,2011-03-19,1,0,0,152,0,0,18,2,18,0,0,0,0,0,2,2,16,2,0.0,150.0
10920,077667e3aaf314db,89a407032911e27e,c32fb8c0f6471a4d,2011-03-19,1,0,0,824,8,4,83,23,58,25,0,0,25,15,23,17,35,8,189.5,401.8
10921,077667e3aaf314db,c32fb8c0f6471a4d,89a407032911e27e,2011-03-19,0,0,0,824,0,0,39,12,38,1,0,0,1,1,13,9,25,11,5.2,524.5
10922,04193f1fff93ddb1,80eacd4da0617c57,eea0274e153256a0,2011-03-19,0,0,0,900,17,5,118,18,114,4,1,1,3,1,45,29,69,17,100.9,668.9
10923,04193f1fff93ddb1,eea0274e153256a0,80eacd4da0617c57,2011-03-19,0,0,0,900,1,0,90,32,87,3,0,0,3,2,14,13,73,30,4.1,784.1
10924,f06030bf27ebe337,b26d3e3746fb4024,c96e2ae6021144a1,2011-03-03,0,1,1,210,1,1,61,17,50,11,0,0,11,3,4,2,46,14,8.0,202.0
10925,f06030bf27ebe337,c96e2ae6021144a1,b26d3e3746fb4024,2011-03-03,0,0,0,210,0,0,49,8,49,0,0,0,0,0,12,9,37,8,0.0,184.0
10926,de2513c984996c8c,054defd5420a551f,aed06011bf62237b,2011-03-03,0,0,0,587,1,1,15,1,14,1,0,0,1,0,0,0,14,1,6.7,70.0
10927,de2513c984996c8c,aed06011bf62237b,054defd5420a551f,2011-03-03,1,2,0,587,1,1,71,46,14,57,7,7,50,42,4,4,10,4,497.0,83.3
10928,d59b40be94d5a609,4417980b3e798abf,48e093ea1f43a053,2011-03-03,0,0,0,900,2,0,143,43,142,1,0,0,1,1,25,24,117,42,3.0,675.6
10929,d59b40be94d5a609,48e093ea1f43a053,4417980b3e798abf,2011-03-03,0,0,0,900,4,4,92,20,81,11,3,2,8,6,29,21,52,14,164.4,643.0
10930,bbbb4c62c35f5390,79899ecf62020f6d,d1e7fc58d4225cdf,2011-03-03,0,4,0,900,6,2,45,9,44,1,0,0,1,1,6,3,38,8,44.6,530.3
10931,bbbb4c62c35f5390,d1e7fc58d4225cdf,79899ecf62020f6d,2011-03-03,0,0,0,900,11,5,103,30,88,15,9,9,6,6,16,16,72,24,146.7,542.4
10932,67afd8e69820ffa0,43563a32c3f10e95,f1f9e48a0d150757,2011-03-03,1,0,0,900,1,1,198,90,188,10,5,5,5,4,57,51,131,86,40.4,760.5
10933,67afd8e69820ffa0,f1f9e48a0d150757,43563a32c3f10e95,2011-03-03,0,0,0,900,7,1,105,6,103,2,0,0,2,1,33,22,70,5,42.5,774.6
10934,42536a8cf2eda678,82e7929bf6c2b689,8b69839f3555a67b,2011-03-03,0,0,0,900,15,1,202,41,202,0,0,0,0,0,16,10,186,41,0.0,802.0
10935,42536a8cf2eda678,8b69839f3555a67b,82e7929bf6c2b689,2011-03-03,1,0,0,900,0,0,200,72,200,0,0,0,0,0,8,5,192,72,0.0,878.0
10936,4186686dbd9957cd,3a8176e15b9887c1,7f955f71fa2ce7ac,2011-03-03,0,0,0,900,8,5,105,39,79,26,0,0,26,18,6,6,73,21,377.4,420.2
10937,4186686dbd9957cd,7f955f71fa2ce7ac,3a8176e15b9887c1,2011-03-03,0,0,0,900,0,0,71,11,68,3,0,0,3,2,21,16,47,9,0.8,519.6
10938,3ce9e07f51239edd,53278852bcd91e11,9b68bf67c5695185,2011-03-03,1,0,0,300,0,0,38,17,38,0,0,0,0,0,0,0,38,17,0.0,265.0
10939,3ce9e07f51239edd,9b68bf67c5695185,53278852bcd91e11,2011-03-03,0,0,0,300,3,0,23,6,23,0,0,0,0,0,9,9,14,6,0.0,174.0
10940,1fa6d636d283ac84,8ddf9c51c5fdea75,d2c55d1d2e67773b,2011-03-03,0,3,1,404,2,0,3,2,3,0,0,0,0,0,1,0,2,2,0.0,179.0
10941,1fa6d636d283ac84,d2c55d1d2e67773b,8ddf9c51c5fdea75,2011-03-03,0,0,0,404,1,1,23,2,16,7,2,1,5,2,3,3,13,0,199.0,205.0
10942,16b0e962beb6d15e,75e0d3cc2262b732,8a59d346dc976a10,2011-03-03,1,0,0,388,1,0,106,13,104,2,0,0,2,2,24,13,80,11,8.0,376.0
10943,16b0e962beb6d15e,8a59d346dc976a10,75e0d3cc2262b732,2011-03-03,0,0,0,388,1,1,70,13,70,0,0,0,0,0,16,9,54,13,0.0,351.0
10944,08602f790f09d949,179f1948dc234f1f,5d7bdab5e03e3216,2011-03-03,1,0,0,54,0,0,7,4,5,2,0,0,2,2,0,0,5,2,2.5,37.0
10945,08602f790f09d949,5d7bdab5e03e3216,179f1948dc234f1f,2011-03-03,0,0,0,54,1,1,5,0,4,1,1,1,0,0,2,1,2,0,12.0,39.5
10946,fec8b9760d6bb235,3c6976f8182d9527,f5431394fb284bb9,2011-02-26,0,2,1,267,2,1,9,4,3,6,0,0,6,4,0,0,3,0,57.0,35.0
10947,fec8b9760d6bb235,f5431394fb284bb9,3c6976f8182d9527,2011-02-26,0,0,0,267,4,1,6,6,0,6,0,0,6,6,0,0,0,0,175.0,35.0
10948,f825e17e7a1332cd,6f018c039b4d5d80,73c7cfa551289285,2011-02-26,0,0,0,900,11,4,72,29,33,39,7,5,32,21,14,13,19,8,380.0,211.3
10949,f825e17e7a1332cd,73c7cfa551289285,6f018c039b4d5d80,2011-02-26,0,1,0,900,3,2,29,9,25,4,0,0,4,3,4,3,21,6,45.7,303.0
10950,e4b5f0358ce7bad4,2adb11835acd815b,4b4753d19489297f,2011-02-26,0,0,0,165,0,0,13,6,9,4,0,0,4,4,2,2,7,2,9.0,88.0
10951,e4b5f0358ce7bad4,4b4753d19489297f,2adb11835acd815b,2011-02-26,0,1,1,165,4,1,13,7,6,7,0,0,7,4,0,0,6,3,68.0,88.0
10952,d5e7fe1f5035505c,32ba186f4b0e3267,91acd6910b802a9e,2011-02-26,1,1,0,900,8,4,61,17,46,15,1,1,14,8,18,14,28,9,243.2,446.0
10953,d5e7fe1f5035505c,91acd6910b802a9e,32ba186f4b0e3267,2011-02-26,0,5,0,900,0,0,66,13,66,0,0,0,0,0,18,11,48,13,0.0,565.8
10954,ae07b35f2797242e,7c35f869033901ae,b13da0b1a3aed3e7,2011-02-26,0,0,0,900,9,6,82,20,80,2,0,0,2,1,14,8,66,19,41.7,608.0
10955,ae07b35f2797242e,b13da0b1a3aed3e7,7c35f869033901ae,2011-02-26,0,0,0,900,1,0,125,13,125,0,0,0,0,0,43,28,82,13,0.0,854.3
10956,76e6177c401f2176,6c2030e0a143a94b,7339d340aa2889cb,2011-02-26,0,0,0,95,1,0,7,0,7,0,0,0,0,0,4,4,3,0,0.0,54.0
10957,76e6177c401f2176,7339d340aa2889cb,6c2030e0a143a94b,2011-02-26,0,1,1,95,1,1,10,2,9,1,0,0,1,1,2,2,7,1,0.0,95.0
10958,72372c31dee3cadc,4f732e58ed907eff,f34312c2ccfa0e00,2011-02-26,0,0,0,900,6,3,198,38,192,6,1,0,5,1,39,21,153,37,38.7,780.4
10959,72372c31dee3cadc,f34312c2ccfa0e00,4f732e58ed907eff,2011-02-26,0,0,0,900,1,1,151,21,150,1,0,0,1,1,23,17,127,20,3.6,829.3
10960,6ac1478baeddaae8,df05aa15b2d66f57,eef9b891edbd4604,2011-02-26,0,0,0,401,4,1,37,8,36,1,0,0,1,1,1,1,35,7,52.5,296.0
10961,6ac1478baeddaae8,eef9b891edbd4604,df05aa15b2d66f57,2011-02-26,1,0,0,401,0,0,43,14,43,0,0,0,0,0,2,0,41,14,0.0,346.5
10962,5b6796a9194d339b,02500fb9fd79a974,c23e3d4875340d8d,2011-02-26,0,0,0,48,0,0,6,1,6,0,0,0,0,0,1,1,5,1,0.0,39.0
10963,5b6796a9194d339b,c23e3d4875340d8d,02500fb9fd79a974,2011-02-26,0,1,1,48,0,0,11,4,11,0,0,0,0,0,0,0,11,4,0.0,48.0
10964,2dd864ec1a1a4031,5f87a5c00b3d17ed,896c322f56b8be5a,2011-02-26,2,0,0,900,0,0,226,40,223,3,0,0,3,3,45,34,178,37,4.8,881.0
10965,2dd864ec1a1a4031,896c322f56b8be5a,5f87a5c00b3d17ed,2011-02-26,0,0,0,900,13,0,204,28,204,0,0,0,0,0,28,10,176,28,0.0,887.2
10966,0f461c4ddf70eff9,2b93ebd9f5417ad2,cb46dface0e28a2c,2011-02-26,1,0,0,414,8,3,123,40,112,11,0,0,11,7,10,10,102,33,24.9,337.0
10967,0f461c4ddf70eff9,cb46dface0e28a2c,2b93ebd9f5417ad2,2011-02-26,0,0,0,414,0,0,53,6,53,0,0,0,0,0,5,2,48,6,0.0,389.1
10968,062816ff1b591bbb,2721bb808bb2523c,6b5b9be990774f0e,2011-02-26,0,0,0,900,7,4,58,13,45,13,1,0,12,3,8,5,37,10,404.6,402.0
10969,062816ff1b591bbb,6b5b9be990774f0e,2721bb808bb2523c,2011-02-26,0,0,0,900,0,0,67,19,67,0,0,0,0,0,12,11,55,19,0.0,495.4
10970,d2246624da1c4e38,d897897060f10a3a,fcffee71cff5530e,2011-02-05,0,0,0,900,2,1,104,21,104,0,0,0,0,0,15,12,89,21,0.0,575.0
10971,d2246624da1c4e38,fcffee71cff5530e,d897897060f10a3a,2011-02-05,0,0,0,900,7,5,155,28,124,31,2,2,29,12,33,20,91,16,304.0,547.0
10972,d1cda3a0c148b725,4f736494fc733095,d81ac739417d7f53,2011-02-05,0,2,0,900,5,0,76,8,74,2,0,0,2,1,22,13,52,7,71.3,652.8
10973,d1cda3a0c148b725,d81ac739417d7f53,4f736494fc733095,2011-02-05,0,0,0,900,5,3,76,16,70,6,0,0,6,2,15,9,55,14,33.2,723.7
10974,ce6f4d06fe5b51f3,33b2f68ef95252e0,9ddfb3369a3b0394,2011-02-05,0,0,0,900,0,0,188,61,188,0,0,0,0,0,13,12,175,61,0.0,900.0
10975,ce6f4d06fe5b51f3,9ddfb3369a3b0394,33b2f68ef95252e0,2011-02-05,0,0,0,900,0,0,135,9,135,0,0,0,0,0,15,1,120,9,0.0,899.0
10976,c1843fa8f113d321,744e098e065cfdbe,b959e8c7fd8390d2,2011-02-05,0,0,0,21,0,0,3,1,3,0,0,0,0,0,0,0,3,1,0.0,18.2
10977,c1843fa8f113d321,b959e8c7fd8390d2,744e098e065cfdbe,2011-02-05,1,0,0,21,0,0,13,5,9,4,0,0,4,2,4,4,5,3,2.8,14.0
10978,ae3ab5d1892153ef,9f842be1a5337be6,b5b684eac99ae0a3,2011-02-05,0,2,0,900,1,0,92,15,92,0,0,0,0,0,4,3,88,15,0.0,506.9
10979,ae3ab5d1892153ef,b5b684eac99ae0a3,9f842be1a5337be6,2011-02-05,0,0,0,900,10,4,123,39,97,26,1,1,25,16,20,16,77,23,361.1,525.0
10980,95f136c07f9834be,9b74de674c355425,ccba80d4820ef557,2011-02-05,1,0,0,402,1,0,61,31,59,2,0,0,2,1,7,6,52,30,23.3,204.0
10981,95f136c07f9834be,ccba80d4820ef557,9b74de674c355425,2011-02-05,0,0,0,402,6,0,49,10,49,0,0,0,0,0,11,7,38,10,0.0,311.7
10982,87c73e2086214b5c,0ee783aa00e468f0,1f454354805b6f75,2011-02-05,0,0,0,205,0,0,15,4,14,1,0,0,1,0,2,2,12,4,1.0,198.7
10983,87c73e2086214b5c,1f454354805b6f75,0ee783aa00e468f0,2011-02-05,1,0,0,205,0,0,10,4,8,2,0,0,2,2,2,2,6,2,3.3,199.0
10984,791b8b3a475487e9,236a37d96d476164,6e0273f9478be71e,2011-02-05,1,1,0,329,4,2,37,15,26,11,1,1,10,8,3,3,23,7,131.4,90.0
10985,791b8b3a475487e9,6e0273f9478be71e,236a37d96d476164,2011-02-05,0,0,0,329,0,0,36,3,36,0,0,0,0,0,14,9,22,3,0.0,184.6
10986,6b7033df94818cee,1d00756835ca67c9,aac5ac38148f0528,2011-02-05,0,1,1,528,4,3,74,14,62,12,3,3,9,6,25,20,37,8,140.7,317.0
10987,6b7033df94818cee,aac5ac38148f0528,1d00756835ca67c9,2011-02-05,0,2,0,528,0,0,75,16,73,2,0,0,2,0,11,6,62,16,0.0,387.3
10988,65ce293c20bd25e2,07f72a2a7591b409,c0ab242c40decc55,2011-02-05,0,3,1,560,2,2,42,4,29,13,8,8,5,2,9,8,20,2,262.0,298.0
10989,65ce293c20bd25e2,c0ab242c40decc55,07f72a2a7591b409,2011-02-05,0,0,0,560,2,0,24,3,24,0,0,0,0,0,3,2,21,3,0.0,298.0
10990,20aa994cd23074b9,4834ff149dc9542a,8a304bfd6bf04a57,2011-02-05,0,0,0,900,2,0,65,12,64,1,0,0,1,0,6,4,58,12,4.5,839.1
10991,20aa994cd23074b9,8a304bfd6bf04a57,4834ff149dc9542a,2011-02-05,0,0,0,900,15,10,102,17,99,3,1,1,2,2,28,20,71,15,33.9,669.5
10992,dc58af0c02a42743,282fa667ff9c51ed,eb29176b03dfa888,2011-01-22,0,0,0,900,1,0,53,10,52,1,0,0,1,1,13,12,39,9,0.2,312.6
10993,dc58af0c02a42743,eb29176b03dfa888,282fa667ff9c51ed,2011-01-22,0,1,0,900,1,1,165,62,80,85,2,2,83,45,15,12,65,17,584.4,239.8
10994,dbfac95047e7b33a,28f62d866c59c709,f1f37d667bcd0d27,2011-01-22,0,0,0,900,8,4,28,11,23,5,0,0,5,3,4,4,19,8,412.1,245.4
10995,dbfac95047e7b33a,f1f37d667bcd0d27,28f62d866c59c709,2011-01-22,0,0,0,900,1,1,50,16,35,15,2,2,13,12,8,5,27,4,77.6,399.9
10996,ba5b23e7ef308883,94527830000ab715,e0b74df14f52cd15,2011-01-22,0,2,0,900,11,3,58,18,34,24,4,4,20,15,26,18,8,3,371.2,334.7
10997,ba5b23e7ef308883,e0b74df14f52cd15,94527830000ab715,2011-01-22,0,0,0,900,1,1,31,7,24,7,2,2,5,5,7,6,17,2,101.3,311.8
10998,ab8b506dd2277da3,5f04e3d58d9ce982,7be63795363029e8,2011-01-22,0,1,1,573,0,0,75,15,72,3,0,0,3,3,20,18,52,12,36.3,351.7
10999,ab8b506dd2277da3,7be63795363029e8,5f04e3d58d9ce982,2011-01-22,0,0,0,573,9,2,72,12,65,7,1,1,6,3,6,3,59,9,100.3,364.7
11000,a60ba933a7ea898e,219a254e15d60135,ba280572acfba13f,2011-01-22,0,0,0,179,3,0,8,0,8,0,0,0,0,0,4,3,4,0,0.0,134.0
11001,a60ba933a7ea898e,ba280572acfba13f,219a254e15d60135,2011-01-22,2,0,0,179,0,0,27,11,21,6,0,0,6,5,6,5,15,6,12.0,165.0
11002,a245b4d0a7861fb8,322a56923b396b4d,eaea0fc7b76525a8,2011-01-22,0,0,1,202,1,1,4,2,1,3,0,0,3,2,0,0,1,0,185.0,17.0
11003,a245b4d0a7861fb8,eaea0fc7b76525a8,322a56923b396b4d,2011-01-22,0,0,0,202,1,0,1,0,1,0,0,0,0,0,1,1,0,0,0.0,17.0
11004,9a71dc94152a76ac,0a97691039c4bbfb,3c0437fbeda06962,2011-01-22,2,0,0,88,0,0,16,8,15,1,0,0,1,1,2,1,13,7,7.0,81.0
11005,9a71dc94152a76ac,3c0437fbeda06962,0a97691039c4bbfb,2011-01-22,0,0,0,88,1,0,32,4,32,0,0,0,0,0,9,8,23,4,0.0,81.0
11006,986bc0ce25dac848,98f6da59d765ec94,dc5a6b2fdb27e7dc,2011-01-22,0,0,0,900,9,3,35,6,10,25,18,18,7,5,2,2,8,1,708.7,163.0
11007,986bc0ce25dac848,dc5a6b2fdb27e7dc,98f6da59d765ec94,2011-01-22,0,0,0,900,1,0,20,5,17,3,0,0,3,1,8,5,9,4,0.0,191.29999999999995
11008,89cb6801b51f2216,901cddcbfa079097,b2e3aca4cd363477,2011-01-22,0,0,0,900,1,0,158,37,156,2,0,0,2,2,32,25,124,35,0.0,900.0
11009,89cb6801b51f2216,b2e3aca4cd363477,901cddcbfa079097,2011-01-22,0,0,0,900,4,0,173,48,173,0,0,0,0,0,23,19,150,48,0.0,867.0
11010,6963c65b49e47277,ccd1299e0345e0ce,e5c9de15bb58b1c6,2011-01-22,2,0,0,178,0,0,33,15,26,7,0,0,7,3,3,2,23,12,2.2,173.0
11011,6963c65b49e47277,e5c9de15bb58b1c6,ccd1299e0345e0ce,2011-01-22,0,0,0,178,6,1,10,0,10,0,0,0,0,0,4,2,6,0,0.0,117.8
11012,4abf375aa97364f6,46baf0f57edfa4df,658c3465581ae46b,2011-01-22,0,0,0,900,6,0,177,35,177,0,0,0,0,0,27,20,150,35,0.0,611.5
11013,4abf375aa97364f6,658c3465581ae46b,46baf0f57edfa4df,2011-01-22,1,0,0,900,0,0,90,14,88,2,2,2,0,0,32,30,56,14,26.5,847.0
11014,fbc7d73f7bf60b9c,0c6d9ea8306c029e,1652f3213655b935,2011-01-01,1,0,0,260,3,0,31,15,21,10,0,0,10,6,8,7,13,9,22.0,136.7
11015,fbc7d73f7bf60b9c,1652f3213655b935,0c6d9ea8306c029e,2011-01-01,1,1,0,260,0,0,16,6,8,8,1,1,7,6,4,4,4,0,79.3,129.0
11016,f327f8e59acfab1b,3be081c29bf734d9,c47df9303d318c67,2011-01-01,0,0,0,567,0,0,81,11,81,0,0,0,0,0,3,3,78,11,0.0,427.0
11017,f327f8e59acfab1b,c47df9303d318c67,3be081c29bf734d9,2011-01-01,0,2,1,567,9,3,61,10,59,2,1,1,1,0,3,1,56,10,108.0,459.0
11018,e7ace0544d5ab596,3414b50b08a10600,6f81b6de2557739a,2011-01-01,0,0,0,900,4,1,55,14,49,6,1,1,5,3,11,10,38,11,91.6,468.0
11019,e7ace0544d5ab596,6f81b6de2557739a,3414b50b08a10600,2011-01-01,0,2,0,900,2,1,47,3,44,3,2,2,1,1,8,5,36,2,264.0,544.4
11020,df42fd9af4740d24,18968f97ad34f15c,b7d524c77c27389b,2011-01-01,1,2,0,753,4,0,68,9,65,3,1,1,2,1,16,15,49,8,16.9,691.0
11021,df42fd9af4740d24,b7d524c77c27389b,18968f97ad34f15c,2011-01-01,0,0,0,753,4,2,76,13,76,0,0,0,0,0,8,4,68,13,0.0,473.1
11022,de7eec13356baebe,8355922d564b152c,9bcf8603ceb25680,2011-01-01,0,1,0,900,1,1,85,22,84,1,0,0,1,1,18,14,66,21,4.7,318.2
11023,de7eec13356baebe,9bcf8603ceb25680,8355922d564b152c,2011-01-01,0,0,0,900,7,3,46,9,32,14,1,1,13,4,11,9,21,5,464.8,397.3
11024,b13e3620949300c5,029eaff01e6bb8f0,60ba33c3f555a7a3,2011-01-01,0,0,0,900,0,0,148,55,136,12,2,2,10,5,26,20,110,50,59.9,406.1
11025,b13e3620949300c5,60ba33c3f555a7a3,029eaff01e6bb8f0,2011-01-01,0,2,0,900,9,2,43,7,41,2,0,0,2,1,16,9,25,6,24.9,678.1
11026,965989097794b22b,3a24769a4855040a,e0b74df14f52cd15,2011-01-01,0,0,0,900,1,0,111,27,109,2,0,0,2,1,47,38,62,26,7.2,656.5
11027,965989097794b22b,e0b74df14f52cd15,3a24769a4855040a,2011-01-01,0,0,0,900,16,4,117,26,92,25,15,15,10,8,35,27,57,18,113.5,597.8
11028,91bb64656e13a1d4,7d96bc577e5178b2,f2688492b9a525a3,2011-01-01,3,1,0,1500,17,3,212,62,196,16,0,0,16,8,14,9,182,54,81.8,1349.6
11029,91bb64656e13a1d4,f2688492b9a525a3,7d96bc577e5178b2,2011-01-01,0,2,0,1500,11,3,226,62,223,3,0,0,3,3,53,33,170,59,17.4,1331.2
11030,65b4d4be2d04bb34,2924886ee9c4c527,fa315e6c77eee106,2011-01-01,0,1,0,900,3,3,100,36,36,64,11,8,53,29,7,7,29,7,668.5,125.4
11031,65b4d4be2d04bb34,fa315e6c77eee106,2924886ee9c4c527,2011-01-01,0,0,0,900,0,0,44,5,43,1,0,0,1,0,22,14,21,5,1.6,207.5
11032,33c8395139de7551,22edaf53ad59a967,9c669abd35b2522f,2011-01-01,0,2,1,225,2,1,13,3,12,1,0,0,1,0,0,0,12,3,106.0,103.5
11033,33c8395139de7551,9c669abd35b2522f,22edaf53ad59a967,2011-01-01,0,1,0,225,0,0,13,5,11,2,1,1,1,1,1,0,10,4,15.5,88.0
11034,075be81e3f92c2bf,579fcdfcabd23a7b,d43a048a880efdff,2011-01-01,3,1,0,217,0,0,50,22,37,13,0,0,13,8,10,8,27,14,43.6,113.0
11035,075be81e3f92c2bf,d43a048a880efdff,579fcdfcabd23a7b,2011-01-01,0,0,0,217,2,0,25,2,25,0,0,0,0,0,9,5,16,2,0.0,165.4
11036,f0d86420d88ca27b,31ee470ef5dc8d7f,fc31f896cde2bc2e,2010-12-11,1,0,0,900,2,2,185,36,177,8,0,0,8,3,46,37,131,33,74.5,723.0
11037,f0d86420d88ca27b,fc31f896cde2bc2e,31ee470ef5dc8d7f,2010-12-11,0,0,0,900,2,0,124,15,124,0,0,0,0,0,35,22,89,15,0.0,772.5
11038,ed6a02c8dcc6f922,008dc37cca279def,ebc1f40e00e0c481,2010-12-11,0,2,0,235,1,1,9,4,1,8,0,0,8,4,0,0,1,0,186.0,33.0
11039,ed6a02c8dcc6f922,ebc1f40e00e0c481,008dc37cca279def,2010-12-11,1,0,0,235,0,0,19,11,4,15,0,0,15,10,0,0,4,1,16.0,33.0
11040,ecc80630494d402a,d0c29452d3272603,dbaaf42313af90fa,2010-12-11,0,1,0,900,5,5,47,17,17,30,0,0,30,16,2,1,15,1,715.0,120.8
11041,ecc80630494d402a,dbaaf42313af90fa,d0c29452d3272603,2010-12-11,0,2,0,900,0,0,29,9,19,10,0,0,10,5,3,3,16,4,64.2,108.0
11042,ecc41acbd699812a,79899ecf62020f6d,86f582852a5b240a,2010-12-11,0,0,0,114,0,0,19,4,19,0,0,0,0,0,2,2,17,4,0.0,113.5
11043,ecc41acbd699812a,86f582852a5b240a,79899ecf62020f6d,2010-12-11,1,0,0,114,0,0,23,7,22,1,0,0,1,1,4,2,18,6,0.5,113.0
11044,e87b5c403533b057,6506c1d34da9c013,dd37fd509af89f15,2010-12-11,0,0,0,1500,9,4,259,65,259,0,0,0,0,0,73,45,186,65,0.0,1204.4
11045,e87b5c403533b057,dd37fd509af89f15,6506c1d34da9c013,2010-12-11,0,0,0,1500,4,1,134,12,133,1,0,0,1,1,6,4,127,11,10.6,1426.0
11046,c4bbae7615545c85,196ed28337adc630,c21a036b4e012f1c,2010-12-11,0,0,0,900,2,1,162,9,162,0,0,0,0,0,26,10,136,9,0.0,884.6
11047,c4bbae7615545c85,c21a036b4e012f1c,196ed28337adc630,2010-12-11,1,0,0,900,0,0,127,42,124,3,1,0,2,1,49,32,75,41,11.4,881.0
11048,94a3e3df3d28d8f0,a149d6bc670cdb60,cf9d24e4bd0cf2ce,2010-12-11,0,0,0,153,0,0,3,0,3,0,0,0,0,0,0,0,3,0,0.0,13.0
11049,94a3e3df3d28d8f0,cf9d24e4bd0cf2ce,a149d6bc670cdb60,2010-12-11,0,1,1,153,1,1,18,7,4,14,2,2,12,7,0,0,4,0,108.0,45.0
11050,77785292d4df807c,07225ba28ae309b6,d1941565abf50b16,2010-12-11,0,0,0,119,1,0,8,2,6,2,2,2,0,0,1,1,5,2,0.0,28.0
11051,77785292d4df807c,d1941565abf50b16,07225ba28ae309b6,2010-12-11,0,2,1,119,1,1,6,1,4,2,0,0,2,1,0,0,4,0,91.0,28.0
11052,42a361f33cbb8d6f,91186547a7f3f758,a26198ba5093147e,2010-12-11,0,0,0,900,8,6,85,41,17,68,1,1,67,38,6,6,11,3,717.9,137.9
11053,42a361f33cbb8d6f,a26198ba5093147e,91186547a7f3f758,2010-12-11,0,0,0,900,1,0,18,2,14,4,1,1,3,1,3,3,11,1,23.1,130.10000000000002
11054,37d988593cb5f14a,0d506315895efffc,d023ae89a2a4a41e,2010-12-11,1,1,0,900,3,1,253,86,239,14,7,7,7,4,31,19,208,82,88.8,653.6
11055,37d988593cb5f14a,d023ae89a2a4a41e,0d506315895efffc,2010-12-11,0,1,0,900,2,0,258,31,253,5,0,0,5,3,10,4,243,28,24.4,767.2
11056,1de579eecc094c8b,0dba4df5f34d5ff0,934de214814b8ff4,2010-12-11,0,0,0,900,8,5,23,10,17,6,0,0,6,5,4,3,13,5,144.8,264.5
11057,1de579eecc094c8b,934de214814b8ff4,0dba4df5f34d5ff0,2010-12-11,0,0,0,900,6,2,81,38,36,45,2,2,43,32,14,13,22,6,273.5,439.2
11058,f5686732b85adafc,338a11d3674eb2d4,7be63795363029e8,2010-12-04,0,0,0,123,1,1,1,0,1,0,0,0,0,0,0,0,1,0,0.0,59.0
11059,f5686732b85adafc,7be63795363029e8,338a11d3674eb2d4,2010-12-04,0,2,1,123,1,1,2,0,2,0,0,0,0,0,0,0,2,0,0.0,71.0
11060,ee85a66d86490f83,8e893f269d5696b2,eea0274e153256a0,2010-12-04,0,0,0,900,0,0,78,10,77,1,0,0,1,1,17,11,60,9,0.0,570.7
11061,ee85a66d86490f83,eea0274e153256a0,8e893f269d5696b2,2010-12-04,2,0,0,900,0,0,112,39,87,25,0,0,25,10,9,5,78,29,329.3,518.0
11062,dee976dde74e7e05,234f3767ff0e5701,427b5953ac8e3a27,2010-12-04,0,0,0,900,0,0,68,17,67,1,0,0,1,1,2,1,65,16,0.0,429.4
11063,dee976dde74e7e05,427b5953ac8e3a27,234f3767ff0e5701,2010-12-04,0,1,0,900,13,5,79,29,42,37,10,10,27,19,5,3,37,10,470.6,404.0
11064,dca2a0eb4cd3deac,511e82663651438d,b0a6124751a56bc4,2010-12-04,1,0,0,900,1,0,62,24,57,5,0,0,5,2,7,6,50,22,20.6,303.4
11065,dca2a0eb4cd3deac,b0a6124751a56bc4,511e82663651438d,2010-12-04,0,0,0,900,13,3,67,32,34,33,0,0,33,23,0,0,34,9,522.6,293.4
11066,dca074896265f816,0941df56f6ac954b,5b5307450405abf0,2010-12-04,0,1,0,900,13,6,58,18,58,0,0,0,0,0,7,6,51,18,0.0,517.7
11067,dca074896265f816,5b5307450405abf0,0941df56f6ac954b,2010-12-04,0,1,0,900,5,2,125,20,124,1,1,1,0,0,45,34,79,20,5.3,729.0
11068,d2287a9cfb6b9b07,8cb76103cd8a1562,901cddcbfa079097,2010-12-04,0,1,1,873,9,7,44,6,43,1,0,0,1,1,13,12,30,5,242.5,194.0
11069,d2287a9cfb6b9b07,901cddcbfa079097,8cb76103cd8a1562,2010-12-04,0,0,0,873,2,1,51,12,42,9,0,0,9,4,4,4,38,8,194.0,436.5
11070,a2be3b3f9739d0af,53278852bcd91e11,c6a33ff198aaaeeb,2010-12-04,0,0,0,900,1,0,55,16,50,5,1,1,4,3,7,6,43,13,24.4,458.0
11071,a2be3b3f9739d0af,c6a33ff198aaaeeb,53278852bcd91e11,2010-12-04,0,1,0,900,5,3,80,19,54,26,10,7,16,11,20,18,34,8,359.0,157.6
11072,a1b035662f43aae2,9f7787e56a6bc0f4,d7b2c0b53883ee80,2010-12-04,0,0,0,900,1,0,132,26,132,0,0,0,0,0,10,10,122,26,0.0,722.0
11073,a1b035662f43aae2,d7b2c0b53883ee80,9f7787e56a6bc0f4,2010-12-04,0,0,0,900,12,0,135,28,135,0,0,0,0,0,49,44,86,28,0.0,753.0
11074,7206d0aa1d53e518,320edfb0332b7073,8e5bfd4e82352340,2010-12-04,0,0,0,51,0,0,1,0,1,0,0,0,0,0,1,1,0,0,0.0,50.0
11075,7206d0aa1d53e518,8e5bfd4e82352340,320edfb0332b7073,2010-12-04,1,0,0,51,0,0,7,2,6,1,0,0,1,1,1,1,5,1,1.0,50.0
11076,6e574bd614afffd9,80dbeb1dd5b53e64,917e53fa0adea0d3,2010-12-04,0,1,0,900,0,0,227,80,217,10,2,1,8,5,26,21,191,75,123.8,739.0
11077,6e574bd614afffd9,917e53fa0adea0d3,80dbeb1dd5b53e64,2010-12-04,0,0,0,900,3,2,282,40,282,0,0,0,0,0,38,24,244,40,0.0,720.2
11078,3d16f99de58b9d0e,210935fd21670f6d,d2c55d1d2e67773b,2010-12-04,0,0,0,900,0,0,15,2,14,1,0,0,1,0,4,4,10,2,4.7,677.5
11079,3d16f99de58b9d0e,d2c55d1d2e67773b,210935fd21670f6d,2010-12-04,0,0,0,900,10,4,27,2,22,5,1,1,4,1,13,13,9,1,194.5,156.3
11080,e76c3346ad9be24a,aac5ac38148f0528,d25b93992f285953,2010-11-20,1,0,0,496,1,1,104,37,68,36,0,0,36,25,11,7,57,12,164.8,301.8
11081,e76c3346ad9be24a,d25b93992f285953,aac5ac38148f0528,2010-11-20,0,0,0,496,1,1,69,17,63,6,0,0,6,4,22,15,41,13,20.2,304.2
11082,8d886fba9328269c,179f1948dc234f1f,d5f820c11a121050,2010-11-20,0,0,0,900,4,1,156,35,151,5,0,0,5,4,52,41,99,31,11.2,705.4
11083,8d886fba9328269c,d5f820c11a121050,179f1948dc234f1f,2010-11-20,0,0,0,900,11,5,118,21,115,3,1,1,2,1,27,21,88,20,17.6,694.8
11084,8b87b341bcd130ee,64a50dad704d1d49,e26882820f9e8df5,2010-11-20,2,0,0,626,2,2,69,16,68,1,0,0,1,0,31,27,37,16,156.0,314.0
11085,8b87b341bcd130ee,e26882820f9e8df5,64a50dad704d1d49,2010-11-20,0,1,0,626,5,0,45,9,45,0,0,0,0,0,9,3,36,9,0.0,460.0
11086,83ea3c36a6f91cb8,20205040232ed0f3,6fb1ba67bef41b37,2010-11-20,1,1,0,900,13,8,60,19,58,2,1,1,1,1,11,11,47,18,77.6,356.4
11087,83ea3c36a6f91cb8,6fb1ba67bef41b37,20205040232ed0f3,2010-11-20,0,3,0,900,8,4,59,19,51,8,0,0,8,3,15,15,36,16,116.6,618.4
11088,71bcafd04decc8ce,902ab9197b83d0db,c80095f6092271a7,2010-11-20,0,2,1,475,2,2,75,10,45,30,12,5,18,7,23,18,22,3,214.5,189.0
11089,71bcafd04decc8ce,c80095f6092271a7,902ab9197b83d0db,2010-11-20,0,1,0,475,0,0,19,3,19,0,0,0,0,0,7,4,12,3,0.0,253.5
11090,552973c278f08fbb,621a6c59f88a44fe,73c7cfa551289285,2010-11-20,0,0,0,21,0,0,6,2,6,0,0,0,0,0,1,1,5,2,0.0,18.0
11091,552973c278f08fbb,73c7cfa551289285,621a6c59f88a44fe,2010-11-20,1,0,0,21,0,0,9,7,6,3,0,0,3,3,0,0,6,4,3.0,18.0
11092,47b690fb54f2eaf9,f7a7f7118d4b01b6,ffc088e64fab57e9,2010-11-20,0,1,0,900,3,1,51,13,50,1,0,0,1,1,28,20,22,12,25.3,622.0
11093,47b690fb54f2eaf9,ffc088e64fab57e9,f7a7f7118d4b01b6,2010-11-20,0,0,0,900,1,1,49,9,49,0,0,0,0,0,8,7,41,9,0.0,733.7
11094,3e0301367e511512,3bad7ef643840f67,896c322f56b8be5a,2010-11-20,0,0,0,463,0,0,79,14,71,8,0,0,8,4,2,2,69,10,24.0,381.1
11095,3e0301367e511512,896c322f56b8be5a,3bad7ef643840f67,2010-11-20,0,2,1,463,11,3,70,13,68,2,1,1,1,1,8,5,60,12,36.9,236.0
11096,256aacb8cb2c4289,c4b81cdecd5d6abe,d58478ded5534695,2010-11-20,0,0,0,900,7,2,61,5,61,0,0,0,0,0,4,3,57,5,0.0,693.5
11097,256aacb8cb2c4289,d58478ded5534695,c4b81cdecd5d6abe,2010-11-20,1,3,0,900,1,1,45,18,31,14,1,1,13,10,7,6,24,8,148.5,656.0
11098,15cae38f1326adfb,31123249b0bbf52e,3dc3022232b79c7a,2010-11-20,0,1,0,431,1,1,21,4,17,4,3,3,1,1,10,6,7,3,87.2,138.7
11099,15cae38f1326adfb,3dc3022232b79c7a,31123249b0bbf52e,2010-11-20,0,2,1,431,3,3,44,15,22,22,2,1,20,11,10,9,12,4,183.3,143.8
11100,0ed093f6aaab94d3,349aaa3da11eb587,8a8a84b743ae7699,2010-11-20,0,0,0,107,0,0,6,2,6,0,0,0,0,0,0,0,6,2,0.0,47.5
11101,0ed093f6aaab94d3,8a8a84b743ae7699,349aaa3da11eb587,2010-11-20,1,0,0,107,0,0,14,6,11,3,0,0,3,2,4,4,7,4,1.5,102.0
11102,fdb7377a34603e47,a8e6a69796280f17,acff437707625fc7,2010-11-13,0,2,0,900,4,3,61,12,59,2,0,0,2,0,15,9,44,12,34.4,645.0
11103,fdb7377a34603e47,acff437707625fc7,a8e6a69796280f17,2010-11-13,0,0,0,900,9,1,83,23,82,1,0,0,1,1,3,2,79,22,83.0,616.6
11104,ebf204638524c377,93b9496275bbbf80,d23ccf4a6c221284,2010-11-13,0,2,0,226,0,0,10,2,9,1,0,0,1,0,2,1,7,2,0.0,28.0
11105,ebf204638524c377,d23ccf4a6c221284,93b9496275bbbf80,2010-11-13,1,0,0,226,2,2,42,17,12,30,0,0,30,14,1,1,11,3,198.0,28.0
11106,d87755257628de36,4f736494fc733095,baed16f18348908e,2010-11-13,0,1,1,141,0,0,4,1,4,0,0,0,0,0,1,1,3,1,0.0,57.7
11107,d87755257628de36,baed16f18348908e,4f736494fc733095,2010-11-13,0,0,0,141,2,2,8,1,6,2,1,1,1,1,3,1,3,0,59.3,52.0
11108,d2ce61c578e67067,771b60ff889661c8,a01e84abefd85ec0,2010-11-13,0,2,0,900,4,3,94,28,88,6,0,0,6,4,11,5,77,24,78.8,387.2
11109,d2ce61c578e67067,a01e84abefd85ec0,771b60ff889661c8,2010-11-13,0,2,0,900,4,3,98,24,65,33,9,9,24,16,22,17,43,8,315.8,333.2
11110,82ad4eb50b3d7bd0,1fcfc3709fe58151,2650e2f846a30f64,2010-11-13,0,0,0,900,5,0,126,25,126,0,0,0,0,0,16,9,110,25,0.0,691.3
11111,82ad4eb50b3d7bd0,2650e2f846a30f64,1fcfc3709fe58151,2010-11-13,0,0,0,900,0,0,209,27,207,2,0,0,2,2,81,63,126,25,4.7,853.0
11112,6a32cabbcd9b1e42,5f87a5c00b3d17ed,b45d6b73f4ca4467,2010-11-13,1,1,1,217,1,0,71,15,64,7,0,0,7,4,19,15,45,11,24.5,182.0
11113,6a32cabbcd9b1e42,b45d6b73f4ca4467,5f87a5c00b3d17ed,2010-11-13,0,0,0,217,0,0,44,2,44,0,0,0,0,0,17,11,27,2,0.0,192.5
11114,68b3222e977a6a11,5b407acfe0ef9b76,84ac950d4c1722dd,2010-11-13,2,0,0,900,5,2,110,30,96,14,0,0,14,8,39,30,57,22,138.2,661.7
11115,68b3222e977a6a11,84ac950d4c1722dd,5b407acfe0ef9b76,2010-11-13,0,0,0,900,4,0,231,49,230,1,0,0,1,1,78,50,152,48,1.3,698.8
11116,5e3f46e6f46d5a90,132f860d02953f4c,59583ff832fe9d68,2010-11-13,0,0,0,900,6,2,74,14,73,1,0,0,1,0,14,9,59,14,338.0,400.0
11117,5e3f46e6f46d5a90,59583ff832fe9d68,132f860d02953f4c,2010-11-13,0,3,0,900,1,0,114,35,94,20,1,1,19,13,24,21,70,22,162.0,319.0
11118,2a9755f4d43f3e2f,28ba5f27e473420c,ccdd90bd1fc7dab6,2010-11-13,0,0,0,140,3,0,10,1,10,0,0,0,0,0,7,5,3,1,0.0,103.6
11119,2a9755f4d43f3e2f,ccdd90bd1fc7dab6,28ba5f27e473420c,2010-11-13,1,0,0,140,2,2,33,19,10,23,0,0,23,16,1,0,9,3,36.4,102.0
11120,0a5d29e380f1e3e0,054defd5420a551f,7339d340aa2889cb,2010-11-13,0,0,0,393,1,0,30,13,26,4,0,0,4,3,3,3,23,10,32.0,110.0
11121,0a5d29e380f1e3e0,7339d340aa2889cb,054defd5420a551f,2010-11-13,0,2,1,393,4,3,38,14,12,26,7,7,19,12,4,4,8,2,203.0,119.0
11122,f817a161eb72e685,6c2030e0a143a94b,aed06011bf62237b,2010-10-23,0,0,0,900,1,0,130,32,130,0,0,0,0,0,48,42,82,32,0.0,820.7
11123,f817a161eb72e685,aed06011bf62237b,6c2030e0a143a94b,2010-10-23,0,0,0,900,5,3,98,36,96,2,1,1,1,1,15,14,81,35,42.3,773.0
11124,f7e5e9fdcbff28b3,22edaf53ad59a967,eaea0fc7b76525a8,2010-10-23,0,1,1,73,1,1,10,1,10,0,0,0,0,0,2,1,8,1,0.0,71.0
11125,f7e5e9fdcbff28b3,eaea0fc7b76525a8,22edaf53ad59a967,2010-10-23,0,0,0,73,1,0,3,0,3,0,0,0,0,0,0,0,3,0,0.0,56.0
11126,ec618a1214d4b171,2f732dd9210d301f,98b80a717b9bda17,2010-10-23,0,0,0,900,2,0,131,19,129,2,0,0,2,1,23,18,106,18,0.0,678.5
11127,ec618a1214d4b171,98b80a717b9bda17,2f732dd9210d301f,2010-10-23,0,0,0,900,3,3,134,33,113,21,3,1,18,5,12,7,101,28,221.5,668.0
11128,9c354bd6ea1bf25a,7691a80e6ca3e55b,d29b5c4f22c6357d,2010-10-23,1,0,0,108,1,1,31,18,2,29,0,0,29,18,0,0,2,0,42.0,66.0
11129,9c354bd6ea1bf25a,d29b5c4f22c6357d,7691a80e6ca3e55b,2010-10-23,0,0,0,108,0,0,2,0,2,0,0,0,0,0,0,0,2,0,0.0,66.0
11130,95ca100d6bf829b2,501b07aec9b8fc2d,9b74de674c355425,2010-10-23,0,0,0,900,2,1,295,58,295,0,0,0,0,0,60,49,235,58,0.0,873.0
11131,95ca100d6bf829b2,9b74de674c355425,501b07aec9b8fc2d,2010-10-23,0,0,0,900,3,0,296,88,296,0,0,0,0,0,68,52,228,88,0.0,900.0
11132,8f301d4eb8e97449,0ff11cc094e887bc,513c6f1715e547a8,2010-10-23,2,0,0,252,2,1,67,30,35,32,0,0,32,16,1,1,34,14,88.2,150.0
11133,8f301d4eb8e97449,513c6f1715e547a8,0ff11cc094e887bc,2010-10-23,0,0,0,252,3,1,19,7,19,0,0,0,0,0,3,2,16,7,0.0,86.8
11134,8787d56f59bfb4c3,270b89c00ef0c55c,89a407032911e27e,2010-10-23,0,1,0,900,2,0,110,21,110,0,0,0,0,0,21,16,89,21,0.0,899.5
11135,8787d56f59bfb4c3,89a407032911e27e,270b89c00ef0c55c,2010-10-23,1,0,0,900,1,0,199,50,198,1,0,0,1,1,8,3,190,49,0.5,893.0
11136,704e1351a64581ed,4d44f37107f01b9b,9fa3bd637edd9aa2,2010-10-23,0,3,0,900,6,5,75,33,31,44,8,8,36,25,8,8,23,8,625.6,113.6
11137,704e1351a64581ed,9fa3bd637edd9aa2,4d44f37107f01b9b,2010-10-23,0,0,0,900,0,0,22,5,17,5,0,0,5,2,4,1,13,3,4.4,266.4
11138,635763ab6b5f0bf0,30a09e43f15f1d75,82e7929bf6c2b689,2010-10-23,0,4,0,900,3,1,65,28,60,5,0,0,5,2,8,8,52,26,14.8,286.70000000000005
11139,635763ab6b5f0bf0,82e7929bf6c2b689,30a09e43f15f1d75,2010-10-23,0,0,0,900,8,2,112,33,44,68,16,9,52,30,6,6,38,3,521.3,333.2
11140,46c74829fb4c2dd5,523fa774700d7d3f,aae99701b21554e4,2010-10-23,0,1,1,681,4,2,165,34,148,17,0,0,17,11,40,26,108,23,48.4,602.3
11141,46c74829fb4c2dd5,aae99701b21554e4,523fa774700d7d3f,2010-10-23,1,0,0,681,3,1,103,27,99,4,0,0,4,2,14,9,85,25,21.7,594.6
11142,1a0b90c661fd603e,8b69839f3555a67b,fe435e440b5de0ff,2010-10-23,0,3,0,900,0,0,54,18,47,7,1,1,6,6,20,16,27,12,42.7,481.0
11143,1a0b90c661fd603e,fe435e440b5de0ff,8b69839f3555a67b,2010-10-23,0,0,0,900,15,4,46,9,44,2,0,0,2,2,21,16,23,7,224.0,409.3
11144,ab341b7bb01cdc89,2b93ebd9f5417ad2,b0550072e5f0afa7,2010-10-16,0,0,0,900,5,0,267,89,267,0,0,0,0,0,35,29,232,89,0.0,898.0
11145,ab341b7bb01cdc89,b0550072e5f0afa7,2b93ebd9f5417ad2,2010-10-16,0,0,0,900,1,0,177,35,177,0,0,0,0,0,20,15,157,35,0.0,900.0
11146,a829493aa8d25e3c,28f3c2258a1d8874,f5990c11974d8e9c,2010-10-16,0,0,0,900,2,0,99,13,99,0,0,0,0,0,9,5,90,13,0.0,526.8
11147,a829493aa8d25e3c,f5990c11974d8e9c,28f3c2258a1d8874,2010-10-16,0,1,0,900,13,5,97,37,68,29,1,1,28,23,14,8,54,14,324.2,464.0
11148,9f2e58bf880157b2,2a8502954f49e682,a7d687e6ecb30981,2010-10-16,0,0,0,703,7,5,103,36,76,27,2,1,25,11,13,10,63,25,311.9,280.0
11149,9f2e58bf880157b2,a7d687e6ecb30981,2a8502954f49e682,2010-10-16,0,6,1,703,1,0,99,46,91,8,5,5,3,3,16,16,75,43,88.0,270.1
11150,9984333d8933dd58,473ce3aa581251a2,f9f07bb5a43535ed,2010-10-16,0,0,0,267,0,0,41,5,41,0,0,0,0,0,11,4,30,5,0.0,264.0
11151,9984333d8933dd58,f9f07bb5a43535ed,473ce3aa581251a2,2010-10-16,1,0,0,267,0,0,59,10,57,2,0,0,2,2,23,16,34,8,3.0,264.0
11152,8c8d46d89bf899e8,1fb80f46d3c105d9,cac08b8685387ca5,2010-10-16,1,2,0,648,1,0,123,50,102,21,4,4,17,15,36,35,66,35,158.7,444.0
11153,8c8d46d89bf899e8,cac08b8685387ca5,1fb80f46d3c105d9,2010-10-16,0,0,0,648,1,0,99,20,99,0,0,0,0,0,37,29,62,20,0.0,418.3
11154,676f5091ce2c3c90,7b143a54451263d9,c11f50e9c1513ce9,2010-10-16,0,4,1,285,2,0,4,1,4,0,0,0,0,0,1,1,3,1,0.0,87.0
11155,676f5091ce2c3c90,c11f50e9c1513ce9,7b143a54451263d9,2010-10-16,0,0,0,285,0,0,10,1,8,2,2,2,0,0,0,0,8,1,198.0,87.0
11156,62d4a918256c83e8,2721bb808bb2523c,f34312c2ccfa0e00,2010-10-16,0,2,0,900,3,1,80,8,72,8,2,1,6,3,42,36,30,5,136.6,410.1
11157,62d4a918256c83e8,f34312c2ccfa0e00,2721bb808bb2523c,2010-10-16,0,2,0,900,6,1,93,14,82,11,1,1,10,8,62,53,20,6,28.9,637.4
11158,5014298453caf116,3c6976f8182d9527,43563a32c3f10e95,2010-10-16,1,3,1,461,3,2,56,23,36,20,2,2,18,12,8,3,28,11,196.8,156.0
11159,5014298453caf116,43563a32c3f10e95,3c6976f8182d9527,2010-10-16,0,0,0,461,1,0,22,6,22,0,0,0,0,0,8,5,14,6,0.0,254.2
11160,2037295b161c8269,56116a79e4deed06,852454c572675334,2010-10-16,0,0,0,900,5,3,40,17,10,30,2,2,28,15,6,4,4,2,680.9,151.0
11161,2037295b161c8269,852454c572675334,56116a79e4deed06,2010-10-16,0,0,0,900,1,0,28,3,28,0,0,0,0,0,14,9,14,3,0.0,173.10000000000002
11162,00ecb8ea731e64d6,1eacf73d6a0055dc,3236bf606fe9fa5b,2010-10-16,0,0,0,900,2,0,109,19,109,0,0,0,0,0,47,39,62,19,0.0,631.0
11163,00ecb8ea731e64d6,3236bf606fe9fa5b,1eacf73d6a0055dc,2010-10-16,0,0,0,900,3,2,75,7,75,0,0,0,0,0,25,15,50,7,0.0,831.0
11164,c22d25f1febd8d09,196ed28337adc630,8a59d346dc976a10,2010-09-25,0,0,0,227,0,0,8,1,8,0,0,0,0,0,2,2,6,1,0.0,44.0
11165,c22d25f1febd8d09,8a59d346dc976a10,196ed28337adc630,2010-09-25,0,1,1,227,2,2,11,5,3,8,2,2,6,4,0,0,3,1,178.0,49.0
11166,bd057764cb51f065,008dc37cca279def,eef9b891edbd4604,2010-09-25,0,2,1,63,2,0,4,0,4,0,0,0,0,0,0,0,4,0,0.0,29.0
11167,bd057764cb51f065,eef9b891edbd4604,008dc37cca279def,2010-09-25,0,0,0,63,1,1,8,2,7,1,0,0,1,1,0,0,7,1,34.0,29.0
11168,b30bb2ba5b68a180,28f62d866c59c709,6085ceb59087514b,2010-09-25,0,0,0,900,7,5,61,25,44,17,0,0,17,10,2,1,42,15,412.0,488.0
11169,b30bb2ba5b68a180,6085ceb59087514b,28f62d866c59c709,2010-09-25,0,0,0,900,0,0,71,6,66,5,0,0,5,2,23,17,43,4,0.0,488.0
11170,b2717e8f7e7a196f,46baf0f57edfa4df,ba280572acfba13f,2010-09-25,0,0,0,900,3,1,157,35,146,11,1,1,10,8,19,16,127,27,114.2,599.0
11171,b2717e8f7e7a196f,ba280572acfba13f,46baf0f57edfa4df,2010-09-25,0,0,0,900,0,0,152,61,152,0,0,0,0,0,17,15,135,61,0.0,785.8
11172,a8b22e990cba6144,60c72f7459827881,a26198ba5093147e,2010-09-25,0,1,0,900,0,0,42,5,35,7,2,2,5,2,12,5,23,3,79.1,457.3
11173,a8b22e990cba6144,a26198ba5093147e,60c72f7459827881,2010-09-25,0,1,0,900,6,4,33,9,20,13,3,2,10,7,10,6,10,2,250.7,280.9
11174,8e2e14693e04bf45,18968f97ad34f15c,ccd1299e0345e0ce,2010-09-25,1,0,0,900,2,0,155,18,154,1,0,0,1,0,72,44,82,18,2.0,898.0
11175,8e2e14693e04bf45,ccd1299e0345e0ce,18968f97ad34f15c,2010-09-25,0,0,0,900,1,0,168,42,168,0,0,0,0,0,36,31,132,42,0.0,898.0
11176,81b5e933186a685a,029880cdbf5ca089,e5c9de15bb58b1c6,2010-09-25,0,0,0,900,18,5,115,31,110,5,0,0,5,5,8,7,102,26,306.2,410.0
11177,81b5e933186a685a,e5c9de15bb58b1c6,029880cdbf5ca089,2010-09-25,0,7,0,900,0,0,164,65,164,0,0,0,0,0,15,10,149,65,0.0,559.8
11178,7e3679992f2c6ff6,73e09f837f3b5ecc,c0ab242c40decc55,2010-09-25,0,0,0,900,0,0,127,21,127,0,0,0,0,0,14,7,113,21,0.0,770.1
11179,7e3679992f2c6ff6,c0ab242c40decc55,73e09f837f3b5ecc,2010-09-25,0,0,0,900,16,5,127,30,107,20,3,2,17,9,10,10,97,21,123.9,677.0
11180,5b986cd7289a0884,86dfed7cc24a9fa7,91acd6910b802a9e,2010-09-25,0,0,0,900,1,0,298,64,298,0,0,0,0,0,72,60,226,64,0.0,900.0
11181,5b986cd7289a0884,91acd6910b802a9e,86dfed7cc24a9fa7,2010-09-25,0,0,0,900,0,0,297,133,297,0,0,0,0,0,21,20,276,133,0.0,900.0
11182,301b145c186635de,1ff9589f9065a9ed,c32fb8c0f6471a4d,2010-09-25,1,0,0,842,2,0,79,11,79,0,0,0,0,0,18,14,61,11,0.0,573.0
11183,301b145c186635de,c32fb8c0f6471a4d,1ff9589f9065a9ed,2010-09-25,0,0,0,842,0,0,69,12,69,0,0,0,0,0,8,7,61,12,0.0,842.0
11184,1733594124569598,5d7bdab5e03e3216,dbaaf42313af90fa,2010-09-25,0,2,1,133,0,0,2,0,2,0,0,0,0,0,1,1,1,0,0.0,125.0
11185,1733594124569598,dbaaf42313af90fa,5d7bdab5e03e3216,2010-09-25,0,0,0,133,2,0,1,0,1,0,0,0,0,0,1,1,0,0,0.0,36.0
11186,f1ffe3ba615ad7b9,0dba4df5f34d5ff0,210935fd21670f6d,2010-09-15,0,0,0,900,9,2,102,14,100,2,1,1,1,0,32,13,68,14,48.0,627.6
11187,f1ffe3ba615ad7b9,210935fd21670f6d,0dba4df5f34d5ff0,2010-09-15,1,0,0,900,1,0,80,15,61,19,1,1,18,9,12,9,49,6,176.4,657.0
11188,b972f998103731da,23459ee7e373b98f,b959e8c7fd8390d2,2010-09-15,0,0,0,900,2,0,239,65,231,8,1,0,7,3,35,23,196,62,4.3,797.6
11189,b972f998103731da,b959e8c7fd8390d2,23459ee7e373b98f,2010-09-15,0,0,0,900,13,9,219,48,215,4,1,1,3,1,43,30,172,47,87.4,611.7
11190,a4bc92bfe82d0547,8f2939f5fd9cca1e,8f3df4c579cfbb69,2010-09-15,0,7,0,900,7,6,58,32,8,50,3,3,47,28,3,2,5,4,592.7,196.8
11191,a4bc92bfe82d0547,8f3df4c579cfbb69,8f2939f5fd9cca1e,2010-09-15,0,6,0,900,3,2,18,9,11,7,1,1,6,5,6,3,5,4,51.2,212.29999999999995
11192,a24121c70f773fe2,07225ba28ae309b6,83fd97284f4bb4a4,2010-09-15,0,1,1,745,9,2,91,9,91,0,0,0,0,0,39,26,52,9,0.0,620.3
11193,a24121c70f773fe2,83fd97284f4bb4a4,07225ba28ae309b6,2010-09-15,0,0,0,745,1,0,76,10,72,4,0,0,4,2,8,3,64,8,60.7,578.0
11194,88ef809a0fde3900,3dc3022232b79c7a,e86bc32f5997a8f7,2010-09-15,1,0,0,67,0,0,27,15,8,19,0,0,19,11,2,2,6,4,10.0,57.0
11195,88ef809a0fde3900,e86bc32f5997a8f7,3dc3022232b79c7a,2010-09-15,0,0,0,67,0,0,7,1,7,0,0,0,0,0,1,0,6,1,0.0,57.0
11196,48db60440ead6f6d,8ddf9c51c5fdea75,a8e6a69796280f17,2010-09-15,0,1,0,208,1,0,6,1,6,0,0,0,0,0,0,0,6,1,0.0,164.0
11197,48db60440ead6f6d,a8e6a69796280f17,8ddf9c51c5fdea75,2010-09-15,1,1,0,208,0,0,35,12,20,15,0,0,15,9,2,1,18,3,17.0,191.0
11198,2f2ac4c08e763d38,679a9054e2815943,d2c55d1d2e67773b,2010-09-15,0,0,0,900,0,0,43,7,43,0,0,0,0,0,6,3,37,7,0.0,511.0
11199,2f2ac4c08e763d38,d2c55d1d2e67773b,679a9054e2815943,2010-09-15,0,0,0,900,10,3,31,8,23,8,3,2,5,4,9,5,14,4,306.0,441.0
11200,2aeba1cc4004d0bc,282fa667ff9c51ed,4f732e58ed907eff,2010-09-15,1,1,1,409,4,1,78,18,77,1,0,0,1,1,7,6,70,17,13.0,362.0
11201,2aeba1cc4004d0bc,4f732e58ed907eff,282fa667ff9c51ed,2010-09-15,0,0,0,409,0,0,71,10,69,2,0,0,2,1,17,16,52,9,8.0,376.0
11202,25137d9cc8b47f57,5f04e3d58d9ce982,a0c139b34f11421a,2010-09-15,0,1,0,900,1,1,125,42,70,55,2,2,53,28,13,10,57,14,435.5,417.0
11203,25137d9cc8b47f57,a0c139b34f11421a,5f04e3d58d9ce982,2010-09-15,0,2,0,900,6,0,82,5,82,0,0,0,0,0,15,10,67,5,0.0,415.5
11204,108140213049e629,75e5fec9f72910ef,d1941565abf50b16,2010-09-15,0,0,0,900,5,4,100,21,99,1,0,0,1,0,6,2,93,21,25.1,699.0
11205,108140213049e629,d1941565abf50b16,75e5fec9f72910ef,2010-09-15,0,2,0,900,6,0,113,13,113,0,0,0,0,0,28,16,85,13,0.0,749.9
11206,f484290346cfcf73,7d96bc577e5178b2,cb139171ed1b69fe,2010-08-28,0,0,0,900,7,5,53,12,33,20,2,2,18,9,2,1,31,3,380.0,501.0
11207,f484290346cfcf73,cb139171ed1b69fe,7d96bc577e5178b2,2010-08-28,0,0,0,900,0,0,63,7,62,1,0,0,1,1,13,7,49,6,0.0,520.0
11208,dacca5ea6be14d08,5b407acfe0ef9b76,9c669abd35b2522f,2010-08-28,0,1,0,900,1,0,67,21,62,5,0,0,5,5,11,8,51,16,10.6,291.29999999999995
11209,dacca5ea6be14d08,9c669abd35b2522f,5b407acfe0ef9b76,2010-08-28,0,1,0,900,7,3,100,44,40,60,15,14,45,36,13,12,27,8,551.7,227.4
11210,bec66de67818a9b1,0aa92558424ced9e,d10b35152277cf98,2010-08-28,0,2,1,199,1,1,11,7,0,11,1,1,10,7,0,0,0,0,182.0,17.0
11211,bec66de67818a9b1,d10b35152277cf98,0aa92558424ced9e,2010-08-28,0,0,0,199,0,0,0,0,0,0,0,0,0,0,0,0,0,0,0.0,17.0
11212,a5962421d687de8f,3bad7ef643840f67,ccba80d4820ef557,2010-08-28,0,1,1,121,3,2,28,19,7,21,0,0,21,15,0,0,7,4,84.9,28.0
11213,a5962421d687de8f,ccba80d4820ef557,3bad7ef643840f67,2010-08-28,0,0,0,121,0,0,8,1,8,0,0,0,0,0,1,0,7,1,0.0,36.099999999999994
11214,9443197a9e0a22a2,236a37d96d476164,dc5a6b2fdb27e7dc,2010-08-28,0,2,1,791,6,4,47,11,10,37,17,16,20,11,5,4,5,0,618.7,72.0
11215,9443197a9e0a22a2,dc5a6b2fdb27e7dc,236a37d96d476164,2010-08-28,0,0,0,791,0,0,10,3,7,3,0,0,3,3,3,1,4,0,0.0,172.29999999999995
11216,65290fc5216c2a73,6fb1ba67bef41b37,b45d6b73f4ca4467,2010-08-28,0,1,0,900,18,7,32,10,29,3,0,0,3,3,16,13,13,7,130.0,120.0
11217,65290fc5216c2a73,b45d6b73f4ca4467,6fb1ba67bef41b37,2010-08-28,0,0,0,900,0,0,35,11,35,0,0,0,0,0,10,9,25,11,0.0,745.0
11218,4bb7363bb03628f6,427b5953ac8e3a27,df2bf09c99594848,2010-08-28,0,1,0,900,7,5,49,21,24,25,4,4,21,17,9,5,15,4,448.5,248.6
11219,4bb7363bb03628f6,df2bf09c99594848,427b5953ac8e3a27,2010-08-28,0,0,0,900,0,0,41,5,30,11,2,1,9,3,12,8,18,2,59.4,370.5
11220,3d38022fdcb3b5c9,73c7cfa551289285,f2688492b9a525a3,2010-08-28,0,0,0,1500,3,2,146,29,145,1,0,0,1,1,14,7,131,28,17.0,1186.8
11221,3d38022fdcb3b5c9,f2688492b9a525a3,73c7cfa551289285,2010-08-28,0,0,0,1500,9,3,234,59,213,21,0,0,21,16,55,35,158,43,228.2,1081.0
11222,18cfc2f58d20c0f2,010986ee359fb863,d0c29452d3272603,2010-08-28,0,0,0,413,3,2,52,18,51,1,0,0,1,1,3,3,48,17,16.5,314.0
11223,18cfc2f58d20c0f2,d0c29452d3272603,010986ee359fb863,2010-08-28,0,2,1,413,1,0,74,17,74,0,0,0,0,0,7,6,67,17,0.0,388.5
11224,17a8fbfbe8d32258,8355922d564b152c,b7d524c77c27389b,2010-08-28,0,1,1,842,5,1,328,76,325,3,0,0,3,2,28,18,297,74,22.7,694.3
11225,17a8fbfbe8d32258,b7d524c77c27389b,8355922d564b152c,2010-08-28,1,0,0,842,1,1,203,36,199,4,0,0,4,1,22,16,177,35,3.7,807.3
11226,c92c53954903554a,31ee470ef5dc8d7f,6f018c039b4d5d80,2010-08-07,0,0,0,900,0,0,81,13,73,8,0,0,8,2,13,9,60,11,64.5,467.3
11227,c92c53954903554a,6f018c039b4d5d80,31ee470ef5dc8d7f,2010-08-07,0,0,0,900,11,9,66,15,50,16,7,5,9,6,11,9,39,9,311.7,348.5
11228,bcab3ebdc21b0b64,1f454354805b6f75,48d1f690b763934c,2010-08-07,0,3,1,1390,1,1,57,21,36,21,3,3,18,14,9,5,27,7,29.0,207.79999999999995
11229,bcab3ebdc21b0b64,48d1f690b763934c,1f454354805b6f75,2010-08-07,0,1,0,1390,7,3,168,68,52,116,21,16,95,56,5,5,47,12,1153.2,168.0
11230,951d11f8684ed734,484acc7b0f856ce9,8a8a84b743ae7699,2010-08-07,0,1,0,900,0,0,45,17,45,0,0,0,0,0,15,13,30,17,0.0,329.29999999999995
11231,951d11f8684ed734,8a8a84b743ae7699,484acc7b0f856ce9,2010-08-07,0,0,0,900,6,3,55,24,22,33,2,1,31,20,4,3,18,4,570.7,191.0
11232,57d481c10c842ba2,5b5307450405abf0,a149d6bc670cdb60,2010-08-07,1,0,0,375,3,3,110,45,67,43,6,6,37,26,28,24,39,19,165.6,67.0
11233,57d481c10c842ba2,a149d6bc670cdb60,5b5307450405abf0,2010-08-07,0,2,0,375,2,0,17,3,17,0,0,0,0,0,6,4,11,3,0.0,209.4
11234,55e12d44e9e524cf,80779d7441af1b52,ebc1f40e00e0c481,2010-08-07,0,1,0,322,1,1,72,33,18,54,3,3,51,28,0,0,18,5,274.8,29.0
11235,55e12d44e9e524cf,ebc1f40e00e0c481,80779d7441af1b52,2010-08-07,1,2,0,322,0,0,19,10,12,7,0,0,7,6,1,1,11,4,8.0,39.19999999999999
11236,3559cab3329e5431,6a2f7c151031653d,c47df9303d318c67,2010-08-07,0,0,0,711,4,1,64,11,63,1,0,0,1,1,13,6,50,10,12.8,512.2
11237,3559cab3329e5431,c47df9303d318c67,6a2f7c151031653d,2010-08-07,0,0,1,711,6,2,90,10,84,6,2,2,4,2,8,7,76,8,147.8,427.2
11238,2592954ad51764b0,0941df56f6ac954b,98f6da59d765ec94,2010-08-07,2,0,0,340,1,0,42,21,27,15,4,4,11,10,4,3,23,11,36.4,289.0
11239,2592954ad51764b0,98f6da59d765ec94,0941df56f6ac954b,2010-08-07,0,0,0,340,4,2,33,7,33,0,0,0,0,0,2,2,31,7,0.0,177.6
11240,241a307a9c3d9a21,3f7c14c7eca7195d,63def5a5662a6917,2010-08-07,0,0,0,900,7,0,101,38,101,0,0,0,0,0,2,2,99,38,0.0,809.1
11241,241a307a9c3d9a21,63def5a5662a6917,3f7c14c7eca7195d,2010-08-07,1,0,0,900,2,1,282,96,280,2,0,0,2,1,46,34,234,95,0.9,880.0
11242,10fd87a88178aedd,621a6c59f88a44fe,91186547a7f3f758,2010-08-07,1,1,1,195,0,0,16,1,16,0,0,0,0,0,2,1,14,1,0.0,182.0
11243,10fd87a88178aedd,91186547a7f3f758,621a6c59f88a44fe,2010-08-07,0,0,0,195,0,0,28,5,28,0,0,0,0,0,8,5,20,5,0.0,195.0
11244,10e35a0667d39086,902ab9197b83d0db,b9415726dc3ec526,2010-08-07,0,0,0,900,4,3,92,40,28,64,14,10,50,35,10,9,18,5,616.6,216.0
11245,10e35a0667d39086,b9415726dc3ec526,902ab9197b83d0db,2010-08-07,0,0,0,900,5,0,9,1,9,0,0,0,0,0,2,1,7,1,0.0,283.4
11246,0072df705378477c,9b68bf67c5695185,c80095f6092271a7,2010-08-07,0,0,0,900,0,0,72,8,72,0,0,0,0,0,26,20,46,8,0.0,684.2
11247,0072df705378477c,c80095f6092271a7,9b68bf67c5695185,2010-08-07,0,1,0,900,6,3,112,35,98,14,3,3,11,7,28,22,70,28,84.8,676.0
11248,db1c5b5a710fbdb0,07225ba28ae309b6,92a9aa9c93192871,2010-08-01,0,2,1,41,0,0,4,2,1,3,0,0,3,2,1,1,0,0,0.0,41.0
11249,db1c5b5a710fbdb0,92a9aa9c93192871,07225ba28ae309b6,2010-08-01,0,0,0,41,1,1,4,0,4,0,0,0,0,0,0,0,4,0,0.0,14.0
11250,c0dc7511452ed0f8,d81ac739417d7f53,fc31f896cde2bc2e,2010-08-01,1,0,0,741,7,5,67,22,39,28,0,0,28,15,19,16,20,7,324.1,195.0
11251,c0dc7511452ed0f8,fc31f896cde2bc2e,d81ac739417d7f53,2010-08-01,0,1,0,741,1,0,34,9,31,3,0,0,3,1,8,8,23,8,2.0,406.9
11252,a3902e22c10725c4,579fcdfcabd23a7b,5b2d7906aa894274,2010-08-01,0,2,1,790,0,0,72,26,33,39,11,11,28,20,7,6,26,6,238.5,203.5
11253,a3902e22c10725c4,5b2d7906aa894274,579fcdfcabd23a7b,2010-08-01,0,2,0,790,9,5,11,3,8,3,0,0,3,3,2,2,6,0,268.5,193.5
11254,a01524699dfa3526,20205040232ed0f3,3be081c29bf734d9,2010-08-01,0,0,0,64,0,0,14,2,14,0,0,0,0,0,1,1,13,2,0.0,60.0
11255,a01524699dfa3526,3be081c29bf734d9,20205040232ed0f3,2010-08-01,1,0,0,64,0,0,15,3,13,2,0,0,2,2,3,2,10,1,4.0,60.0
11256,92dea6ff8f0c1b10,054defd5420a551f,0b5b6876c2a4723f,2010-08-01,0,2,0,900,8,4,65,20,52,13,1,1,12,10,25,17,27,10,123.7,491.0
11257,92dea6ff8f0c1b10,0b5b6876c2a4723f,054defd5420a551f,2010-08-01,0,0,0,900,1,0,129,16,129,0,0,0,0,0,81,69,48,16,0.0,473.3
11258,860954fbe26b867a,322a56923b396b4d,d023ae89a2a4a41e,2010-08-01,0,0,0,569,2,0,27,5,21,6,0,0,6,3,4,4,17,2,31.3,141.10000000000002
11259,860954fbe26b867a,d023ae89a2a4a41e,322a56923b396b4d,2010-08-01,1,0,0,569,4,3,83,37,14,69,2,2,67,31,3,3,11,6,380.9,134.7
11260,7949430ebc47f31b,07f72a2a7591b409,ccdd90bd1fc7dab6,2010-08-01,1,0,0,112,1,1,16,12,4,12,0,0,12,12,4,3,0,0,54.0,58.0
11261,7949430ebc47f31b,ccdd90bd1fc7dab6,07f72a2a7591b409,2010-08-01,0,0,0,112,0,0,5,0,5,0,0,0,0,0,0,0,5,0,0.0,58.0
11262,743f9df5bdfbcb95,179f1948dc234f1f,acff437707625fc7,2010-08-01,1,0,0,900,15,1,44,13,41,3,0,0,3,0,3,3,38,13,29.3,585.5
11263,743f9df5bdfbcb95,acff437707625fc7,179f1948dc234f1f,2010-08-01,1,0,0,900,1,1,83,16,77,6,1,1,5,2,5,5,72,14,226.5,568.7
11264,71cb15f6dbdaccd8,6f81b6de2557739a,aac5ac38148f0528,2010-08-01,0,2,0,900,7,6,79,25,30,49,1,1,48,23,8,6,22,2,462.6,234.3
11265,71cb15f6dbdaccd8,aac5ac38148f0528,6f81b6de2557739a,2010-08-01,0,2,0,900,0,0,61,19,37,24,2,2,22,13,5,3,32,6,193.7,203.39999999999998
11266,26800d759ba50371,53278852bcd91e11,a7f4d0902bb64092,2010-08-01,0,1,1,149,3,2,27,18,19,8,0,0,8,6,0,0,19,12,49.6,28.299999999999997
11267,26800d759ba50371,a7f4d0902bb64092,53278852bcd91e11,2010-08-01,0,0,0,149,1,0,22,11,6,16,0,0,16,10,0,0,6,1,58.7,33.4
11268,d9c61052035c9b69,513c6f1715e547a8,68dd7b3783c19f9c,2010-07-03,0,1,1,439,4,1,15,2,10,5,4,4,1,1,2,2,8,1,96.2,154.1
11269,d9c61052035c9b69,68dd7b3783c19f9c,513c6f1715e547a8,2010-07-03,1,0,0,439,0,0,85,39,28,57,0,0,57,31,1,1,27,8,130.9,179.8
11270,bb7df9a9c9a69914,22edaf53ad59a967,e86bc32f5997a8f7,2010-07-03,0,2,0,900,9,6,44,4,40,4,0,0,4,2,2,1,38,2,346.4,461.4
11271,bb7df9a9c9a69914,e86bc32f5997a8f7,22edaf53ad59a967,2010-07-03,0,0,0,900,1,1,69,6,68,1,0,0,1,1,19,15,49,5,5.6,497.6
11272,b5608e83faac1387,896c322f56b8be5a,aa1952ec0b3dd8e1,2010-07-03,1,0,0,900,2,1,162,46,147,15,0,0,15,13,10,2,137,33,205.0,521.6
11273,b5608e83faac1387,aa1952ec0b3dd8e1,896c322f56b8be5a,2010-07-03,1,0,0,900,3,3,108,33,98,10,0,0,10,4,10,6,88,29,91.4,503.0
11274,6e62908d6639dcdb,7691a80e6ca3e55b,d23ccf4a6c221284,2010-07-03,0,0,0,900,4,3,53,14,45,8,1,1,7,6,25,22,20,8,124.0,311.0
11275,6e62908d6639dcdb,d23ccf4a6c221284,7691a80e6ca3e55b,2010-07-03,0,1,0,900,3,0,42,2,42,0,0,0,0,0,17,14,25,2,0.0,765.0
11276,536c26ef4da9ace7,59583ff832fe9d68,c6a33ff198aaaeeb,2010-07-03,0,0,0,488,2,0,90,27,90,0,0,0,0,0,8,5,82,27,0.0,367.2
11277,536c26ef4da9ace7,c6a33ff198aaaeeb,59583ff832fe9d68,2010-07-03,1,0,0,488,4,2,112,39,96,16,0,0,16,11,15,9,81,28,50.8,291.0
11278,4c5a2a3cf2bea222,31123249b0bbf52e,91acd6910b802a9e,2010-07-03,1,1,0,422,2,1,42,14,41,1,0,0,1,0,16,11,25,14,11.2,321.0
11279,4c5a2a3cf2bea222,91acd6910b802a9e,31123249b0bbf52e,2010-07-03,0,4,1,422,1,0,49,12,49,0,0,0,0,0,10,7,39,12,0.0,264.8
11280,458e6de1b9ef3500,c4b81cdecd5d6abe,d2c55d1d2e67773b,2010-07-03,1,0,0,755,5,5,37,10,31,6,0,0,6,3,0,0,31,7,192.0,467.0
11281,458e6de1b9ef3500,d2c55d1d2e67773b,c4b81cdecd5d6abe,2010-07-03,0,0,0,755,2,0,39,10,39,0,0,0,0,0,11,10,28,10,0.0,475.0
11282,20d28c177a7d43a4,744e098e065cfdbe,93b9496275bbbf80,2010-07-03,0,2,1,485,7,1,30,13,15,15,5,5,10,8,1,1,14,5,224.1,199.5
11283,20d28c177a7d43a4,93b9496275bbbf80,744e098e065cfdbe,2010-07-03,1,2,0,485,1,0,62,26,43,19,0,0,19,11,5,4,38,15,46.5,189.9
11284,16cab4b91e2c8881,132f860d02953f4c,234f3767ff0e5701,2010-07-03,0,1,0,900,5,3,56,2,47,9,3,2,6,0,16,10,31,2,259.7,488.0
11285,16cab4b91e2c8881,234f3767ff0e5701,132f860d02953f4c,2010-07-03,0,1,0,900,1,1,89,17,81,8,2,1,6,3,12,10,69,14,8.0,613.3
11286,07ba406a1d0a5a71,89a407032911e27e,df05aa15b2d66f57,2010-07-03,1,0,0,67,0,0,12,10,6,6,0,0,6,6,0,0,6,4,5.2,60.0
11287,07ba406a1d0a5a71,df05aa15b2d66f57,89a407032911e27e,2010-07-03,0,0,0,67,0,0,5,0,5,0,0,0,0,0,1,1,4,0,0.0,61.8
11288,049659c5a58ebb61,b0550072e5f0afa7,d43a048a880efdff,2010-07-03,0,1,0,880,5,5,68,24,59,9,0,0,9,5,5,3,54,19,355.2,357.1
11289,049659c5a58ebb61,d43a048a880efdff,b0550072e5f0afa7,2010-07-03,0,4,1,880,0,0,105,31,99,6,0,0,6,5,27,15,72,26,9.9,501.8
11290,c3e49cc87bd262c8,1f77fce698e80488,6c2030e0a143a94b,2010-06-19,0,1,0,900,4,2,95,21,90,5,0,0,5,2,11,8,79,19,18.3,757.0
11291,c3e49cc87bd262c8,6c2030e0a143a94b,1f77fce698e80488,2010-06-19,0,0,0,900,5,0,111,17,111,0,0,0,0,0,57,45,54,17,0.0,657.7
11292,a9da6a31229b136c,3236bf606fe9fa5b,cac08b8685387ca5,2010-06-19,1,1,0,272,0,0,44,18,17,27,0,0,27,16,4,1,13,2,141.0,131.0
11293,a9da6a31229b136c,cac08b8685387ca5,3236bf606fe9fa5b,2010-06-19,0,0,0,272,0,0,11,2,11,0,0,0,0,0,7,4,4,2,0.0,131.0
11294,a754766050409638,d43a048a880efdff,d5f820c11a121050,2010-06-19,1,0,0,557,0,0,92,31,88,4,0,0,4,4,18,11,70,27,5.9,465.0
11295,a754766050409638,d5f820c11a121050,d43a048a880efdff,2010-06-19,0,1,0,557,10,2,78,28,72,6,0,0,6,4,19,15,53,24,48.0,327.1
11296,9b38456520395242,5f87a5c00b3d17ed,f34312c2ccfa0e00,2010-06-19,0,0,0,900,0,0,256,31,256,0,0,0,0,0,67,46,189,31,0.0,899.0
11297,9b38456520395242,f34312c2ccfa0e00,5f87a5c00b3d17ed,2010-06-19,0,0,0,900,0,0,142,21,142,0,0,0,0,0,45,31,97,21,0.0,900.0
11298,8c082a3c69e2d192,523fa774700d7d3f,baed16f18348908e,2010-06-19,0,1,1,521,7,5,59,16,50,9,0,0,9,7,8,6,42,9,132.5,197.0
11299,8c082a3c69e2d192,baed16f18348908e,523fa774700d7d3f,2010-06-19,0,0,0,521,0,0,66,11,66,0,0,0,0,0,13,8,53,11,0.0,388.5
11300,76ca3d1cefd6945a,a0c139b34f11421a,c11f50e9c1513ce9,2010-06-19,0,0,0,900,8,4,59,24,23,36,4,4,32,18,4,3,19,6,710.5,150.0
11301,76ca3d1cefd6945a,c11f50e9c1513ce9,a0c139b34f11421a,2010-06-19,0,3,0,900,1,1,16,0,16,0,0,0,0,0,3,2,13,0,0.0,133.5
11302,3eb829eb77256ac0,0c6d9ea8306c029e,fd5b6598a3b70c0a,2010-06-19,0,0,0,900,6,3,34,13,19,15,2,2,13,9,3,3,16,4,577.5,154.0
11303,3eb829eb77256ac0,fd5b6598a3b70c0a,0c6d9ea8306c029e,2010-06-19,0,3,0,900,2,0,44,16,31,13,1,1,12,8,11,5,20,8,53.0,216.5
11304,3657196c2f624138,01f022fa494188e2,7339d340aa2889cb,2010-06-19,0,0,0,492,2,0,45,7,45,0,0,0,0,0,7,2,38,7,0.0,489.1
11305,3657196c2f624138,7339d340aa2889cb,01f022fa494188e2,2010-06-19,1,0,0,492,0,0,88,28,80,8,0,0,8,3,26,22,54,25,2.9,487.0
11306,256c9a39386f94a9,210935fd21670f6d,85248da6e9e2f7e7,2010-06-19,1,0,0,565,3,1,65,21,50,15,0,0,15,11,5,3,45,10,108.8,449.0
11307,256c9a39386f94a9,85248da6e9e2f7e7,210935fd21670f6d,2010-06-19,0,0,0,565,1,0,74,17,73,1,0,0,1,1,17,12,56,16,0.0,456.2
11308,13fa791f0772250c,98b80a717b9bda17,b9d0fd83bb8a147a,2010-06-19,0,0,0,900,9,2,199,67,199,0,0,0,0,0,14,10,185,67,0.0,809.0
11309,13fa791f0772250c,b9d0fd83bb8a147a,98b80a717b9bda17,2010-06-19,0,0,0,900,0,0,227,45,227,0,0,0,0,0,27,20,200,45,0.0,900.0
11310,fcac56089f65d04e,3ae10ac4df3df05c,f5990c11974d8e9c,2010-06-12,0,0,0,884,1,1,120,14,111,9,1,1,8,2,40,22,71,12,81.6,638.6
11311,fcac56089f65d04e,f5990c11974d8e9c,3ae10ac4df3df05c,2010-06-12,1,3,1,884,5,0,122,34,111,11,0,0,11,6,17,15,94,28,109.4,633.4
11312,e7cb3f5cb39c33e6,1fcfc3709fe58151,852454c572675334,2010-06-12,0,2,0,900,6,1,57,8,55,2,0,0,2,1,13,7,42,7,54.1,341.0
11313,e7cb3f5cb39c33e6,852454c572675334,1fcfc3709fe58151,2010-06-12,0,1,0,900,5,1,80,21,68,12,2,2,10,6,17,15,51,15,72.0,647.9
11314,dd7920cac66bed25,bd58d34e39b7b12a,d29b5c4f22c6357d,2010-06-12,0,2,0,900,7,5,72,32,18,54,12,10,42,25,2,2,16,7,621.0,96.2
11315,dd7920cac66bed25,d29b5c4f22c6357d,bd58d34e39b7b12a,2010-06-12,0,2,0,900,1,0,61,30,25,36,0,0,36,23,5,3,20,7,67.8,183.0
11316,c40fd062610d4e61,86f582852a5b240a,eb29176b03dfa888,2010-06-12,0,0,0,105,1,1,8,3,5,3,0,0,3,1,2,1,3,2,57.0,24.0
11317,c40fd062610d4e61,eb29176b03dfa888,86f582852a5b240a,2010-06-12,0,2,1,105,0,0,12,1,11,1,0,0,1,1,5,3,6,0,24.0,24.0
11318,ab7934f39038ab27,56116a79e4deed06,e9e1acc96536bb4f,2010-06-12,0,2,1,408,2,1,18,11,6,12,0,0,12,10,2,2,4,1,194.8,99.0
11319,ab7934f39038ab27,e9e1acc96536bb4f,56116a79e4deed06,2010-06-12,0,0,0,408,2,0,5,1,4,1,0,0,1,1,4,4,0,0,33.0,114.19999999999999
11320,9ae6a6f0f0730fa1,658c3465581ae46b,c32fb8c0f6471a4d,2010-06-12,2,0,0,870,0,0,66,11,66,0,0,0,0,0,21,14,45,11,0.0,809.8
11321,9ae6a6f0f0730fa1,c32fb8c0f6471a4d,658c3465581ae46b,2010-06-12,1,2,1,870,1,0,100,26,96,4,1,1,3,3,19,15,77,23,56.2,603.0
11322,8c3179f0fd62af14,a390eb8a9b2df298,d897897060f10a3a,2010-06-12,0,0,0,295,1,1,41,12,40,1,0,0,1,1,6,5,34,11,5.8,264.3
11323,8c3179f0fd62af14,d897897060f10a3a,a390eb8a9b2df298,2010-06-12,1,0,0,295,0,0,52,14,50,2,0,0,2,2,12,10,38,12,1.7,284.2
11324,72d69e969eda8679,20205040232ed0f3,e5c9de15bb58b1c6,2010-06-12,0,1,0,900,2,0,70,10,70,0,0,0,0,0,26,16,44,10,0.0,792.8
11325,72d69e969eda8679,e5c9de15bb58b1c6,20205040232ed0f3,2010-06-12,0,1,0,900,6,3,73,17,72,1,0,0,1,0,12,11,60,17,89.2,365.0
11326,37e2f89510cc0bba,22e47b53e4ceb27c,df2bf09c99594848,2010-06-12,0,0,0,547,0,0,10,1,10,0,0,0,0,0,2,1,8,1,0.0,111.60000000000002
11327,37e2f89510cc0bba,df2bf09c99594848,22e47b53e4ceb27c,2010-06-12,1,0,0,547,3,3,63,35,11,52,3,2,49,34,6,5,5,1,395.4,106.0
11328,11774c581b818e30,30a09e43f15f1d75,8b69839f3555a67b,2010-06-12,0,1,0,900,9,1,40,8,38,2,0,0,2,2,6,5,32,6,26.6,555.6
11329,11774c581b818e30,8b69839f3555a67b,30a09e43f15f1d75,2010-06-12,0,3,0,900,3,1,59,19,50,9,0,0,9,5,12,5,38,14,251.4,454.4
11330,0031c043c9f14eb8,cbd5d3cdd862e90e,f9f07bb5a43535ed,2010-06-12,0,0,0,893,8,3,70,22,64,6,1,0,5,2,9,7,55,20,80.5,503.9
11331,0031c043c9f14eb8,f9f07bb5a43535ed,cbd5d3cdd862e90e,2010-06-12,1,1,0,893,2,0,170,43,125,45,4,4,41,25,42,25,83,18,161.1,565.5
11332,f89589236dc3cbd7,2b93ebd9f5417ad2,d0c29452d3272603,2010-05-29,0,0,0,900,0,0,225,75,225,0,0,0,0,0,1,1,224,75,0.0,900.0
11333,f89589236dc3cbd7,d0c29452d3272603,2b93ebd9f5417ad2,2010-05-29,0,0,0,900,4,1,211,21,211,0,0,0,0,0,59,29,152,21,0.0,855.0
11334,96f51af6a93b94c6,2650e2f846a30f64,9bcf8603ceb25680,2010-05-29,0,0,0,900,0,0,38,7,36,2,0,0,2,0,7,3,29,7,2.6,240.89999999999998
11335,96f51af6a93b94c6,9bcf8603ceb25680,2650e2f846a30f64,2010-05-29,0,0,0,900,8,6,40,26,12,28,0,0,28,21,4,4,8,5,650.1,154.4
11336,8ba089858a7d647b,24b033b3daf1c9df,43563a32c3f10e95,2010-05-29,1,0,0,133,2,0,16,3,15,1,0,0,1,0,1,1,14,3,32.5,61.3
11337,8ba089858a7d647b,43563a32c3f10e95,24b033b3daf1c9df,2010-05-29,1,0,0,133,0,0,21,13,19,2,0,0,2,2,4,4,15,11,6.7,90.5
11338,7f35ce1469dab556,28f3c2258a1d8874,82e7929bf6c2b689,2010-05-29,1,0,0,900,2,0,174,63,141,33,7,7,26,14,20,14,121,49,183.9,666.0
11339,7f35ce1469dab556,82e7929bf6c2b689,28f3c2258a1d8874,2010-05-29,0,0,0,900,8,1,90,22,90,0,0,0,0,0,3,2,87,22,0.0,591.1
11340,655a110a0bd2ea42,28f62d866c59c709,ccd1299e0345e0ce,2010-05-29,0,0,0,208,6,1,6,1,6,0,0,0,0,0,0,0,6,1,0.0,120.0
11341,655a110a0bd2ea42,ccd1299e0345e0ce,28f62d866c59c709,2010-05-29,1,0,0,208,0,0,21,11,16,5,0,0,5,5,3,3,13,6,1.0,206.0
11342,6190569c372725bf,013da757877044a2,f2c8ebbeafd45f2b,2010-05-29,0,0,0,900,2,1,107,20,107,0,0,0,0,0,34,17,73,20,0.0,813.8
11343,6190569c372725bf,f2c8ebbeafd45f2b,013da757877044a2,2010-05-29,0,0,0,900,8,3,104,17,100,4,0,0,4,3,36,29,64,14,53.2,594.0
11344,5000a0bde6213fd9,947eccadb72f4f6f,aae99701b21554e4,2010-05-29,1,1,0,66,1,1,9,3,6,3,0,0,3,1,1,0,5,2,35.0,31.0
11345,5000a0bde6213fd9,aae99701b21554e4,947eccadb72f4f6f,2010-05-29,0,1,1,66,0,0,6,3,6,0,0,0,0,0,0,0,6,3,0.0,30.0
11346,3832958c913305f0,4c8d6fde2dde07c4,83fd97284f4bb4a4,2010-05-29,0,0,0,900,1,0,73,10,73,0,0,0,0,0,8,7,65,10,0.0,853.2
11347,3832958c913305f0,83fd97284f4bb4a4,4c8d6fde2dde07c4,2010-05-29,1,0,0,900,3,0,184,40,183,1,0,0,1,0,36,24,147,40,1.8,806.0
11348,3046c0d0208a65f1,ee779c43a8926d52,ffc088e64fab57e9,2010-05-29,0,0,0,900,12,3,52,21,37,15,0,0,15,10,10,8,27,11,231.0,428.3
11349,3046c0d0208a65f1,ffc088e64fab57e9,ee779c43a8926d52,2010-05-29,1,0,0,900,1,0,47,7,42,5,1,1,4,3,11,9,31,4,9.7,613.0
11350,26025a42e011229f,497ba5b12a4bfc47,73e09f837f3b5ecc,2010-05-29,0,3,0,900,13,3,50,16,43,7,0,0,7,6,8,2,35,10,104.0,451.6
11351,26025a42e011229f,73e09f837f3b5ecc,497ba5b12a4bfc47,2010-05-29,0,1,0,900,1,1,67,16,60,7,0,0,7,4,8,7,52,12,151.4,623.0
11352,094a77eecd56a27a,353de740bb6c7e75,bda04c573563cc2e,2010-05-29,1,0,0,755,9,0,44,14,44,0,0,0,0,0,0,0,44,14,0.0,752.0
11353,094a77eecd56a27a,bda04c573563cc2e,353de740bb6c7e75,2010-05-29,0,0,0,755,0,0,182,43,182,0,0,0,0,0,11,8,171,43,0.0,754.0
11354,fc2badbeebf85ebf,18968f97ad34f15c,501b07aec9b8fc2d,2010-05-08,1,0,0,900,5,3,119,41,116,3,0,0,3,3,16,14,100,38,24.0,805.6
11355,fc2badbeebf85ebf,501b07aec9b8fc2d,18968f97ad34f15c,2010-05-08,1,1,0,900,1,0,181,40,174,7,0,0,7,7,34,30,140,33,22.4,828.0
11356,e3846855a38f0bce,0941df56f6ac954b,a26198ba5093147e,2010-05-08,0,0,0,900,8,8,81,36,70,11,1,1,10,8,17,16,53,28,161.3,504.0
11357,e3846855a38f0bce,a26198ba5093147e,0941df56f6ac954b,2010-05-08,0,0,0,900,1,0,111,38,111,0,0,0,0,0,33,29,78,38,0.0,729.7
11358,d4415f08ba3e017e,219a254e15d60135,46baf0f57edfa4df,2010-05-08,0,0,0,900,7,2,120,57,108,12,0,0,12,12,7,3,101,45,72.9,738.2
11359,d4415f08ba3e017e,46baf0f57edfa4df,219a254e15d60135,2010-05-08,0,0,0,900,0,0,161,93,155,6,0,0,6,5,6,4,149,88,3.8,808.1
11360,c795c4b7beb89bee,010986ee359fb863,2be6596a9db33bf5,2010-05-08,1,0,0,162,3,1,7,2,7,0,0,0,0,0,3,1,4,2,0.0,90.0
11361,c795c4b7beb89bee,2be6596a9db33bf5,010986ee359fb863,2010-05-08,0,0,0,162,0,0,7,1,7,0,0,0,0,0,4,4,3,1,0.0,162.0
11362,bb58aad30b58b1e4,23725c826c481e7f,dd37fd509af89f15,2010-05-08,0,0,0,900,0,0,28,10,25,3,0,0,3,3,2,1,23,7,1.0,176.0
11363,bb58aad30b58b1e4,dd37fd509af89f15,23725c826c481e7f,2010-05-08,0,1,0,900,6,4,29,11,10,19,6,6,13,11,2,2,8,0,722.0,177.0
11364,59f77a6ecd041dff,b7d524c77c27389b,fb1538b46877a695,2010-05-08,2,1,0,383,0,0,17,9,14,3,0,0,3,3,3,2,11,6,23.0,126.0
11365,59f77a6ecd041dff,fb1538b46877a695,b7d524c77c27389b,2010-05-08,0,0,0,383,5,4,16,5,4,12,0,0,12,4,1,0,3,1,211.0,149.0
11366,44adac5d05f7e883,4130a743d9d22163,9fa3bd637edd9aa2,2010-05-08,0,1,1,505,1,1,51,9,49,2,0,0,2,2,21,18,28,7,36.8,333.2
11367,44adac5d05f7e883,9fa3bd637edd9aa2,4130a743d9d22163,2010-05-08,0,1,0,505,2,2,37,19,36,1,0,0,1,1,6,3,30,18,24.8,369.2
11368,351dccf63078a20e,4d44f37107f01b9b,dbaaf42313af90fa,2010-05-08,1,0,0,430,2,0,92,40,91,1,0,0,1,1,2,2,89,39,1.3,406.0
11369,351dccf63078a20e,dbaaf42313af90fa,4d44f37107f01b9b,2010-05-08,0,1,1,430,1,0,94,34,94,0,0,0,0,0,18,10,76,34,0.0,397.7
11370,19425b506594d5c7,27541033b97c076d,ba280572acfba13f,2010-05-08,0,0,0,564,5,2,21,4,20,1,0,0,1,1,8,1,12,3,212.0,195.8
11371,19425b506594d5c7,ba280572acfba13f,27541033b97c076d,2010-05-08,1,4,0,564,0,0,56,28,33,23,4,4,19,18,12,12,21,10,156.2,155.0
11372,189d14e4e1602c48,ab8900ae1f1dfd4c,eaea0fc7b76525a8,2010-05-08,0,2,0,900,6,1,23,6,20,3,0,0,3,3,4,1,16,3,225.8,274.1
11373,189d14e4e1602c48,eaea0fc7b76525a8,ab8900ae1f1dfd4c,2010-05-08,0,2,0,900,3,3,79,43,42,37,8,8,29,29,8,8,34,14,324.9,235.2
11374,1572dbb2433d2201,140745cbbcb023ac,f7a7f7118d4b01b6,2010-05-08,1,0,0,215,1,0,28,11,22,6,0,0,6,6,8,6,14,5,20.4,167.8
11375,1572dbb2433d2201,f7a7f7118d4b01b6,140745cbbcb023ac,2010-05-08,0,0,0,215,2,2,11,6,10,1,0,0,1,1,4,3,6,5,13.2,141.6
11376,e1f77d40503e5259,3c6976f8182d9527,902ab9197b83d0db,2010-04-10,0,0,0,295,2,0,5,0,5,0,0,0,0,0,1,0,4,0,0.0,131.9
11377,e1f77d40503e5259,902ab9197b83d0db,3c6976f8182d9527,2010-04-10,0,1,1,295,5,1,18,4,8,10,4,4,6,3,6,6,2,1,138.1,74.0
11378,a2e7273a95d5db4a,5731cc327790b731,aac5ac38148f0528,2010-04-10,0,2,0,521,1,1,9,4,6,3,0,0,3,2,1,0,5,2,146.0,80.10000000000002
11379,a2e7273a95d5db4a,aac5ac38148f0528,5731cc327790b731,2010-04-10,0,3,1,521,0,0,73,41,24,49,5,5,44,31,1,1,23,10,294.9,50.0
11380,867904bc58d656df,322a56923b396b4d,7e69a4b0961aa555,2010-04-10,1,1,0,728,0,0,108,31,105,3,0,0,3,3,5,3,100,28,16.7,593.5
11381,867904bc58d656df,7e69a4b0961aa555,322a56923b396b4d,2010-04-10,0,2,0,728,5,4,132,32,128,4,1,1,3,2,43,26,85,30,95.5,520.3
11382,63f744d672fbb8b4,1f454354805b6f75,427b5953ac8e3a27,2010-04-10,1,0,0,1500,0,0,111,29,102,9,7,3,2,1,40,29,62,28,82.0,1418.0
11383,63f744d672fbb8b4,427b5953ac8e3a27,1f454354805b6f75,2010-04-10,0,0,0,1500,13,0,52,9,52,0,0,0,0,0,6,1,46,9,0.0,1414.0
11384,5a6861ca6d7fd021,621a6c59f88a44fe,aae0897825336b1a,2010-04-10,2,0,0,880,1,0,123,32,122,1,1,1,0,0,41,37,81,32,4.5,776.0
11385,5a6861ca6d7fd021,aae0897825336b1a,621a6c59f88a44fe,2010-04-10,0,0,0,880,1,0,109,16,109,0,0,0,0,0,23,18,86,16,0.0,875.5
11386,3a1d4016452477f5,5b407acfe0ef9b76,5b5307450405abf0,2010-04-10,0,1,0,900,4,2,41,9,41,0,0,0,0,0,20,19,21,9,0.0,259.3
11387,3a1d4016452477f5,5b5307450405abf0,5b407acfe0ef9b76,2010-04-10,0,1,0,900,10,3,72,21,33,39,4,3,35,17,10,7,23,4,493.7,305.0
11388,38ea5a7a5b4932cb,33011768c3c4dc9a,6a2f7c151031653d,2010-04-10,0,1,0,570,0,0,20,3,19,1,0,0,1,0,8,4,11,3,44.5,204.2
11389,38ea5a7a5b4932cb,6a2f7c151031653d,33011768c3c4dc9a,2010-04-10,0,1,1,570,3,2,45,16,22,23,3,3,20,15,8,6,14,1,276.8,188.5
11390,354a92ca4fd824a1,179f1948dc234f1f,234f3767ff0e5701,2010-04-10,1,0,0,470,8,1,60,17,14,46,8,8,38,13,0,0,14,4,208.4,215.9
11391,354a92ca4fd824a1,234f3767ff0e5701,179f1948dc234f1f,2010-04-10,1,3,0,470,0,0,26,7,23,3,0,0,3,3,2,2,21,4,32.1,154.6
11392,2fec2ba8ea346a3a,1cf1310684a841f5,7691a80e6ca3e55b,2010-04-10,0,0,0,900,0,0,127,11,127,0,0,0,0,0,11,9,116,11,0.0,894.0
11393,2fec2ba8ea346a3a,7691a80e6ca3e55b,1cf1310684a841f5,2010-04-10,0,0,0,900,1,1,97,26,94,3,0,0,3,1,7,6,87,25,6.0,894.0
11394,29c9e57b23116aa2,73c7cfa551289285,f2688492b9a525a3,2010-04-10,0,0,0,1500,0,0,262,60,262,0,0,0,0,0,14,11,248,60,0.0,1499.5
11395,29c9e57b23116aa2,f2688492b9a525a3,73c7cfa551289285,2010-04-10,0,0,0,1500,13,1,232,39,231,1,0,0,1,1,53,22,178,38,0.5,1495.0
11396,eeb8b25df8543e0f,15b1b21cd743d652,b45d6b73f4ca4467,2010-03-31,0,0,0,900,6,0,146,28,146,0,0,0,0,0,36,24,110,28,0.0,800.0
11397,eeb8b25df8543e0f,b45d6b73f4ca4467,15b1b21cd743d652,2010-03-31,0,0,0,900,0,0,198,32,197,1,0,0,1,1,46,29,151,31,3.0,858.0
11398,c16403197580e0af,6f81b6de2557739a,cce79e827569f26e,2010-03-31,0,0,0,900,6,5,57,19,25,32,5,5,27,15,0,0,25,4,582.8,242.1
11399,c16403197580e0af,cce79e827569f26e,6f81b6de2557739a,2010-03-31,0,0,0,900,4,3,50,13,43,7,1,1,6,4,7,6,36,9,56.9,130.20000000000005
11400,b32acf1c70321321,6fb1ba67bef41b37,dc0f07928009a127,2010-03-31,0,1,0,900,14,4,96,26,61,35,4,4,31,18,20,16,41,8,345.5,365.3
11401,b32acf1c70321321,dc0f07928009a127,6fb1ba67bef41b37,2010-03-31,1,1,0,900,1,0,74,16,72,2,0,0,2,2,9,8,63,14,1.7,535.5
11402,9eaea5e0165802d0,c4b81cdecd5d6abe,df2bf09c99594848,2010-03-31,2,0,0,289,0,0,37,17,31,6,0,0,6,3,1,0,30,14,7.0,264.9
11403,9eaea5e0165802d0,df2bf09c99594848,c4b81cdecd5d6abe,2010-03-31,1,0,0,289,0,0,40,8,37,3,0,0,3,3,12,8,25,5,17.1,242.0
11404,8d986c9ee38daf19,3be081c29bf734d9,cb139171ed1b69fe,2010-03-31,0,0,0,772,1,0,116,11,116,0,0,0,0,0,32,9,84,11,0.0,696.5
11405,8d986c9ee38daf19,cb139171ed1b69fe,3be081c29bf734d9,2010-03-31,0,1,1,772,2,1,186,40,177,9,0,0,9,6,14,11,163,34,67.5,667.0
11406,8afb878a0900372e,98f6da59d765ec94,e5d03e4d966126bd,2010-03-31,0,0,0,900,10,6,53,13,23,30,17,16,13,9,6,4,17,4,480.0,351.6
11407,8afb878a0900372e,e5d03e4d966126bd,98f6da59d765ec94,2010-03-31,0,3,0,900,0,0,31,9,30,1,0,0,1,1,6,3,24,8,20.4,257.0
11408,713c9b6d0abe5cfc,a780d16cf7eed44d,acff437707625fc7,2010-03-31,0,0,0,467,2,0,44,3,44,0,0,0,0,0,8,5,36,3,0.0,316.0
11409,713c9b6d0abe5cfc,acff437707625fc7,a780d16cf7eed44d,2010-03-31,1,0,0,467,0,0,72,48,60,12,0,0,12,9,2,2,58,39,151.0,316.0
11410,516868e246064e2b,52cae54377b433b7,cb46dface0e28a2c,2010-03-31,0,0,0,329,1,0,71,4,71,0,0,0,0,0,19,15,52,4,0.0,303.6
11411,516868e246064e2b,cb46dface0e28a2c,52cae54377b433b7,2010-03-31,3,0,0,329,0,0,65,24,57,8,0,0,8,4,7,5,50,20,25.4,240.0
11412,2e8217f029c25a3a,75e5fec9f72910ef,eb1723480fa2f96c,2010-03-31,1,0,0,253,1,1,59,21,38,21,1,1,20,14,0,0,38,7,81.3,164.0
11413,2e8217f029c25a3a,eb1723480fa2f96c,75e5fec9f72910ef,2010-03-31,0,0,0,253,0,0,28,2,28,0,0,0,0,0,11,4,17,2,0.0,171.7
11414,2328c7832a356a6d,4f732e58ed907eff,5f87a5c00b3d17ed,2010-03-31,0,0,0,900,1,1,159,36,155,4,0,0,4,2,25,18,130,34,34.3,826.9
11415,2328c7832a356a6d,5f87a5c00b3d17ed,4f732e58ed907eff,2010-03-31,0,0,0,900,5,2,225,28,222,3,0,0,3,1,21,11,201,27,13.1,795.7
11416,17cda9957f96883f,3f7c14c7eca7195d,ebc1f40e00e0c481,2010-03-31,1,0,0,39,0,0,15,9,6,9,0,0,9,6,0,0,6,3,8.0,31.0
11417,17cda9957f96883f,ebc1f40e00e0c481,3f7c14c7eca7195d,2010-03-31,0,0,0,39,0,0,5,0,5,0,0,0,0,0,2,2,3,0,0.0,31.0
11418,e74e3c2a96fa9c55,7abe471b61725980,aa1952ec0b3dd8e1,2010-03-27,0,2,0,560,5,1,11,6,9,2,0,0,2,1,2,2,7,5,33.3,118.10000000000002
11419,e74e3c2a96fa9c55,aa1952ec0b3dd8e1,7abe471b61725980,2010-03-27,0,2,1,560,1,1,29,16,8,21,0,0,21,14,1,0,7,2,341.9,119.7
11420,d89e004e3992c5a4,484acc7b0f856ce9,6f018c039b4d5d80,2010-03-27,0,0,0,900,0,0,30,4,30,0,0,0,0,0,13,13,17,4,0.0,420.9
11421,d89e004e3992c5a4,6f018c039b4d5d80,484acc7b0f856ce9,2010-03-27,0,0,0,900,7,2,99,41,52,47,14,11,33,27,20,20,32,14,436.1,167.0
11422,d0e4876ab954d27d,473ce3aa581251a2,6506c1d34da9c013,2010-03-27,0,0,0,1500,0,0,27,3,22,5,0,0,5,3,3,1,19,0,30.8,229.0
11423,d0e4876ab954d27d,6506c1d34da9c013,473ce3aa581251a2,2010-03-27,0,6,0,1500,11,11,79,35,18,61,19,19,42,30,6,5,12,5,1234.0,235.2
11424,828776734a528b62,679a9054e2815943,8ddf9c51c5fdea75,2010-03-27,0,0,0,45,0,0,2,0,2,0,0,0,0,0,0,0,2,0,0.0,38.0
11425,828776734a528b62,8ddf9c51c5fdea75,679a9054e2815943,2010-03-27,0,1,1,45,0,0,1,0,0,1,0,0,1,0,0,0,0,0,7.0,38.0
11426,5755a68d39867abc,1ff9589f9065a9ed,68dd7b3783c19f9c,2010-03-27,0,0,0,228,0,0,10,2,10,0,0,0,0,0,1,1,9,2,0.0,171.3
11427,5755a68d39867abc,68dd7b3783c19f9c,1ff9589f9065a9ed,2010-03-27,1,0,0,228,2,0,63,31,43,20,0,0,20,15,19,18,24,16,53.7,75.0
11428,4be101dd6883d9bb,23459ee7e373b98f,b9415726dc3ec526,2010-03-27,1,0,0,900,2,2,124,38,55,69,16,14,53,30,8,8,47,8,313.4,322.8
11429,4be101dd6883d9bb,b9415726dc3ec526,23459ee7e373b98f,2010-03-27,0,1,0,900,13,11,66,31,49,17,2,1,15,6,2,2,47,25,150.2,268.6
11430,3b8e793ed8151a51,cf9d24e4bd0cf2ce,d1941565abf50b16,2010-03-27,0,1,0,900,8,4,45,7,38,7,0,0,7,3,11,10,27,4,258.6,269.1
11431,3b8e793ed8151a51,d1941565abf50b16,cf9d24e4bd0cf2ce,2010-03-27,0,3,0,900,2,1,67,12,60,7,1,1,6,2,12,10,48,10,39.9,544.4
11432,2059fd17f2ff4e4a,9c669abd35b2522f,d023ae89a2a4a41e,2010-03-27,0,0,0,690,4,0,39,11,38,1,0,0,1,1,10,10,28,10,2.6,527.9
11433,2059fd17f2ff4e4a,d023ae89a2a4a41e,9c669abd35b2522f,2010-03-27,0,0,0,690,6,4,88,13,71,17,0,0,17,7,38,34,33,6,121.1,231.4
11434,103b36a1b9d98102,31123249b0bbf52e,91186547a7f3f758,2010-03-27,0,0,0,510,0,0,10,0,10,0,0,0,0,0,6,6,4,0,0.0,374.7
11435,103b36a1b9d98102,91186547a7f3f758,31123249b0bbf52e,2010-03-27,0,1,1,510,11,5,27,13,20,7,0,0,7,4,3,2,17,9,119.3,84.0
11436,0ae251dd5c0b5304,23a16ebe733e3041,8355922d564b152c,2010-03-27,0,0,0,167,0,0,22,1,22,0,0,0,0,0,3,2,19,1,0.0,98.9
11437,0ae251dd5c0b5304,8355922d564b152c,23a16ebe733e3041,2010-03-27,1,0,0,167,0,0,60,27,37,23,3,3,20,15,4,4,33,12,68.1,93.0
11438,f63a647b74359194,84ac950d4c1722dd,92a9aa9c93192871,2010-03-21,0,0,0,44,0,0,5,1,5,0,0,0,0,0,0,0,5,1,0.0,41.0
11439,f63a647b74359194,92a9aa9c93192871,84ac950d4c1722dd,2010-03-21,1,0,0,44,2,1,2,0,2,0,0,0,0,0,0,0,2,0,0.0,34.0
11440,eb62bfcd3d96a182,22edaf53ad59a967,fc31f896cde2bc2e,2010-03-21,0,1,0,121,1,1,17,7,4,13,0,0,13,6,0,0,4,1,55.0,17.0
11441,eb62bfcd3d96a182,fc31f896cde2bc2e,22edaf53ad59a967,2010-03-21,1,0,0,121,1,1,8,4,4,4,1,1,3,3,1,1,3,1,49.0,17.0
11442,dd56acbfb08aa6b2,052ceb8976695342,89a407032911e27e,2010-03-21,0,0,0,47,2,0,6,2,6,0,0,0,0,0,0,0,6,2,0.0,46.3
11443,dd56acbfb08aa6b2,89a407032911e27e,052ceb8976695342,2010-03-21,1,0,0,47,0,0,36,25,31,5,0,0,5,5,0,0,31,20,0.7,44.0
11444,d215c4e6dc1346ae,1eacf73d6a0055dc,f0abbb6f3444dae7,2010-03-21,1,0,0,676,9,9,94,25,61,33,14,11,19,15,20,17,41,10,304.2,169.0
11445,d215c4e6dc1346ae,f0abbb6f3444dae7,1eacf73d6a0055dc,2010-03-21,0,0,0,676,0,0,29,3,27,2,0,0,2,0,0,0,27,3,0.0,371.8
11446,a41be337367884e6,236a37d96d476164,60c72f7459827881,2010-03-21,0,0,0,900,10,6,76,29,43,33,5,4,28,18,9,6,34,11,602.7,206.0
11447,a41be337367884e6,60c72f7459827881,236a37d96d476164,2010-03-21,0,0,0,900,0,0,62,11,62,0,0,0,0,0,11,6,51,11,0.0,297.29999999999995
11448,9f6f356a56e4fe6f,497ba5b12a4bfc47,f59f1d3a2ff13edd,2010-03-21,0,1,0,900,6,3,145,54,136,9,1,1,8,5,18,15,118,49,79.3,455.6
11449,9f6f356a56e4fe6f,f59f1d3a2ff13edd,497ba5b12a4bfc47,2010-03-21,0,1,0,900,3,2,81,22,79,2,0,0,2,2,7,5,72,20,12.4,715.7
11450,9368a80ba62d87e2,9f1641c08cf8fbe2,c47df9303d318c67,2010-03-21,0,3,0,520,1,0,7,1,6,1,0,0,1,1,0,0,6,0,2.0,93.60000000000002
11451,9368a80ba62d87e2,c47df9303d318c67,9f1641c08cf8fbe2,2010-03-21,0,1,1,520,2,2,33,9,15,18,3,3,15,9,3,2,12,0,424.4,70.0
11452,7aa7b0c5706a0492,270b89c00ef0c55c,63def5a5662a6917,2010-03-21,0,0,0,233,1,1,19,2,19,0,0,0,0,0,9,7,10,2,0.0,223.0
11453,7aa7b0c5706a0492,63def5a5662a6917,270b89c00ef0c55c,2010-03-21,1,0,0,233,0,0,35,14,21,14,1,1,13,9,7,5,14,5,9.0,224.0
11454,43f0495855470427,07f72a2a7591b409,fa315e6c77eee106,2010-03-21,1,0,0,199,3,2,17,9,4,13,0,0,13,9,3,2,1,0,151.4,36.0
11455,43f0495855470427,fa315e6c77eee106,07f72a2a7591b409,2010-03-21,0,0,0,199,0,0,8,3,5,3,1,1,2,2,2,1,3,1,0.0,47.599999999999994
11456,275c22a93bdd84d8,7f955f71fa2ce7ac,a7f4d0902bb64092,2010-03-21,1,0,0,181,0,0,29,7,28,1,0,0,1,1,7,6,21,6,1.0,180.0
11457,275c22a93bdd84d8,a7f4d0902bb64092,7f955f71fa2ce7ac,2010-03-21,0,0,0,181,0,0,16,2,16,0,0,0,0,0,5,4,11,2,0.0,180.0
11458,2270b89b17067838,a08d909a5be6f410,ccdd90bd1fc7dab6,2010-03-21,0,0,0,900,0,0,97,11,97,0,0,0,0,0,12,8,85,11,0.0,865.2
11459,2270b89b17067838,ccdd90bd1fc7dab6,a08d909a5be6f410,2010-03-21,0,0,0,900,3,2,91,13,89,2,0,0,2,0,19,15,70,13,34.8,813.0
11460,e892b4a03304f2a4,132f860d02953f4c,5d7bdab5e03e3216,2010-02-20,0,3,0,900,1,1,50,7,47,3,0,0,3,2,19,13,28,5,41.7,539.4
11461,e892b4a03304f2a4,5d7bdab5e03e3216,132f860d02953f4c,2010-02-20,0,1,0,900,7,5,73,12,50,23,5,2,18,7,17,11,33,5,235.6,479.3
11462,e716f8079c60bc66,4b4753d19489297f,c32fb8c0f6471a4d,2010-02-20,0,0,0,600,11,0,25,2,25,0,0,0,0,0,7,7,18,2,0.0,380.1
11463,e716f8079c60bc66,c32fb8c0f6471a4d,4b4753d19489297f,2010-02-20,1,1,0,600,0,0,63,23,45,18,1,1,17,8,5,5,40,15,180.9,389.0
11464,ca93e3f69fa3d725,0ff11cc094e887bc,ee9d73f4fee9cbdd,2010-02-20,1,0,0,140,0,0,45,16,40,5,0,0,5,5,12,7,28,11,2.1,137.0
11465,ca93e3f69fa3d725,ee9d73f4fee9cbdd,0ff11cc094e887bc,2010-02-20,0,0,0,140,0,0,22,3,22,0,0,0,0,0,0,0,22,3,0.0,137.9
11466,b4d624bdc27dff83,79899ecf62020f6d,896c322f56b8be5a,2010-02-20,0,2,0,900,6,3,31,4,30,1,0,0,1,0,7,3,23,4,144.5,504.7
11467,b4d624bdc27dff83,896c322f56b8be5a,79899ecf62020f6d,2010-02-20,0,3,0,900,3,2,87,18,86,1,0,0,1,1,5,2,81,17,106.3,436.5
11468,aefca2869c87eb11,b9d0fd83bb8a147a,c0ab242c40decc55,2010-02-20,0,0,0,730,0,0,74,9,74,0,0,0,0,0,10,6,64,9,0.0,628.3
11469,aefca2869c87eb11,c0ab242c40decc55,b9d0fd83bb8a147a,2010-02-20,1,0,0,730,9,3,62,17,55,7,1,1,6,4,13,11,42,13,101.7,454.0
11470,46a7cb6937144ba2,53278852bcd91e11,f5431394fb284bb9,2010-02-20,2,0,0,806,4,2,54,24,47,7,0,0,7,5,1,1,46,19,29.8,335.6
11471,46a7cb6937144ba2,f5431394fb284bb9,53278852bcd91e11,2010-02-20,1,1,0,806,10,5,52,15,29,23,0,0,23,9,9,7,20,6,351.4,226.2
11472,3b0258eb19d66f8f,3dc3022232b79c7a,91acd6910b802a9e,2010-02-20,0,0,0,101,1,1,22,5,21,1,0,0,1,1,1,0,20,4,16.0,85.0
11473,3b0258eb19d66f8f,91acd6910b802a9e,3dc3022232b79c7a,2010-02-20,0,1,1,101,0,0,14,2,14,0,0,0,0,0,0,0,14,2,0.0,85.0
11474,241a722f3b042c59,2b93ebd9f5417ad2,a1f6999fe57236e0,2010-02-20,0,0,0,900,9,5,137,21,137,0,0,0,0,0,16,11,121,21,0.0,826.5
11475,241a722f3b042c59,a1f6999fe57236e0,2b93ebd9f5417ad2,2010-02-20,1,1,0,900,1,1,165,16,151,14,6,3,8,4,33,23,118,12,30.5,839.0
11476,0ea087a71863184d,59583ff832fe9d68,c6a33ff198aaaeeb,2010-02-20,1,0,0,664,1,0,123,37,123,0,0,0,0,0,19,11,104,37,0.0,578.6
11477,0ea087a71863184d,c6a33ff198aaaeeb,59583ff832fe9d68,2010-02-20,0,0,0,664,5,2,117,19,115,2,0,0,2,0,24,17,91,19,9.4,499.0
11478,fb9b03644f559604,ccd1299e0345e0ce,cce79e827569f26e,2010-02-06,0,0,0,900,0,0,81,23,69,12,1,1,11,7,15,10,54,16,64.0,651.6
11479,fb9b03644f559604,cce79e827569f26e,ccd1299e0345e0ce,2010-02-06,0,1,0,900,13,5,49,6,45,4,0,0,4,0,3,0,42,6,152.4,493.0
11480,f92e8d6c96306013,0aa92558424ced9e,21b8a0f5c231096f,2010-02-06,0,1,1,369,1,1,67,41,57,10,0,0,10,8,4,3,53,33,74.8,152.0
11481,f92e8d6c96306013,21b8a0f5c231096f,0aa92558424ced9e,2010-02-06,0,0,0,369,0,0,21,8,21,0,0,0,0,0,3,2,18,8,0.0,294.2
11482,b091e021e61f1950,48d1f690b763934c,a8e6a69796280f17,2010-02-06,0,0,0,900,6,6,56,31,17,39,5,4,34,25,4,4,13,6,662.2,79.1
11483,b091e021e61f1950,a8e6a69796280f17,48d1f690b763934c,2010-02-06,0,2,0,900,1,0,24,7,17,7,0,0,7,4,5,4,12,3,39.9,180.79999999999995
11484,adddc6e46da5ca19,579fcdfcabd23a7b,902ab9197b83d0db,2010-02-06,0,0,0,900,0,0,27,0,27,0,0,0,0,0,8,5,19,0,0.0,301.1
11485,adddc6e46da5ca19,902ab9197b83d0db,579fcdfcabd23a7b,2010-02-06,0,1,0,900,4,3,103,26,38,65,22,13,43,26,10,9,28,0,598.9,255.0
11486,840863604b38a33f,64360e618823a8e4,dc0f07928009a127,2010-02-06,0,2,0,900,1,0,48,7,42,6,0,0,6,0,17,12,25,7,37.4,453.7
11487,840863604b38a33f,dc0f07928009a127,64360e618823a8e4,2010-02-06,0,0,0,900,11,7,53,9,35,18,6,6,12,5,15,11,20,4,365.3,314.6
11488,83a7cc0b0de904b9,427b5953ac8e3a27,d0c29452d3272603,2010-02-06,0,0,0,900,7,4,77,22,73,4,0,0,4,2,11,8,62,20,79.0,577.6
11489,83a7cc0b0de904b9,d0c29452d3272603,427b5953ac8e3a27,2010-02-06,0,0,0,900,0,0,95,6,88,7,0,0,7,3,31,14,57,3,6.4,810.0
11490,5e52b0bf9719f0ae,30a09e43f15f1d75,9fe85152f351e737,2010-02-06,1,1,1,414,0,0,25,5,24,1,0,0,1,0,5,4,19,5,15.0,369.0
11491,5e52b0bf9719f0ae,9fe85152f351e737,30a09e43f15f1d75,2010-02-06,0,0,0,414,1,1,61,3,60,1,0,0,1,0,10,4,50,3,30.0,369.0
11492,2bf24d9c33bb4d49,86dfed7cc24a9fa7,d2d37e8eeb3abc8d,2010-02-06,1,0,0,143,0,0,36,7,32,4,0,0,4,4,11,5,21,3,3.0,140.0
11493,2bf24d9c33bb4d49,d2d37e8eeb3abc8d,86dfed7cc24a9fa7,2010-02-06,0,0,0,143,0,0,21,6,21,0,0,0,0,0,0,0,21,6,0.0,140.0
11494,20628fd4e19a97e4,219a254e15d60135,df05aa15b2d66f57,2010-02-06,0,1,0,900,1,1,70,24,57,13,0,0,13,10,14,10,43,14,97.1,626.2
11495,20628fd4e19a97e4,df05aa15b2d66f57,219a254e15d60135,2010-02-06,0,1,0,900,7,1,64,13,63,1,0,0,1,0,11,11,52,13,19.8,545.9
11496,1fc065e1d3243594,231926533134ec1f,86f582852a5b240a,2010-02-06,0,1,0,900,0,0,130,24,120,10,1,0,9,3,9,6,111,21,53.3,588.3
11497,1fc065e1d3243594,86f582852a5b240a,231926533134ec1f,2010-02-06,0,0,0,900,6,3,126,45,109,17,1,1,16,12,20,16,89,33,167.7,560.7
11498,1a21263dc5d866b6,46baf0f57edfa4df,e4a9dbade7c7e1a7,2010-02-06,1,0,0,391,0,0,49,22,34,15,0,0,15,11,0,0,34,11,70.0,286.6
11499,1a21263dc5d866b6,e4a9dbade7c7e1a7,46baf0f57edfa4df,2010-02-06,0,0,0,391,10,1,46,12,44,2,0,0,2,1,5,3,39,11,20.4,219.0
11500,f4641db74fcb8ab7,3ae10ac4df3df05c,5b5307450405abf0,2010-01-11,0,1,0,900,2,1,128,13,128,0,0,0,0,0,16,9,112,13,0.0,705.5
11501,f4641db74fcb8ab7,5b5307450405abf0,3ae10ac4df3df05c,2010-01-11,0,1,0,900,3,2,172,31,162,10,1,1,9,3,18,15,144,28,131.5,637.0
11502,f338da998c4fdf53,947eccadb72f4f6f,f8fe2053d73d7bcf,2010-01-11,0,0,0,900,1,0,160,18,160,0,0,0,0,0,19,14,141,18,0.0,824.5
11503,f338da998c4fdf53,f8fe2053d73d7bcf,947eccadb72f4f6f,2010-01-11,0,0,0,900,9,2,103,15,101,2,1,1,1,0,19,16,82,15,7.5,802.0
11504,db620510bbb3f0af,010986ee359fb863,c4b81cdecd5d6abe,2010-01-11,0,0,0,804,4,1,72,7,72,0,0,0,0,0,0,0,72,7,0.0,590.9
11505,db620510bbb3f0af,c4b81cdecd5d6abe,010986ee359fb863,2010-01-11,1,0,0,804,2,1,81,19,63,18,0,0,18,7,5,2,58,12,125.1,672.0
11506,d5e0fd3eec76f7e1,53bb0d40905b87c0,d43a048a880efdff,2010-01-11,0,0,0,900,1,0,54,13,54,0,0,0,0,0,3,2,51,13,0.0,295.4
11507,d5e0fd3eec76f7e1,d43a048a880efdff,53bb0d40905b87c0,2010-01-11,0,2,0,900,3,2,99,48,35,64,1,1,63,43,14,11,21,5,557.6,264.0
11508,c4fa93a4f37a6ca7,6a2f7c151031653d,a6959da32f0e6b5d,2010-01-11,0,2,0,900,8,5,112,37,60,52,2,2,50,23,10,3,50,14,478.6,397.0
11509,c4fa93a4f37a6ca7,a6959da32f0e6b5d,6a2f7c151031653d,2010-01-11,0,0,0,900,0,0,53,4,52,1,0,0,1,0,20,17,32,4,6.0,397.4
11510,be72958d9715757d,4d44f37107f01b9b,d5f820c11a121050,2010-01-11,0,2,0,900,6,1,128,50,127,1,0,0,1,0,2,2,125,50,2.9,711.1
11511,be72958d9715757d,d5f820c11a121050,4d44f37107f01b9b,2010-01-11,0,0,0,900,6,2,108,22,103,5,1,1,4,2,22,13,81,20,31.9,629.1
11512,bad1f36202e2c7d7,6fb1ba67bef41b37,8a59d346dc976a10,2010-01-11,0,1,0,900,13,4,206,36,204,2,2,2,0,0,42,33,162,36,8.7,787.0
11513,bad1f36202e2c7d7,8a59d346dc976a10,6fb1ba67bef41b37,2010-01-11,0,1,0,900,6,1,146,38,146,0,0,0,0,0,24,17,122,38,0.0,784.3
11514,a570acbbcbbd151d,2650e2f846a30f64,7e69a4b0961aa555,2010-01-11,0,0,0,900,2,2,162,40,137,25,4,4,21,14,52,43,85,26,151.5,597.0
11515,a570acbbcbbd151d,7e69a4b0961aa555,2650e2f846a30f64,2010-01-11,0,0,0,900,1,0,150,19,150,0,0,0,0,0,30,18,120,19,0.0,600.5
11516,5355fd4a2598f679,7d96bc577e5178b2,8355922d564b152c,2010-01-11,0,0,0,900,0,0,142,29,142,0,0,0,0,0,19,12,123,29,0.0,889.0
11517,5355fd4a2598f679,8355922d564b152c,7d96bc577e5178b2,2010-01-11,0,0,0,900,3,0,251,49,251,0,0,0,0,0,37,21,214,49,0.0,900.0
11518,504b540805598fa5,83fd97284f4bb4a4,e5c9de15bb58b1c6,2010-01-11,1,2,0,719,1,0,74,20,68,6,1,0,5,1,6,6,62,19,57.3,346.5
11519,504b540805598fa5,e5c9de15bb58b1c6,83fd97284f4bb4a4,2010-01-11,0,1,1,719,4,3,80,19,59,21,1,1,20,11,4,2,55,8,200.5,451.7
11520,19f615a7a5cfd304,cbd5d3cdd862e90e,eaea0fc7b76525a8,2010-01-11,0,2,1,267,3,2,19,7,17,2,0,0,2,2,1,1,16,5,113.3,89.0
11521,19f615a7a5cfd304,eaea0fc7b76525a8,cbd5d3cdd862e90e,2010-01-11,0,0,0,267,3,0,18,2,15,3,2,2,1,1,3,2,12,1,8.0,145.7
11522,d7f9a09021a9a13c,3bad7ef643840f67,501b07aec9b8fc2d,2010-01-02,0,2,0,900,16,4,81,23,75,6,0,0,6,5,3,3,72,18,68.1,692.7
11523,d7f9a09021a9a13c,501b07aec9b8fc2d,3bad7ef643840f67,2010-01-02,0,0,0,900,0,0,264,60,258,6,0,0,6,2,45,34,213,58,48.3,686.9
11524,c99370e3e54bd5fd,23725c826c481e7f,a149d6bc670cdb60,2010-01-02,1,0,0,144,0,0,20,4,17,3,1,1,2,2,8,3,9,2,3.0,141.0
11525,c99370e3e54bd5fd,a149d6bc670cdb60,23725c826c481e7f,2010-01-02,0,0,0,144,0,0,11,1,11,0,0,0,0,0,7,3,4,1,0.0,141.0
11526,9d2c9d2249d4fe50,84ac950d4c1722dd,d1941565abf50b16,2010-01-02,0,0,0,151,0,0,27,2,27,0,0,0,0,0,1,0,26,2,0.0,115.0
11527,9d2c9d2249d4fe50,d1941565abf50b16,84ac950d4c1722dd,2010-01-02,1,1,1,151,0,0,23,3,21,2,0,0,2,1,4,3,17,2,15.0,136.0
11528,78b928a602a81971,6f81b6de2557739a,8b69839f3555a67b,2010-01-02,0,0,0,243,0,0,36,12,36,0,0,0,0,0,1,1,35,12,0.0,144.4
11529,78b928a602a81971,8b69839f3555a67b,6f81b6de2557739a,2010-01-02,1,1,1,243,0,0,34,14,21,13,0,0,13,7,0,0,21,7,96.6,139.0
11530,57dca2ebe96ed622,2924886ee9c4c527,ee779c43a8926d52,2010-01-02,0,0,0,900,0,0,84,15,84,0,0,0,0,0,21,16,63,15,0.0,842.6
11531,57dca2ebe96ed622,ee779c43a8926d52,2924886ee9c4c527,2010-01-02,0,0,0,900,16,8,66,11,65,1,0,0,1,1,1,1,64,10,43.4,466.0
11532,47245dd345d9ef7e,282fa667ff9c51ed,4c8d6fde2dde07c4,2010-01-02,0,1,1,185,0,0,34,12,34,0,0,0,0,0,4,3,30,12,0.0,169.8
11533,47245dd345d9ef7e,4c8d6fde2dde07c4,282fa667ff9c51ed,2010-01-02,1,0,0,185,1,1,24,8,22,2,0,0,2,0,3,2,19,8,9.2,139.0
11534,41e9da89f349b2bc,63def5a5662a6917,d29b5c4f22c6357d,2010-01-02,1,0,0,127,0,0,33,9,26,7,0,0,7,4,9,5,17,5,6.1,120.0
11535,41e9da89f349b2bc,d29b5c4f22c6357d,63def5a5662a6917,2010-01-02,0,0,0,127,0,0,18,3,18,0,0,0,0,0,3,0,15,3,0.0,120.9
11536,24e14c4824144c64,d81ac739417d7f53,f5990c11974d8e9c,2010-01-02,1,0,0,322,2,2,39,13,13,26,0,0,26,10,2,2,11,3,233.2,44.0
11537,24e14c4824144c64,f5990c11974d8e9c,d81ac739417d7f53,2010-01-02,0,1,0,322,1,0,8,3,7,1,0,0,1,1,2,2,5,2,0.0,88.80000000000001
11538,0e05f54d8b66f317,179f1948dc234f1f,aae99701b21554e4,2010-01-02,1,0,0,150,1,1,28,8,5,23,8,8,15,8,1,0,4,0,83.0,67.0
11539,0e05f54d8b66f317,aae99701b21554e4,179f1948dc234f1f,2010-01-02,0,1,0,150,2,0,16,5,16,0,0,0,0,0,5,4,11,5,0.0,46.0
11540,0949caefc6735f9b,15b1b21cd743d652,a0c139b34f11421a,2010-01-02,0,4,0,900,7,6,45,18,17,28,0,0,28,18,7,3,10,0,616.0,203.3
11541,0949caefc6735f9b,a0c139b34f11421a,15b1b21cd743d652,2010-01-02,0,4,0,900,1,1,30,1,26,4,0,0,4,1,1,0,25,0,14.7,262.0
11542,f6d078e9fe7d17c8,73c7cfa551289285,82e7929bf6c2b689,2009-12-12,1,0,0,1357,0,0,131,66,112,19,0,0,19,9,4,4,108,57,30.0,1267.0
11543,f6d078e9fe7d17c8,82e7929bf6c2b689,73c7cfa551289285,2009-12-12,0,0,0,1357,27,0,108,7,108,0,0,0,0,0,8,1,100,7,0.0,945.0
11544,ccac56928fc2b40b,236a37d96d476164,6f018c039b4d5d80,2009-12-12,0,0,0,900,2,1,174,34,174,0,0,0,0,0,27,20,147,34,0.0,687.5
11545,ccac56928fc2b40b,6f018c039b4d5d80,236a37d96d476164,2009-12-12,0,0,0,900,10,4,163,37,160,3,0,0,3,2,28,18,132,35,23.5,642.0
11546,afd5e85676eb697d,0941df56f6ac954b,e9e1acc96536bb4f,2009-12-12,0,4,0,900,14,7,83,36,71,12,1,1,11,8,16,12,55,28,132.9,302.0
11547,afd5e85676eb697d,e9e1acc96536bb4f,0941df56f6ac954b,2009-12-12,0,0,0,900,6,1,26,6,26,0,0,0,0,0,13,10,13,6,0.0,637.1
11548,a9bc7915974b7d15,1eacf73d6a0055dc,1ff9589f9065a9ed,2009-12-12,0,0,0,72,0,0,4,0,4,0,0,0,0,0,0,0,4,0,0.0,43.0
11549,a9bc7915974b7d15,1ff9589f9065a9ed,1eacf73d6a0055dc,2009-12-12,1,1,1,72,0,0,5,2,2,3,0,0,3,1,0,0,2,1,6.0,66.0
11550,a7c63a2b33049ace,8ddf9c51c5fdea75,a780d16cf7eed44d,2009-12-12,0,3,1,501,2,1,14,5,5,9,0,0,9,4,1,1,4,1,245.0,145.0
11551,a7c63a2b33049ace,a780d16cf7eed44d,8ddf9c51c5fdea75,2009-12-12,0,2,0,501,2,2,27,8,8,19,0,0,19,8,2,0,6,0,111.0,145.0
11552,a29236fcb395f443,ebc1f40e00e0c481,f0abbb6f3444dae7,2009-12-12,0,2,0,900,1,1,115,23,111,4,0,0,4,2,36,31,75,21,46.7,520.7
11553,a29236fcb395f443,f0abbb6f3444dae7,ebc1f40e00e0c481,2009-12-12,1,0,0,900,0,0,89,28,82,7,0,0,7,6,11,9,71,22,29.3,740.3
11554,9172138df0d70cb0,c47df9303d318c67,cb139171ed1b69fe,2009-12-12,0,0,0,439,3,0,69,7,61,8,0,0,8,2,14,6,47,5,22.9,383.0
11555,9172138df0d70cb0,cb139171ed1b69fe,c47df9303d318c67,2009-12-12,1,1,1,439,2,1,78,20,76,2,0,0,2,2,5,2,71,18,13.0,351.1
11556,8e9f2b82a7b87778,2db7fa8db6bc9632,eb29176b03dfa888,2009-12-12,0,3,0,900,7,1,85,12,84,1,0,0,1,1,16,8,68,11,6.5,616.3
11557,8e9f2b82a7b87778,eb29176b03dfa888,2db7fa8db6bc9632,2009-12-12,0,0,0,900,5,2,130,39,88,42,0,0,42,17,26,16,62,22,205.7,555.5
11558,7e50ae4dbdd380a1,a26198ba5093147e,a6d8bfe9e0c8153b,2009-12-12,1,0,0,297,3,1,40,10,31,9,2,1,7,5,17,17,14,5,69.2,122.8
11559,7e50ae4dbdd380a1,a6d8bfe9e0c8153b,a26198ba5093147e,2009-12-12,1,0,0,297,0,0,37,11,24,13,0,0,13,8,4,3,20,3,28.2,188.8
11560,483d934c46351c78,322a56923b396b4d,8d49545dadf9b919,2009-12-12,0,1,1,243,0,0,36,6,36,0,0,0,0,0,5,4,31,6,0.0,172.2
11561,483d934c46351c78,8d49545dadf9b919,322a56923b396b4d,2009-12-12,0,1,0,243,2,1,48,15,35,13,0,0,13,8,5,2,30,7,70.8,134.0
11562,f6246d2b9f663e33,8fa2b06572365321,ba280572acfba13f,2009-12-05,0,1,0,310,4,3,19,6,19,0,0,0,0,0,5,4,14,6,0.0,131.0
11563,f6246d2b9f663e33,ba280572acfba13f,8fa2b06572365321,2009-12-05,1,0,0,310,0,0,34,6,30,4,1,1,3,2,8,7,22,4,18.0,247.0
11564,f5affe923c640d0e,5a558ba1ff5e9121,cac08b8685387ca5,2009-12-05,0,1,0,800,3,0,48,13,45,3,0,0,3,3,13,3,32,10,27.0,343.7
11565,f5affe923c640d0e,cac08b8685387ca5,5a558ba1ff5e9121,2009-12-05,1,2,0,800,2,1,95,40,49,46,5,3,41,28,15,15,34,12,330.3,335.0
11566,e246b6a8cd7853de,3f7c14c7eca7195d,89a407032911e27e,2009-12-05,1,0,0,225,2,1,35,8,33,2,0,0,2,1,0,0,33,7,41.0,143.0
11567,e246b6a8cd7853de,89a407032911e27e,3f7c14c7eca7195d,2009-12-05,0,0,0,225,0,0,48,12,48,0,0,0,0,0,4,0,44,12,0.0,184.0
11568,c32b24a24d946893,579fcdfcabd23a7b,b9415726dc3ec526,2009-12-05,0,0,0,900,1,0,67,15,56,11,1,1,10,5,24,20,32,10,83.5,506.8
11569,c32b24a24d946893,b9415726dc3ec526,579fcdfcabd23a7b,2009-12-05,0,2,0,900,15,7,35,9,30,5,1,1,4,3,7,5,23,6,112.2,457.5
11570,7f0e469103ab46b6,013da757877044a2,cf9d24e4bd0cf2ce,2009-12-05,0,0,0,216,0,0,19,0,19,0,0,0,0,0,5,3,14,0,0.0,211.0
11571,7f0e469103ab46b6,cf9d24e4bd0cf2ce,013da757877044a2,2009-12-05,0,1,1,216,2,2,16,1,16,0,0,0,0,0,5,5,11,1,0.0,83.0
11572,5ab4bdec4db84f7d,5731cc327790b731,f2688492b9a525a3,2009-12-05,0,0,0,440,9,3,42,5,42,0,0,0,0,0,3,2,39,5,0.0,291.0
11573,5ab4bdec4db84f7d,f2688492b9a525a3,5731cc327790b731,2009-12-05,0,1,1,440,3,0,61,19,43,18,0,0,18,12,12,6,31,7,29.0,403.0
11574,4182524382590e07,7691a80e6ca3e55b,e78f601035d677f2,2009-12-05,0,0,0,900,1,0,100,20,100,0,0,0,0,0,7,6,93,20,0.0,900.0
11575,4182524382590e07,e78f601035d677f2,7691a80e6ca3e55b,2009-12-05,0,0,0,900,1,0,159,5,159,0,0,0,0,0,20,12,139,5,0.0,884.0
11576,3f0826158f87f41d,07f72a2a7591b409,98b80a717b9bda17,2009-12-05,0,0,0,254,1,1,88,33,27,61,3,3,58,30,9,8,18,3,81.3,170.0
11577,3f0826158f87f41d,98b80a717b9bda17,07f72a2a7591b409,2009-12-05,0,0,0,254,1,0,17,2,17,0,0,0,0,0,6,3,11,2,0.0,172.7
11578,0b0ba5238399545c,8a8a84b743ae7699,fc31f896cde2bc2e,2009-12-05,0,2,0,895,4,2,24,2,15,9,6,4,3,2,4,2,11,0,495.0,150.5
11579,0b0ba5238399545c,fc31f896cde2bc2e,8a8a84b743ae7699,2009-12-05,1,0,0,895,3,2,22,7,12,10,3,2,7,5,5,5,7,2,194.5,186.0
11580,fc0f12be6552bfe5,1652f3213655b935,2650e2f846a30f64,2009-11-21,0,0,0,900,4,1,140,40,138,2,0,0,2,0,19,11,119,40,4.5,764.0
11581,fc0f12be6552bfe5,2650e2f846a30f64,1652f3213655b935,2009-11-21,0,0,0,900,1,0,222,53,222,0,0,0,0,0,103,81,119,53,0.0,567.5
11582,ef8f31b86469a967,3dc3022232b79c7a,5eedbf1e9601be35,2009-11-21,1,0,0,505,4,2,63,22,28,35,3,2,32,17,4,4,24,5,157.9,309.3
11583,ef8f31b86469a967,5eedbf1e9601be35,3dc3022232b79c7a,2009-11-21,0,1,0,505,3,1,14,5,12,2,0,0,2,1,2,1,10,4,19.7,288.1
11584,d66f2c83c26e5b80,7abe471b61725980,eb1723480fa2f96c,2009-11-21,0,2,0,900,5,5,71,17,67,4,0,0,4,1,7,5,60,16,22.5,378.6
11585,d66f2c83c26e5b80,eb1723480fa2f96c,7abe471b61725980,2009-11-21,0,0,0,900,3,2,59,11,40,19,10,6,9,6,12,11,28,5,375.4,383.5
11586,c52e23519279d18a,234f3767ff0e5701,4f2fcbefb668689d,2009-11-21,0,1,1,239,1,1,8,1,7,1,0,0,1,1,2,2,5,0,20.3,131.1
11587,c52e23519279d18a,4f2fcbefb668689d,234f3767ff0e5701,2009-11-21,0,1,0,239,4,3,12,2,9,3,0,0,3,1,4,3,5,1,46.9,93.7
11588,9fa3f9f7caf429d6,2f732dd9210d301f,fcffee71cff5530e,2009-11-21,0,0,0,900,9,3,75,21,51,24,2,1,22,11,2,2,49,10,239.0,629.2
11589,9fa3f9f7caf429d6,fcffee71cff5530e,2f732dd9210d301f,2009-11-21,0,0,0,900,1,0,206,44,202,4,0,0,4,3,36,26,166,41,21.8,590.0
11590,70228adf93b6434f,30a09e43f15f1d75,6f81b6de2557739a,2009-11-21,2,0,0,900,4,2,77,21,45,32,4,3,28,12,10,10,35,9,261.8,407.9
11591,70228adf93b6434f,6f81b6de2557739a,30a09e43f15f1d75,2009-11-21,0,1,0,900,4,1,38,11,29,9,0,0,9,8,13,5,16,3,132.1,271.2
11592,6f78fc53b8662627,896c322f56b8be5a,fa8b9e6b0c2269f8,2009-11-21,0,2,1,576,3,3,120,29,92,28,0,0,28,15,8,4,84,14,328.0,248.0
11593,6f78fc53b8662627,fa8b9e6b0c2269f8,896c322f56b8be5a,2009-11-21,0,0,0,576,0,0,69,18,66,3,0,0,3,2,8,7,58,16,0.0,248.0
11594,31f12d3f95576ef4,365fee2da473b177,dd37fd509af89f15,2009-11-21,0,0,0,587,1,0,72,9,70,2,0,0,2,1,14,7,56,8,43.0,305.0
11595,31f12d3f95576ef4,dd37fd509af89f15,365fee2da473b177,2009-11-21,0,1,1,587,4,2,53,15,38,15,2,1,13,8,7,3,31,7,239.0,305.0
11596,119b156ded2af0f1,24b033b3daf1c9df,73e09f837f3b5ecc,2009-11-21,0,0,0,116,0,0,14,1,14,0,0,0,0,0,2,2,12,1,0.0,116.0
11597,119b156ded2af0f1,73e09f837f3b5ecc,24b033b3daf1c9df,2009-11-21,1,0,0,116,0,0,28,11,28,0,0,0,0,0,4,3,24,11,0.0,114.0
11598,0c6055509d98ed06,484acc7b0f856ce9,b7d524c77c27389b,2009-11-21,1,0,0,204,2,0,39,9,38,1,0,0,1,1,15,13,23,8,2.2,150.0
11599,0c6055509d98ed06,b7d524c77c27389b,484acc7b0f856ce9,2009-11-21,0,0,0,204,2,0,24,3,24,0,0,0,0,0,5,5,19,3,0.0,134.8
11600,cb510afff3dafdab,28f3c2258a1d8874,9b74de674c355425,2009-11-14,0,0,0,900,6,5,148,59,12,136,21,17,115,58,4,4,8,1,791.4,97.0
11601,cb510afff3dafdab,9b74de674c355425,28f3c2258a1d8874,2009-11-14,0,1,0,900,0,0,19,1,19,0,0,0,0,0,6,4,13,1,0.0,108.60000000000002
11602,bf8164367980fcd3,473ce3aa581251a2,9fe85152f351e737,2009-11-14,0,0,0,900,4,1,112,21,106,6,0,0,6,4,49,34,57,17,41.4,541.0
11603,bf8164367980fcd3,9fe85152f351e737,473ce3aa581251a2,2009-11-14,0,1,0,900,3,0,98,17,98,0,0,0,0,0,31,21,67,17,0.0,699.6
11604,b4ebb7576e9745e7,4f732e58ed907eff,f2c8ebbeafd45f2b,2009-11-14,1,0,0,578,0,0,122,38,122,0,0,0,0,0,24,21,98,38,0.0,525.0
11605,b4ebb7576e9745e7,f2c8ebbeafd45f2b,4f732e58ed907eff,2009-11-14,0,0,0,578,2,0,73,6,73,0,0,0,0,0,17,9,56,6,0.0,559.0
11606,b12d96ba9426b8d4,2b93ebd9f5417ad2,3c241737a6069b9f,2009-11-14,1,1,0,564,3,3,85,24,44,41,4,3,37,12,2,2,42,12,79.2,289.5
11607,b12d96ba9426b8d4,3c241737a6069b9f,2b93ebd9f5417ad2,2009-11-14,1,0,0,564,1,0,53,8,42,11,2,1,9,4,5,2,37,4,189.5,260.8
11608,b0ee33ab448e252b,37b1696e6d115957,b45d6b73f4ca4467,2009-11-14,0,0,0,202,0,0,45,5,45,0,0,0,0,0,9,6,36,5,0.0,184.2
11609,b0ee33ab448e252b,b45d6b73f4ca4467,37b1696e6d115957,2009-11-14,2,0,0,202,0,0,28,8,25,3,0,0,3,2,9,6,16,6,7.8,189.0
11610,964245b54324810d,23459ee7e373b98f,3c6976f8182d9527,2009-11-14,0,0,0,41,0,0,17,3,17,0,0,0,0,0,4,3,13,3,0.0,36.0
11611,964245b54324810d,3c6976f8182d9527,23459ee7e373b98f,2009-11-14,1,0,0,41,0,0,23,6,16,7,0,0,7,4,0,0,16,2,5.0,36.0
11612,81283a33e907dbbe,5b407acfe0ef9b76,d023ae89a2a4a41e,2009-11-14,1,1,0,833,0,0,101,35,50,51,2,2,49,27,19,9,31,8,209.1,457.6
11613,81283a33e907dbbe,d023ae89a2a4a41e,5b407acfe0ef9b76,2009-11-14,0,0,0,833,12,4,54,11,45,9,0,0,9,5,20,17,25,6,129.4,278.9
11614,7cdc6fdf983fb412,0aa92558424ced9e,fa315e6c77eee106,2009-11-14,0,0,0,900,10,1,73,19,73,0,0,0,0,0,20,20,53,19,0.0,326.5
11615,7cdc6fdf983fb412,fa315e6c77eee106,0aa92558424ced9e,2009-11-14,1,0,0,900,2,1,51,10,46,5,0,0,5,2,20,17,26,8,34.5,755.0
11616,6c569785225fd2e7,5f87a5c00b3d17ed,aac5ac38148f0528,2009-11-14,2,0,0,473,2,0,165,28,161,4,0,0,4,2,19,10,142,26,6.1,447.0
11617,6c569785225fd2e7,aac5ac38148f0528,5f87a5c00b3d17ed,2009-11-14,0,0,0,473,3,1,84,9,84,0,0,0,0,0,6,3,78,9,0.0,409.9
11618,4f36bc6fe119c4ac,33011768c3c4dc9a,9f1641c08cf8fbe2,2009-11-14,0,1,1,384,0,0,57,5,57,0,0,0,0,0,14,12,43,5,0.0,295.0
11619,4f36bc6fe119c4ac,9f1641c08cf8fbe2,33011768c3c4dc9a,2009-11-14,0,0,0,384,2,1,41,4,40,1,0,0,1,1,11,7,29,3,51.0,333.0
11620,2c07f8ba25640237,31123249b0bbf52e,852454c572675334,2009-11-14,1,3,0,747,1,0,75,36,50,25,1,1,24,18,10,8,40,18,108.6,476.0
11621,2c07f8ba25640237,852454c572675334,31123249b0bbf52e,2009-11-14,0,3,0,747,10,1,53,13,51,2,0,0,2,0,10,6,41,13,106.0,267.4
11622,e60e53bdc614a0af,140745cbbcb023ac,f7a7f7118d4b01b6,2009-10-24,0,0,0,1500,4,0,146,15,146,0,0,0,0,0,100,65,46,15,0.0,1338.0
11623,e60e53bdc614a0af,f7a7f7118d4b01b6,140745cbbcb023ac,2009-10-24,0,0,0,1500,0,0,108,11,108,0,0,0,0,0,46,24,62,11,0.0,1477.0
11624,d77a72e3fa8db853,658c3465581ae46b,69b69c0178c4004d,2009-10-24,1,0,0,450,0,0,64,23,61,3,0,0,3,3,9,6,52,20,69.0,381.0
11625,d77a72e3fa8db853,69b69c0178c4004d,658c3465581ae46b,2009-10-24,0,0,0,450,2,0,72,6,72,0,0,0,0,0,33,23,39,6,0.0,381.0
11626,b4627dd3bb50be2c,0ff11cc094e887bc,bd58d34e39b7b12a,2009-10-24,1,0,0,358,5,5,95,56,22,73,1,1,72,51,5,5,17,5,274.2,80.0
11627,b4627dd3bb50be2c,bd58d34e39b7b12a,0ff11cc094e887bc,2009-10-24,0,0,0,358,0,0,21,3,21,0,0,0,0,0,0,0,21,3,0.0,83.80000000000001
11628,92975b516e6463b6,75e5fec9f72910ef,d1a1314976c50bef,2009-10-24,0,2,0,900,14,11,121,21,118,3,0,0,3,1,3,1,115,20,118.3,604.5
11629,92975b516e6463b6,d1a1314976c50bef,75e5fec9f72910ef,2009-10-24,0,0,0,900,0,0,99,12,96,3,0,0,3,1,20,12,76,11,19.5,742.7
11630,7a72d7448159fb59,365fee2da473b177,ab8900ae1f1dfd4c,2009-10-24,1,0,0,41,0,0,20,9,20,0,0,0,0,0,1,1,19,9,0.0,41.0
11631,7a72d7448159fb59,ab8900ae1f1dfd4c,365fee2da473b177,2009-10-24,0,0,0,41,0,0,1,0,1,0,0,0,0,0,1,0,0,0,0.0,41.0
11632,5c612d2cc1f5da21,c0ab242c40decc55,f59f1d3a2ff13edd,2009-10-24,2,0,0,900,4,3,166,46,138,28,3,2,25,12,4,4,134,34,212.0,635.0
11633,5c612d2cc1f5da21,f59f1d3a2ff13edd,c0ab242c40decc55,2009-10-24,0,1,0,900,0,0,116,23,116,0,0,0,0,0,4,2,112,23,0.0,687.0
11634,5a9ecff594dc6bb9,054defd5420a551f,cb46dface0e28a2c,2009-10-24,0,0,0,713,3,1,54,13,50,4,0,0,4,1,11,10,39,12,21.1,279.1
11635,5a9ecff594dc6bb9,cb46dface0e28a2c,054defd5420a551f,2009-10-24,1,0,0,713,0,0,136,53,82,54,2,2,52,26,12,11,70,27,254.9,252.9
11636,32ae3f0d43babd86,48d1f690b763934c,acff437707625fc7,2009-10-24,0,0,0,900,7,4,281,38,277,4,2,1,2,1,75,52,202,37,37.7,589.0
11637,32ae3f0d43babd86,acff437707625fc7,48d1f690b763934c,2009-10-24,0,1,0,900,0,0,154,23,154,0,0,0,0,0,3,2,151,23,0.0,843.3
11638,1298d89922befa8c,052ceb8976695342,ebc1f40e00e0c481,2009-10-24,0,1,0,244,1,1,23,4,8,15,5,2,10,3,2,2,6,1,78.5,88.0
11639,1298d89922befa8c,ebc1f40e00e0c481,052ceb8976695342,2009-10-24,0,3,1,244,1,1,16,7,6,10,0,0,10,7,5,5,1,0,67.0,98.5
11640,1238f31a41b78528,79899ecf62020f6d,f34312c2ccfa0e00,2009-10-24,1,0,0,543,7,2,53,28,23,30,0,0,30,24,2,0,21,4,270.0,264.0
11641,1238f31a41b78528,f34312c2ccfa0e00,79899ecf62020f6d,2009-10-24,0,0,0,543,0,0,44,3,44,0,0,0,0,0,15,11,29,3,0.0,273.0
11642,03c2cebad8d8c012,38b50fd1e1b5b656,b959e8c7fd8390d2,2009-10-24,0,0,0,900,4,1,79,13,78,1,0,0,1,0,29,18,49,13,14.2,540.4
11643,03c2cebad8d8c012,b959e8c7fd8390d2,38b50fd1e1b5b656,2009-10-24,0,0,0,900,6,2,98,8,92,6,2,2,4,1,27,15,65,7,131.6,556.8
11644,fd61b04ee64f7f20,d2d37e8eeb3abc8d,dd37fd509af89f15,2009-09-19,0,0,0,85,0,0,9,1,9,0,0,0,0,0,2,0,7,1,0.0,79.0
11645,fd61b04ee64f7f20,dd37fd509af89f15,d2d37e8eeb3abc8d,2009-09-19,1,0,0,85,0,0,17,8,11,6,0,0,6,6,3,1,8,2,6.0,79.0
11646,e314474cb6a7a65c,53278852bcd91e11,ccdd90bd1fc7dab6,2009-09-19,0,0,0,900,2,1,65,11,64,1,0,0,1,1,8,6,56,10,8.6,542.4
11647,e314474cb6a7a65c,ccdd90bd1fc7dab6,53278852bcd91e11,2009-09-19,0,1,0,900,5,4,106,38,88,18,1,1,17,8,5,5,83,30,314.6,489.4
11648,d359fe8a99250f64,497ba5b12a4bfc47,a08d909a5be6f410,2009-09-19,0,0,0,900,16,0,105,17,105,0,0,0,0,0,11,10,94,17,0.0,680.0
11649,d359fe8a99250f64,a08d909a5be6f410,497ba5b12a4bfc47,2009-09-19,0,0,0,900,0,0,117,24,117,0,0,0,0,0,6,5,111,24,0.0,876.0
11650,b272e9a4ed7a1b23,20205040232ed0f3,e0ec3c3b6b611f7e,2009-09-19,1,0,0,506,0,0,149,38,123,26,2,1,24,12,37,28,86,26,14.3,489.0
11651,b272e9a4ed7a1b23,e0ec3c3b6b611f7e,20205040232ed0f3,2009-09-19,0,0,0,506,0,0,71,5,71,0,0,0,0,0,10,6,61,5,0.0,491.7
11652,acfa3a3c0d09bb57,23725c826c481e7f,8b69839f3555a67b,2009-09-19,1,0,0,151,0,0,63,25,63,0,0,0,0,0,3,2,60,25,0.0,151.0
11653,acfa3a3c0d09bb57,8b69839f3555a67b,23725c826c481e7f,2009-09-19,0,0,0,151,2,0,35,9,35,0,0,0,0,0,3,3,32,9,0.0,131.0
11654,a2da03d9c25b49e5,1fd4fbdcc67de844,679a9054e2815943,2009-09-19,0,0,0,363,0,0,46,12,46,0,0,0,0,0,6,5,40,12,0.0,299.2
11655,a2da03d9c25b49e5,679a9054e2815943,1fd4fbdcc67de844,2009-09-19,0,1,1,363,7,3,73,24,66,7,0,0,7,3,7,7,59,21,63.8,208.0
11656,92ea4999f99f55fd,15b1b21cd743d652,6fb1ba67bef41b37,2009-09-19,0,0,0,900,7,4,110,24,97,13,1,1,12,3,8,4,89,21,125.9,455.4
11657,92ea4999f99f55fd,6fb1ba67bef41b37,15b1b21cd743d652,2009-09-19,0,4,0,900,5,4,136,35,112,24,8,8,16,10,32,24,80,25,105.6,576.1
11658,7b06e7f2b34d24b8,3dc3022232b79c7a,5b5307450405abf0,2009-09-19,0,1,0,369,2,0,47,4,46,1,0,0,1,0,5,2,41,4,0.8,150.3
11659,7b06e7f2b34d24b8,5b5307450405abf0,3dc3022232b79c7a,2009-09-19,0,1,1,369,4,3,59,13,46,13,2,2,11,5,4,3,42,8,213.7,105.2
11660,656e1040e6e007b2,282fa667ff9c51ed,83fd97284f4bb4a4,2009-09-19,0,0,0,216,0,0,53,3,53,0,0,0,0,0,10,3,43,3,0.0,213.5
11661,656e1040e6e007b2,83fd97284f4bb4a4,282fa667ff9c51ed,2009-09-19,1,0,0,216,1,1,32,8,29,3,0,0,3,2,5,2,24,6,2.5,211.0
11662,42a7d576dc207e63,6085ceb59087514b,d1941565abf50b16,2009-09-19,0,0,0,348,0,0,49,4,49,0,0,0,0,0,7,2,42,4,0.0,216.0
11663,42a7d576dc207e63,d1941565abf50b16,6085ceb59087514b,2009-09-19,1,1,0,348,1,0,87,23,65,22,0,0,22,11,11,7,54,12,132.0,210.0
11664,329a097e0b53daac,6a2f7c151031653d,dc0f07928009a127,2009-09-19,0,0,0,900,12,2,165,21,147,18,0,0,18,5,40,31,107,16,165.9,636.0
11665,329a097e0b53daac,dc0f07928009a127,6a2f7c151031653d,2009-09-19,0,0,0,900,1,0,172,16,169,3,0,0,3,1,16,11,153,15,6.0,714.1
11666,2ff09ddaa2b78cc4,63def5a5662a6917,c32fb8c0f6471a4d,2009-09-19,1,0,0,720,0,0,157,28,157,0,0,0,0,0,54,42,103,28,0.0,672.0
11667,2ff09ddaa2b78cc4,c32fb8c0f6471a4d,63def5a5662a6917,2009-09-19,0,0,0,720,1,0,49,13,49,0,0,0,0,0,13,9,36,13,0.0,697.0
11668,e83b214695941af1,53bb0d40905b87c0,5d7bdab5e03e3216,2009-09-16,0,2,0,900,1,0,44,14,40,4,0,0,4,3,7,5,33,11,24.3,349.4
11669,e83b214695941af1,5d7bdab5e03e3216,53bb0d40905b87c0,2009-09-16,0,2,0,900,10,6,55,20,23,32,7,4,25,15,11,8,12,5,471.6,256.7
11670,d6e75e0238d3ad9b,0b5b6876c2a4723f,aae99701b21554e4,2009-09-16,0,0,0,236,0,0,19,6,19,0,0,0,0,0,1,1,18,6,0.0,87.0
11671,d6e75e0238d3ad9b,aae99701b21554e4,0b5b6876c2a4723f,2009-09-16,0,1,1,236,1,1,17,7,8,9,0,0,9,5,2,2,6,2,130.0,106.0
11672,c1be2b862f737c18,579fcdfcabd23a7b,f1f9e48a0d150757,2009-09-16,0,0,0,900,5,0,178,16,178,0,0,0,0,0,36,28,142,16,0.0,894.0
11673,c1be2b862f737c18,f1f9e48a0d150757,579fcdfcabd23a7b,2009-09-16,0,0,0,900,1,0,154,16,154,0,0,0,0,0,28,19,126,16,0.0,900.0
11674,b589aba75770bc6b,52cae54377b433b7,89b8d1bf1ff09d1d,2009-09-16,2,0,0,900,0,0,131,37,74,57,2,2,55,13,24,14,50,24,449.5,399.0
11675,b589aba75770bc6b,89b8d1bf1ff09d1d,52cae54377b433b7,2009-09-16,1,1,0,900,0,0,162,31,159,3,0,0,3,2,10,9,149,29,20.0,410.5
11676,b4a81d7eb4e42c1c,7d96bc577e5178b2,daf1b84aebd6602b,2009-09-16,0,1,0,900,7,3,79,19,78,1,0,0,1,1,5,4,73,18,32.3,701.7
11677,b4a81d7eb4e42c1c,daf1b84aebd6602b,7d96bc577e5178b2,2009-09-16,0,0,0,900,0,0,166,22,165,1,0,0,1,1,32,18,133,21,4.3,807.7
11678,aceaa32be99719b0,d81ac739417d7f53,f9f07bb5a43535ed,2009-09-16,2,3,0,900,4,3,59,23,38,21,1,1,20,11,7,4,31,12,266.4,308.2
11679,aceaa32be99719b0,f9f07bb5a43535ed,d81ac739417d7f53,2009-09-16,0,1,0,900,2,1,70,21,38,32,2,2,30,17,7,4,31,4,185.8,395.6
11680,7c620723b6840231,a56607a451e4c70d,f5990c11974d8e9c,2009-09-16,0,1,0,735,2,1,55,9,55,0,0,0,0,0,25,10,30,9,0.0,279.0
11681,7c620723b6840231,f5990c11974d8e9c,a56607a451e4c70d,2009-09-16,0,2,1,735,6,2,41,8,32,9,0,0,9,7,8,4,24,1,376.0,359.0
11682,4553c3ab494c2d05,18968f97ad34f15c,231926533134ec1f,2009-09-16,2,0,0,203,0,0,50,22,36,14,1,0,13,6,6,6,30,16,14.0,177.0
11683,4553c3ab494c2d05,231926533134ec1f,18968f97ad34f15c,2009-09-16,0,0,0,203,0,0,49,5,49,0,0,0,0,0,6,4,43,5,0.0,189.0
11684,1287c631cb74f1d9,8355922d564b152c,ccd1299e0345e0ce,2009-09-16,0,2,1,433,2,2,73,13,73,0,0,0,0,0,11,8,62,13,0.0,330.9
11685,1287c631cb74f1d9,ccd1299e0345e0ce,8355922d564b152c,2009-09-16,1,0,0,433,3,3,42,5,38,4,0,0,4,0,6,6,32,5,19.1,390.0
11686,0454bfbc49e95c16,236a37d96d476164,5eedbf1e9601be35,2009-09-16,0,0,0,900,11,6,54,1,33,21,18,17,3,0,13,9,20,1,390.7,193.0
11687,0454bfbc49e95c16,5eedbf1e9601be35,236a37d96d476164,2009-09-16,0,1,0,900,0,0,33,7,33,0,0,0,0,0,5,4,28,7,0.0,460.3
11688,fd292c2a587bb2f5,179f1948dc234f1f,f8fe2053d73d7bcf,2009-08-29,0,2,0,900,12,2,102,34,82,20,0,0,20,13,21,19,61,21,107.8,566.2
11689,fd292c2a587bb2f5,f8fe2053d73d7bcf,179f1948dc234f1f,2009-08-29,0,1,0,900,6,3,82,21,68,14,10,10,4,3,9,7,59,18,85.8,602.2
11690,fa0d393a452c0809,219a254e15d60135,bda04c573563cc2e,2009-08-29,0,0,0,7,0,0,1,0,1,0,0,0,0,0,0,0,1,0,0.0,3.0
11691,fa0d393a452c0809,bda04c573563cc2e,219a254e15d60135,2009-08-29,1,0,0,7,0,0,5,4,1,4,0,0,4,3,0,0,1,1,4.0,3.0
11692,e3c9c95b67580b9b,4f2fcbefb668689d,d43a048a880efdff,2009-08-29,0,1,1,690,4,3,42,16,29,13,0,0,13,9,6,5,23,7,117.0,337.0
11693,e3c9c95b67580b9b,d43a048a880efdff,4f2fcbefb668689d,2009-08-29,0,0,0,690,1,1,43,6,40,3,0,0,3,2,14,8,26,4,209.0,364.0
11694,b0958ed411ae9675,04643fd03d9159cc,e5c9de15bb58b1c6,2009-08-29,0,1,0,900,15,3,102,24,95,7,0,0,7,2,3,3,92,22,98.4,610.4
11695,b0958ed411ae9675,e5c9de15bb58b1c6,04643fd03d9159cc,2009-08-29,1,0,0,900,1,1,161,52,149,12,0,0,12,5,7,6,142,47,36.6,740.6
11696,6d32a829217cf2fa,59583ff832fe9d68,fa315e6c77eee106,2009-08-29,0,0,0,900,5,1,127,18,127,0,0,0,0,0,34,23,93,18,0.0,736.0
11697,6d32a829217cf2fa,fa315e6c77eee106,59583ff832fe9d68,2009-08-29,0,0,0,900,1,1,134,16,133,1,0,0,1,1,58,46,75,15,5.0,714.0
11698,6ae10aa4c6dc986d,353de740bb6c7e75,75f871836d41f90f,2009-08-29,0,2,0,900,11,8,36,17,6,30,4,4,26,15,0,0,6,2,684.0,210.8
11699,6ae10aa4c6dc986d,75f871836d41f90f,353de740bb6c7e75,2009-08-29,0,0,0,900,0,0,58,9,56,2,0,0,2,0,4,2,52,9,5.2,185.0
11700,4d3297af1b7889ba,270b89c00ef0c55c,df05aa15b2d66f57,2009-08-29,1,0,0,147,0,0,27,20,2,25,1,1,24,19,1,1,1,1,117.0,30.0
11701,4d3297af1b7889ba,df05aa15b2d66f57,270b89c00ef0c55c,2009-08-29,0,0,0,147,0,0,1,0,0,1,0,0,1,0,0,0,0,0,0.0,30.0
11702,39f07708af6ecfc7,2924886ee9c4c527,b9d0fd83bb8a147a,2009-08-29,1,0,0,95,0,0,8,4,5,3,0,0,3,3,1,1,4,1,27.0,68.0
11703,39f07708af6ecfc7,b9d0fd83bb8a147a,2924886ee9c4c527,2009-08-29,0,0,0,95,0,0,17,1,17,0,0,0,0,0,2,2,15,1,0.0,68.0
11704,3445246f8e3eba24,427b5953ac8e3a27,a8e6a69796280f17,2009-08-29,0,0,0,21,0,0,2,0,2,0,0,0,0,0,1,0,1,0,0.0,21.0
11705,3445246f8e3eba24,a8e6a69796280f17,427b5953ac8e3a27,2009-08-29,1,0,0,21,0,0,1,1,1,0,0,0,0,0,0,0,1,1,0.0,20.0
11706,2a23f787fff1d837,0aa92558424ced9e,ee9d73f4fee9cbdd,2009-08-29,0,0,0,900,1,0,103,40,93,10,0,0,10,7,3,2,90,33,79.6,637.2
11707,2a23f787fff1d837,ee9d73f4fee9cbdd,0aa92558424ced9e,2009-08-29,2,3,0,900,0,0,96,21,95,1,0,0,1,1,8,6,87,20,55.8,485.4
11708,2711e57bbef4d928,06f36cf4bd97ec77,d5f820c11a121050,2009-08-29,0,0,0,317,0,0,32,5,31,1,0,0,1,1,3,2,28,4,0.0,149.6
11709,2711e57bbef4d928,d5f820c11a121050,06f36cf4bd97ec77,2009-08-29,1,0,0,317,3,3,50,21,23,27,2,1,25,13,3,3,20,8,167.4,131.0
11710,faec13fd40b6d797,7f955f71fa2ce7ac,cfb65863d5099327,2009-08-08,0,0,0,900,0,0,83,18,78,5,0,0,5,2,8,6,70,16,33.0,721.3
11711,faec13fd40b6d797,cfb65863d5099327,7f955f71fa2ce7ac,2009-08-08,0,0,0,900,12,4,102,15,83,19,0,0,19,8,7,7,76,7,145.7,706.0
11712,ef6a0ee848382391,eff47295daf721a6,fc31f896cde2bc2e,2009-08-08,0,1,0,900,6,2,46,8,36,10,0,0,10,3,4,3,32,5,140.0,211.0
11713,ef6a0ee848382391,fc31f896cde2bc2e,eff47295daf721a6,2009-08-08,0,1,0,900,7,5,37,5,21,16,9,6,7,5,9,8,12,0,507.0,253.0
11714,ea9edb20f527b49e,3ae10ac4df3df05c,fd87b1bbfcde9d5e,2009-08-08,1,0,0,817,2,1,114,24,102,12,4,4,8,4,16,9,86,20,38.3,719.0
11715,ea9edb20f527b49e,fd87b1bbfcde9d5e,3ae10ac4df3df05c,2009-08-08,0,1,0,817,2,1,114,18,103,11,6,6,5,3,28,19,75,15,31.0,716.7
11716,de495aa2ec1f1e91,1f454354805b6f75,fcffee71cff5530e,2009-08-08,3,0,0,203,0,0,25,12,19,6,0,0,6,5,1,1,18,7,14.2,184.0
11717,de495aa2ec1f1e91,fcffee71cff5530e,1f454354805b6f75,2009-08-08,0,0,0,203,0,0,42,1,42,0,0,0,0,0,7,2,35,1,0.0,188.8
11718,b71f07f052d0a48b,aa1952ec0b3dd8e1,d1a1314976c50bef,2009-08-08,0,0,0,900,5,3,48,17,20,28,1,1,27,10,5,3,15,7,738.0,140.6
11719,b71f07f052d0a48b,d1a1314976c50bef,aa1952ec0b3dd8e1,2009-08-08,0,1,0,900,0,0,48,20,37,11,0,0,11,10,6,4,31,10,21.4,129.0
11720,a9dc59e90779c1e3,234f3767ff0e5701,91186547a7f3f758,2009-08-08,0,2,0,900,0,0,62,13,52,10,1,1,9,6,11,11,41,7,19.0,232.60000000000002
11721,a9dc59e90779c1e3,91186547a7f3f758,234f3767ff0e5701,2009-08-08,0,0,0,900,14,6,62,23,23,39,8,7,31,15,9,8,14,8,610.4,208.0
11722,8ead66bc1678519b,3c0437fbeda06962,896c322f56b8be5a,2009-08-08,0,0,0,419,0,0,46,2,42,4,0,0,4,0,4,3,38,2,12.0,183.9
11723,8ead66bc1678519b,896c322f56b8be5a,3c0437fbeda06962,2009-08-08,0,1,1,419,5,3,33,10,24,9,0,0,9,2,4,4,20,8,211.1,149.0
11724,73a4a092c1850b57,73c7cfa551289285,cb139171ed1b69fe,2009-08-08,0,1,1,1134,3,1,94,32,76,18,5,5,13,10,22,20,54,22,80.7,844.1
11725,73a4a092c1850b57,cb139171ed1b69fe,73c7cfa551289285,2009-08-08,0,0,0,1134,15,0,58,7,56,2,0,0,2,2,18,12,38,5,38.9,742.3
11726,6a61d45818534b19,2db7fa8db6bc9632,f2c8ebbeafd45f2b,2009-08-08,0,0,0,900,5,0,74,13,74,0,0,0,0,0,15,15,59,13,0.0,772.2
11727,6a61d45818534b19,f2c8ebbeafd45f2b,2db7fa8db6bc9632,2009-08-08,0,0,0,900,5,2,122,28,109,13,0,0,13,10,26,22,83,18,126.8,432.0
11728,5a8c92dfbb16d26f,480b702debcb5433,d023ae89a2a4a41e,2009-08-08,0,1,0,900,2,0,28,4,23,5,0,0,5,1,1,1,22,3,53.9,245.5
11729,5a8c92dfbb16d26f,d023ae89a2a4a41e,480b702debcb5433,2009-08-08,0,2,0,900,7,2,67,29,24,43,10,10,33,26,9,8,15,3,557.5,120.1
11730,28037f9be7e0781a,0941df56f6ac954b,2650e2f846a30f64,2009-08-08,1,0,0,29,0,0,15,7,10,5,0,0,5,0,0,0,10,7,1.0,27.0
11731,28037f9be7e0781a,2650e2f846a30f64,0941df56f6ac954b,2009-08-08,0,0,0,29,0,0,9,1,9,0,0,0,0,0,3,1,6,1,0.0,28.0
11732,f8896b43f4ecf861,4d44f37107f01b9b,5d7bdab5e03e3216,2009-07-11,0,1,1,55,0,0,1,0,1,0,0,0,0,0,0,0,1,0,0.0,55.0
11733,f8896b43f4ecf861,5d7bdab5e03e3216,4d44f37107f01b9b,2009-07-11,0,0,0,55,0,0,5,1,5,0,0,0,0,0,0,0,5,1,0.0,34.0
11734,f885b95dbb354e3d,21b8a0f5c231096f,c6a33ff198aaaeeb,2009-07-11,0,0,0,900,9,3,36,18,12,24,2,2,22,14,0,0,12,4,589.0,187.2
11735,f885b95dbb354e3d,c6a33ff198aaaeeb,21b8a0f5c231096f,2009-07-11,0,3,0,900,0,0,60,23,30,30,2,1,28,19,3,2,27,4,123.8,150.0
11736,d9c3d7b09d8df3e4,86f582852a5b240a,d1941565abf50b16,2009-07-11,0,1,0,900,0,0,57,13,47,10,0,0,10,7,8,7,39,6,21.5,310.1
11737,d9c3d7b09d8df3e4,d1941565abf50b16,86f582852a5b240a,2009-07-11,0,1,0,900,7,6,91,24,57,34,4,4,30,14,10,9,47,10,561.9,250.5
11738,b6234bf015c80fc5,9bcf8603ceb25680,a26198ba5093147e,2009-07-11,0,1,0,900,5,4,59,25,23,36,2,2,34,18,2,2,21,7,562.5,250.5
11739,b6234bf015c80fc5,a26198ba5093147e,9bcf8603ceb25680,2009-07-11,0,0,0,900,5,1,44,7,41,3,1,1,2,2,20,14,21,5,24.5,198.5
11740,b0dfb313364a7c80,31ee470ef5dc8d7f,6506c1d34da9c013,2009-07-11,0,0,0,1500,0,0,162,14,142,20,1,1,19,6,28,15,114,8,53.3,660.5
11741,b0dfb313364a7c80,6506c1d34da9c013,31ee470ef5dc8d7f,2009-07-11,1,1,0,1500,12,10,128,35,106,22,1,1,21,13,31,23,75,22,759.5,652.7
11742,8df2751dcbfa0fa2,1ff9589f9065a9ed,513c6f1715e547a8,2009-07-11,0,0,0,408,0,0,12,2,12,0,0,0,0,0,2,2,10,2,0.0,62.0
11743,8df2751dcbfa0fa2,513c6f1715e547a8,1ff9589f9065a9ed,2009-07-11,1,0,0,408,1,1,51,41,5,46,4,4,42,40,2,2,3,1,346.0,62.0
11744,6f6158830b01ea27,07f72a2a7591b409,20bcc9966affb19c,2009-07-11,0,1,1,463,0,0,87,11,87,0,0,0,0,0,24,14,63,11,0.0,429.0
11745,6f6158830b01ea27,20bcc9966affb19c,07f72a2a7591b409,2009-07-11,0,0,0,463,4,0,68,11,68,0,0,0,0,0,0,0,68,11,0.0,460.0
11746,6d1093a1c31dab94,1ccf4e7caff270df,2b93ebd9f5417ad2,2009-07-11,1,0,0,500,0,0,98,17,97,1,0,0,1,1,15,12,82,16,1.9,473.0
11747,6d1093a1c31dab94,2b93ebd9f5417ad2,1ccf4e7caff270df,2009-07-11,0,0,0,500,1,0,109,16,109,0,0,0,0,0,9,6,100,16,0.0,492.1
11748,55bcf58be822d115,9f1641c08cf8fbe2,bfc2fc38a0e20211,2009-07-11,0,2,1,156,1,1,10,1,9,1,0,0,1,1,5,0,4,0,18.2,83.0
11749,55bcf58be822d115,bfc2fc38a0e20211,9f1641c08cf8fbe2,2009-07-11,0,0,0,156,0,0,8,0,8,0,0,0,0,0,6,4,2,0,0.0,101.8
11750,55833bf5054126e2,30a09e43f15f1d75,6f018c039b4d5d80,2009-07-11,0,5,0,900,2,0,11,3,9,2,0,0,2,1,2,2,7,2,41.5,261.20000000000005
11751,55833bf5054126e2,6f018c039b4d5d80,30a09e43f15f1d75,2009-07-11,0,1,0,900,4,4,34,9,25,9,2,2,7,6,8,4,17,3,555.8,117.5
11752,15705df8ba8dcbe1,4130a743d9d22163,b0550072e5f0afa7,2009-07-11,1,0,0,900,0,0,156,39,153,3,0,0,3,2,48,37,105,37,11.0,676.9
11753,15705df8ba8dcbe1,b0550072e5f0afa7,4130a743d9d22163,2009-07-11,0,0,0,900,4,3,156,50,141,15,2,1,13,5,5,4,136,45,179.1,698.0
11754,a5a5e24f4dd40fbf,75e5fec9f72910ef,ccd1299e0345e0ce,2009-06-20,0,0,0,900,14,6,50,8,39,11,2,1,9,3,7,5,32,5,297.0,387.0
11755,a5a5e24f4dd40fbf,ccd1299e0345e0ce,75e5fec9f72910ef,2009-06-20,0,0,0,900,4,1,50,4,50,0,0,0,0,0,11,9,39,4,0.0,593.0
11756,707d6023b8723c5d,5b407acfe0ef9b76,edd8d5d8089a35f8,2009-06-20,0,1,1,220,1,1,30,3,29,1,0,0,1,0,17,11,12,3,6.7,80.0
11757,707d6023b8723c5d,edd8d5d8089a35f8,5b407acfe0ef9b76,2009-06-20,0,0,0,220,2,0,22,1,22,0,0,0,0,0,13,7,9,1,0.0,209.3
11758,4ae231bd909ceddc,91acd6910b802a9e,a6d8bfe9e0c8153b,2009-06-20,0,0,0,900,3,0,247,65,247,0,0,0,0,0,48,36,199,65,0.0,882.5
11759,4ae231bd909ceddc,a6d8bfe9e0c8153b,91acd6910b802a9e,2009-06-20,1,0,0,900,1,1,195,36,192,3,0,0,3,1,40,33,152,35,3.5,879.0
11760,468d6da7f097e449,82e7929bf6c2b689,c47df9303d318c67,2009-06-20,1,3,0,900,2,1,144,63,116,28,1,1,27,16,5,4,111,47,49.9,402.6
11761,468d6da7f097e449,c47df9303d318c67,82e7929bf6c2b689,2009-06-20,0,0,0,900,7,2,96,20,67,29,2,2,27,8,9,7,58,12,431.4,374.1
11762,43712d71cec9bde6,3bbcd63a016d9715,fa8b9e6b0c2269f8,2009-06-20,0,0,0,286,1,0,63,18,63,0,0,0,0,0,7,6,56,18,0.0,281.0
11763,43712d71cec9bde6,fa8b9e6b0c2269f8,3bbcd63a016d9715,2009-06-20,0,1,1,286,0,0,36,4,36,0,0,0,0,0,11,10,25,4,0.0,256.0
11764,1d30430af5257347,4f732e58ed907eff,b45d6b73f4ca4467,2009-06-20,0,0,0,900,7,0,129,37,129,0,0,0,0,0,45,37,84,37,0.0,673.0
11765,1d30430af5257347,b45d6b73f4ca4467,4f732e58ed907eff,2009-06-20,0,0,0,900,2,0,86,21,86,0,0,0,0,0,32,25,54,21,0.0,539.0
11766,11871325db7a13ec,79899ecf62020f6d,8355922d564b152c,2009-06-20,0,1,0,900,14,8,47,5,17,30,18,18,12,2,4,4,13,3,477.8,212.0
11767,11871325db7a13ec,8355922d564b152c,79899ecf62020f6d,2009-06-20,0,4,0,900,2,1,29,4,26,3,0,0,3,1,3,2,23,3,51.0,286.2
11768,08c5dcd426dea606,7e69a4b0961aa555,8d49545dadf9b919,2009-06-20,0,1,0,900,1,0,162,36,162,0,0,0,0,0,46,30,116,36,0.0,894.0
11769,08c5dcd426dea606,8d49545dadf9b919,7e69a4b0961aa555,2009-06-20,0,0,0,900,3,1,185,29,185,0,0,0,0,0,12,10,173,29,0.0,893.0
11770,0486ad62f7dfd11e,51b0bb73a1da34bc,679a9054e2815943,2009-06-20,0,0,0,288,1,0,6,3,6,0,0,0,0,0,0,0,6,3,0.0,208.6
11771,0486ad62f7dfd11e,679a9054e2815943,51b0bb73a1da34bc,2009-06-20,1,0,0,288,5,4,61,26,42,19,0,0,19,12,1,1,41,14,79.4,125.0
11772,036bb5b335e93ca8,322a56923b396b4d,852454c572675334,2009-06-20,0,0,0,294,0,0,21,11,14,7,0,0,7,6,3,2,11,5,44.3,194.0
11773,036bb5b335e93ca8,852454c572675334,322a56923b396b4d,2009-06-20,0,8,1,294,2,2,29,11,26,3,1,1,2,1,6,5,20,10,24.0,113.7
11774,f25d324841223f26,28f3c2258a1d8874,5b5307450405abf0,2009-06-13,0,3,0,900,10,4,85,9,79,6,2,2,4,1,30,20,49,8,84.8,344.6
11775,f25d324841223f26,5b5307450405abf0,28f3c2258a1d8874,2009-06-13,0,5,0,900,4,4,67,9,54,13,0,0,13,5,17,12,37,4,145.4,569.2
11776,df28f8cb5a12ec8e,484acc7b0f856ce9,9fe85152f351e737,2009-06-13,0,0,0,527,1,0,31,1,31,0,0,0,0,0,21,16,10,1,0.0,373.6
11777,df28f8cb5a12ec8e,9fe85152f351e737,484acc7b0f856ce9,2009-06-13,1,1,0,527,1,1,35,8,29,6,0,0,6,2,3,2,26,6,115.4,200.0
11778,cfacff39c9f3b2f9,eb1723480fa2f96c,f34312c2ccfa0e00,2009-06-13,0,0,0,900,15,3,47,12,34,13,3,2,10,6,11,10,23,6,225.2,431.6
11779,cfacff39c9f3b2f9,f34312c2ccfa0e00,eb1723480fa2f96c,2009-06-13,0,0,0,900,2,1,85,12,73,12,11,11,1,1,43,39,30,11,35.4,488.8
11780,cd45a78028039f53,37b1696e6d115957,aac5ac38148f0528,2009-06-13,0,3,0,900,5,1,28,6,26,2,0,0,2,2,12,8,14,4,121.5,192.10000000000002
11781,cd45a78028039f53,aac5ac38148f0528,37b1696e6d115957,2009-06-13,0,2,0,900,1,1,74,27,23,51,5,5,46,25,1,0,22,2,464.9,304.5
11782,bb0794053766a866,058e4e08a1ad8aba,5f87a5c00b3d17ed,2009-06-13,0,0,0,203,1,1,16,1,16,0,0,0,0,0,4,4,12,1,0.0,103.0
11783,bb0794053766a866,5f87a5c00b3d17ed,058e4e08a1ad8aba,2009-06-13,0,2,1,203,0,0,23,4,20,3,0,0,3,2,5,4,15,2,71.0,132.0
11784,83314e1ed6f7d94e,1fcfc3709fe58151,9b74de674c355425,2009-06-13,0,0,0,900,7,2,39,5,39,0,0,0,0,0,17,13,22,5,0.0,553.6
11785,83314e1ed6f7d94e,9b74de674c355425,1fcfc3709fe58151,2009-06-13,0,0,0,900,0,0,102,16,94,8,0,0,8,3,47,30,47,13,218.4,627.0
11786,440936f9db783997,a421465acbe59c77,ebc1f40e00e0c481,2009-06-13,0,0,0,457,0,0,60,14,6,54,2,2,52,14,0,0,6,0,282.8,169.0
11787,440936f9db783997,ebc1f40e00e0c481,a421465acbe59c77,2009-06-13,0,7,1,457,1,0,6,1,6,0,0,0,0,0,4,3,2,1,0.0,46.19999999999999
11788,3b44d0179f94726c,1cf1310684a841f5,c32fb8c0f6471a4d,2009-06-13,0,0,0,186,2,0,25,2,25,0,0,0,0,0,6,5,19,2,0.0,173.5
11789,3b44d0179f94726c,c32fb8c0f6471a4d,1cf1310684a841f5,2009-06-13,1,0,0,186,1,1,35,15,29,6,0,0,6,2,1,1,28,13,7.5,171.0
11790,11ca5d09db47708b,473ce3aa581251a2,b7d524c77c27389b,2009-06-13,1,0,0,900,1,1,61,14,48,13,2,2,11,4,16,12,32,10,123.5,435.5
11791,11ca5d09db47708b,b7d524c77c27389b,473ce3aa581251a2,2009-06-13,0,3,0,900,6,2,41,11,35,6,0,0,6,4,12,8,23,7,198.5,412.5
11792,0d09e95e85efad69,231926533134ec1f,33011768c3c4dc9a,2009-06-13,1,0,0,458,1,0,66,18,46,20,2,1,18,6,8,4,38,12,82.9,335.5
11793,0d09e95e85efad69,33011768c3c4dc9a,231926533134ec1f,2009-06-13,0,3,1,458,0,0,50,13,49,1,0,0,1,0,17,14,32,13,6.5,271.1
11794,09e7db36cd72bf61,0ff11cc094e887bc,1eacf73d6a0055dc,2009-06-13,0,2,0,900,10,7,53,23,14,39,7,6,32,20,0,0,14,3,742.0,102.0
11795,09e7db36cd72bf61,1eacf73d6a0055dc,0ff11cc094e887bc,2009-06-13,0,0,0,900,3,1,34,11,28,6,1,1,5,3,9,9,19,8,18.0,107.0
11796,f1423b63d81c88ea,219a254e15d60135,658c3465581ae46b,2009-05-23,0,1,1,102,1,1,5,0,5,0,0,0,0,0,0,0,5,0,0.0,58.0
11797,f1423b63d81c88ea,658c3465581ae46b,219a254e15d60135,2009-05-23,0,0,0,102,0,0,11,3,11,0,0,0,0,0,0,0,11,3,0.0,102.0
11798,eb23f3574b656624,029880cdbf5ca089,f2688492b9a525a3,2009-05-23,0,0,0,900,3,1,204,22,204,0,0,0,0,0,7,5,197,22,0.0,875.0
11799,eb23f3574b656624,f2688492b9a525a3,029880cdbf5ca089,2009-05-23,0,1,0,900,7,1,191,44,191,0,0,0,0,0,39,30,152,44,0.0,855.0
11800,dd400f38c483f629,59583ff832fe9d68,cc300e9aa3063431,2009-05-23,1,0,0,197,0,0,50,15,48,2,0,0,2,2,4,3,44,13,8.0,181.0
11801,dd400f38c483f629,cc300e9aa3063431,59583ff832fe9d68,2009-05-23,0,0,0,197,0,0,33,3,33,0,0,0,0,0,20,14,13,3,0.0,186.0
11802,d1e144ce44599f3a,621a6c59f88a44fe,86dfed7cc24a9fa7,2009-05-23,0,0,0,900,5,3,58,14,34,24,12,12,12,6,9,8,25,8,396.0,359.6
11803,d1e144ce44599f3a,86dfed7cc24a9fa7,621a6c59f88a44fe,2009-05-23,1,0,0,900,1,1,41,9,35,6,0,0,6,3,13,5,22,6,45.4,451.0
11804,b9be472f456cac79,5eedbf1e9601be35,f5990c11974d8e9c,2009-05-23,0,1,1,186,1,1,10,2,3,7,2,2,5,2,0,0,3,0,128.0,58.0
11805,b9be472f456cac79,f5990c11974d8e9c,5eedbf1e9601be35,2009-05-23,0,0,0,186,0,0,4,1,4,0,0,0,0,0,3,0,1,1,0.0,58.0
11806,b4bf090eb5c57903,64360e618823a8e4,a6959da32f0e6b5d,2009-05-23,0,0,0,63,0,0,11,1,11,0,0,0,0,0,4,2,7,1,0.0,55.8
11807,b4bf090eb5c57903,a6959da32f0e6b5d,64360e618823a8e4,2009-05-23,1,0,0,63,1,1,11,4,7,4,0,0,4,3,4,3,3,1,7.2,54.0
11808,62fbd9d089a9a306,1fd4fbdcc67de844,ec33146e43e58933,2009-05-23,2,0,0,37,0,0,12,8,6,6,0,0,6,3,0,0,6,5,6.7,27.0
11809,62fbd9d089a9a306,ec33146e43e58933,1fd4fbdcc67de844,2009-05-23,0,0,0,37,0,0,0,0,0,0,0,0,0,0,0,0,0,0,0.0,30.3
11810,54d14f98d4a83def,aa79d5399571068e,ab8900ae1f1dfd4c,2009-05-23,0,0,0,144,1,0,5,0,5,0,0,0,0,0,2,2,3,0,0.0,112.0
11811,54d14f98d4a83def,ab8900ae1f1dfd4c,aa79d5399571068e,2009-05-23,0,1,1,144,0,0,6,0,6,0,0,0,0,0,5,4,1,0,0.0,77.0
11812,5060770f197e2147,3c0437fbeda06962,5669b828e7e11329,2009-05-23,0,0,0,900,0,0,226,47,224,2,1,1,1,1,24,14,200,46,0.0,821.5
11813,5060770f197e2147,5669b828e7e11329,3c0437fbeda06962,2009-05-23,0,0,0,900,14,5,105,10,104,1,0,0,1,1,50,40,54,9,78.5,586.0
11814,1e87e0e4da55c92f,48d1f690b763934c,d0c29452d3272603,2009-05-23,0,0,0,900,5,3,61,26,12,49,5,5,44,23,5,5,7,3,832.0,68.0
11815,1e87e0e4da55c92f,d0c29452d3272603,48d1f690b763934c,2009-05-23,0,2,0,900,0,0,21,6,21,0,0,0,0,0,5,3,16,6,0.0,67.0
11816,15750dc75b7426f3,ee779c43a8926d52,f7a7f7118d4b01b6,2009-05-23,0,0,0,537,0,0,24,2,24,0,0,0,0,0,4,2,20,2,0.0,520.3
11817,15750dc75b7426f3,f7a7f7118d4b01b6,ee779c43a8926d52,2009-05-23,3,0,0,537,2,0,46,17,41,5,0,0,5,2,13,11,28,15,16.7,507.0
11818,de84ebe3b8cb8cd3,501b07aec9b8fc2d,eb29176b03dfa888,2009-04-18,1,0,0,900,0,0,186,31,174,12,0,0,12,4,37,31,137,27,92.0,572.1
11819,de84ebe3b8cb8cd3,eb29176b03dfa888,501b07aec9b8fc2d,2009-04-18,0,2,0,900,11,4,104,30,99,5,0,0,5,3,22,16,77,27,166.9,541.0
11820,d29dd21d8881a0e0,140745cbbcb023ac,a390eb8a9b2df298,2009-04-18,1,0,0,268,1,0,32,14,25,7,0,0,7,7,10,10,15,7,16.5,242.0
11821,d29dd21d8881a0e0,a390eb8a9b2df298,140745cbbcb023ac,2009-04-18,0,0,0,268,1,1,37,8,37,0,0,0,0,0,2,0,35,8,0.0,230.5
11822,c6a5ed1127cbc9b9,88a9bc81271ccd89,a08d909a5be6f410,2009-04-18,0,0,0,900,3,2,148,21,128,20,6,3,14,6,16,10,112,15,57.4,834.0
11823,c6a5ed1127cbc9b9,a08d909a5be6f410,88a9bc81271ccd89,2009-04-18,0,0,0,900,0,0,164,23,164,0,0,0,0,0,28,21,136,23,0.0,842.6
11824,bdb62b661d033fe2,1efa064872f089d0,cf9d24e4bd0cf2ce,2009-04-18,0,0,0,297,0,0,5,0,5,0,0,0,0,0,4,4,1,0,0.0,57.900000000000006
11825,bdb62b661d033fe2,cf9d24e4bd0cf2ce,1efa064872f089d0,2009-04-18,0,1,1,297,2,1,43,17,5,38,0,0,38,16,3,3,2,1,217.1,57.0
11826,bcba81de8f082768,1eacf73d6a0055dc,69b69c0178c4004d,2009-04-18,1,0,0,449,3,2,84,24,46,38,14,10,24,14,19,19,27,10,223.5,149.0
11827,bcba81de8f082768,69b69c0178c4004d,1eacf73d6a0055dc,2009-04-18,0,0,0,449,0,0,20,1,20,0,0,0,0,0,9,8,11,1,0.0,225.5
11828,793432d042384a02,2be6596a9db33bf5,52cae54377b433b7,2009-04-18,0,0,0,147,1,0,1,0,1,0,0,0,0,0,1,1,0,0,0.0,16.200000000000003
11829,793432d042384a02,52cae54377b433b7,2be6596a9db33bf5,2009-04-18,1,0,0,147,1,1,34,15,2,32,0,0,32,15,1,1,1,0,103.8,40.0
11830,7291a111058dbf0e,1f454354805b6f75,cfb65863d5099327,2009-04-18,0,0,0,1500,0,0,139,35,110,29,16,12,13,12,52,47,58,23,145.0,1229.7
11831,7291a111058dbf0e,cfb65863d5099327,1f454354805b6f75,2009-04-18,0,0,0,1500,14,1,54,3,52,2,0,0,2,0,12,7,40,3,105.3,1197.0
11832,226de3e7e71f2b4f,55a7b2d4e54ffac9,a26198ba5093147e,2009-04-18,0,0,0,900,2,2,75,27,35,40,1,1,39,16,3,3,32,11,510.7,275.8
11833,226de3e7e71f2b4f,a26198ba5093147e,55a7b2d4e54ffac9,2009-04-18,0,0,0,900,4,3,76,24,66,10,1,1,9,5,12,9,54,19,75.2,186.3
11834,1f64e532f942ef57,579fcdfcabd23a7b,59583ff832fe9d68,2009-04-18,0,0,0,233,0,0,18,4,18,0,0,0,0,0,5,4,13,4,0.0,224.0
11835,1f64e532f942ef57,59583ff832fe9d68,579fcdfcabd23a7b,2009-04-18,0,2,1,233,2,2,11,0,11,0,0,0,0,0,6,3,5,0,0.0,126.0
11836,154da5e0d8541508,3c241737a6069b9f,ec33146e43e58933,2009-04-18,0,1,0,900,6,5,65,25,41,24,1,1,23,18,9,5,32,7,371.6,418.5
11837,154da5e0d8541508,ec33146e43e58933,3c241737a6069b9f,2009-04-18,0,0,0,900,0,0,53,8,51,2,1,1,1,0,18,14,33,8,1.5,522.4
11838,0bf025d86cc2a409,24b033b3daf1c9df,f1f9e48a0d150757,2009-04-18,0,0,0,900,1,0,223,66,223,0,0,0,0,0,25,21,198,66,0.0,887.0
11839,0bf025d86cc2a409,f1f9e48a0d150757,24b033b3daf1c9df,2009-04-18,0,0,0,900,0,0,189,37,189,0,0,0,0,0,38,32,151,37,0.0,898.0
11840,06142a1de3bbae75,06f36cf4bd97ec77,22e47b53e4ceb27c,2009-04-18,0,0,0,900,9,5,84,25,20,64,31,29,33,24,17,17,3,1,558.0,176.5
11841,06142a1de3bbae75,22e47b53e4ceb27c,06f36cf4bd97ec77,2009-04-18,0,0,0,900,0,0,16,4,15,1,0,0,1,0,2,2,13,4,8.5,308.0
11842,f1100f1bc6cbb351,20205040232ed0f3,6a2f7c151031653d,2009-04-01,0,0,0,900,4,1,213,40,198,15,3,2,12,7,36,27,162,33,111.5,729.0
11843,f1100f1bc6cbb351,6a2f7c151031653d,20205040232ed0f3,2009-04-01,0,3,0,900,1,0,134,18,134,0,0,0,0,0,14,8,120,18,0.0,783.5
11844,ddc233f8ca7c05aa,9ca265dfe8323db3,d5f820c11a121050,2009-04-01,0,0,0,100,0,0,4,1,4,0,0,0,0,0,0,0,4,1,0.0,40.0
11845,ddc233f8ca7c05aa,d5f820c11a121050,9ca265dfe8323db3,2009-04-01,1,0,0,100,1,1,27,11,7,20,1,1,19,10,4,4,3,1,60.0,34.0
11846,c642640db89fb033,89b8d1bf1ff09d1d,f8fe2053d73d7bcf,2009-04-01,0,7,1,525,0,0,39,6,39,0,0,0,0,0,5,3,34,6,0.0,170.0
11847,c642640db89fb033,f8fe2053d73d7bcf,89b8d1bf1ff09d1d,2009-04-01,0,0,0,525,3,3,37,14,22,15,1,1,14,10,7,4,15,4,331.0,194.0
11848,ae68274ab6f78cd8,8b69839f3555a67b,f9f07bb5a43535ed,2009-04-01,0,6,0,900,5,5,61,20,40,21,0,0,21,11,8,6,32,9,327.6,376.8
11849,ae68274ab6f78cd8,f9f07bb5a43535ed,8b69839f3555a67b,2009-04-01,0,3,0,900,4,3,86,20,77,9,0,0,9,8,16,15,61,12,55.2,382.4
11850,a7d42315236560e9,aa03a3ca00ac6827,c0ab242c40decc55,2009-04-01,0,0,0,900,0,0,43,6,41,2,0,0,2,1,6,3,35,5,20.3,302.9
11851,a7d42315236560e9,c0ab242c40decc55,aa03a3ca00ac6827,2009-04-01,0,2,0,900,7,5,56,17,33,23,3,2,20,12,7,5,26,5,536.1,273.7
11852,a561360edf66ee6f,054defd5420a551f,d35c3ed553b71fa2,2009-04-01,0,2,1,114,0,0,15,5,15,0,0,0,0,0,3,2,12,5,0.0,104.0
11853,a561360edf66ee6f,d35c3ed553b71fa2,054defd5420a551f,2009-04-01,0,0,0,114,1,1,12,4,12,0,0,0,0,0,1,0,11,4,0.0,51.0
11854,9c7a67ce1d6a01f9,18968f97ad34f15c,75e5fec9f72910ef,2009-04-01,0,0,0,900,0,0,40,8,34,6,1,1,5,3,16,14,18,5,11.7,399.8
11855,9c7a67ce1d6a01f9,75e5fec9f72910ef,18968f97ad34f15c,2009-04-01,0,3,0,900,13,5,20,5,14,6,0,0,6,2,2,2,12,3,455.2,281.3
11856,4cffb137402f7bb0,cb46dface0e28a2c,d632d156c0549e07,2009-04-01,1,0,0,900,8,4,48,13,39,9,0,0,9,5,19,16,20,8,127.2,379.0
11857,4cffb137402f7bb0,d632d156c0549e07,cb46dface0e28a2c,2009-04-01,0,1,0,900,8,1,70,11,56,14,3,2,11,4,24,22,32,7,97.0,481.8
11858,4b9203b86f0aa870,049d698d773eb3e1,91186547a7f3f758,2009-04-01,0,3,0,900,2,0,39,3,39,0,0,0,0,0,25,22,14,3,0.0,442.0
11859,4b9203b86f0aa870,91186547a7f3f758,049d698d773eb3e1,2009-04-01,0,1,0,900,15,9,67,32,51,16,0,0,16,11,11,9,40,21,334.0,399.0
11860,47e17513aae45a95,59aaf2730b84698a,5eedbf1e9601be35,2009-04-01,0,0,0,121,0,0,3,0,3,0,0,0,0,0,1,0,2,0,0.0,34.0
11861,47e17513aae45a95,5eedbf1e9601be35,59aaf2730b84698a,2009-04-01,0,1,1,121,2,1,20,13,2,18,0,0,18,13,0,0,2,0,87.0,34.0
11862,33e576af1d064e4e,282fa667ff9c51ed,d74cba8566291bfa,2009-04-01,0,1,1,118,0,0,16,1,16,0,0,0,0,0,3,2,13,1,0.0,118.0
11863,33e576af1d064e4e,d74cba8566291bfa,282fa667ff9c51ed,2009-04-01,0,0,0,118,1,0,3,0,3,0,0,0,0,0,1,1,2,0,0.0,52.0
11864,d9d7e8e9149e61b1,234f3767ff0e5701,a6fd2173d5e2d7f0,2009-03-07,1,0,0,92,0,0,25,8,21,4,0,0,4,4,5,2,16,4,1.5,89.0
11865,d9d7e8e9149e61b1,a6fd2173d5e2d7f0,234f3767ff0e5701,2009-03-07,0,0,0,92,0,0,25,4,25,0,0,0,0,0,3,2,22,4,0.0,90.5
11866,798ca95afb5875ef,179f1948dc234f1f,98b80a717b9bda17,2009-03-07,0,0,0,233,4,0,37,11,37,0,0,0,0,0,5,3,32,11,0.0,228.2
11867,798ca95afb5875ef,98b80a717b9bda17,179f1948dc234f1f,2009-03-07,1,0,0,233,0,0,47,18,46,1,0,0,1,1,5,5,41,17,3.8,214.0
11868,789a8911fcd6de13,7d96bc577e5178b2,d1941565abf50b16,2009-03-07,0,0,0,900,1,1,93,25,85,8,1,1,7,3,14,11,71,22,76.9,775.0
11869,789a8911fcd6de13,d1941565abf50b16,7d96bc577e5178b2,2009-03-07,0,1,0,900,8,0,100,9,100,0,0,0,0,0,21,16,79,9,0.0,737.1
11870,731a3120fdffa44c,83d0de122f2f9664,fa315e6c77eee106,2009-03-07,0,0,0,387,0,0,28,3,28,0,0,0,0,0,3,2,25,3,0.0,387.0
11871,731a3120fdffa44c,fa315e6c77eee106,83d0de122f2f9664,2009-03-07,2,0,0,387,0,0,75,11,75,0,0,0,0,0,26,21,49,11,0.0,376.0
11872,39b79764bbac93cb,497ba5b12a4bfc47,c80095f6092271a7,2009-03-07,0,1,0,900,8,4,103,16,87,16,4,4,12,5,19,14,68,11,206.7,422.0
11873,39b79764bbac93cb,c80095f6092271a7,497ba5b12a4bfc47,2009-03-07,0,0,0,900,0,0,65,22,65,0,0,0,0,0,5,5,60,22,0.0,691.3
11874,31535a79c5959be8,a8d521d913df4e31,eff47295daf721a6,2009-03-07,0,0,0,215,0,0,2,0,2,0,0,0,0,0,1,0,1,0,0.0,13.0
11875,31535a79c5959be8,eff47295daf721a6,a8d521d913df4e31,2009-03-07,1,0,0,215,1,1,23,12,2,21,0,0,21,11,0,0,2,1,202.0,13.0
11876,21b02cb26307ac0f,2db7fa8db6bc9632,f2c8ebbeafd45f2b,2009-03-07,1,0,0,44,0,0,12,4,7,5,0,0,5,3,2,1,5,1,5.0,38.0
11877,21b02cb26307ac0f,f2c8ebbeafd45f2b,2db7fa8db6bc9632,2009-03-07,0,0,0,44,0,0,9,0,9,0,0,0,0,0,4,4,5,0,0.0,37.0
11878,1df12710cfdb60f4,0359313549d230a1,31123249b0bbf52e,2009-03-07,0,0,0,92,1,0,1,0,1,0,0,0,0,0,0,0,1,0,0.0,50.7
11879,1df12710cfdb60f4,31123249b0bbf52e,0359313549d230a1,2009-03-07,2,0,0,92,0,0,31,20,20,11,0,0,11,9,5,4,15,11,20.3,57.0
11880,038c472ae3fd7728,270b89c00ef0c55c,68dd7b3783c19f9c,2009-03-07,0,0,0,69,1,1,8,5,6,2,0,0,2,1,0,0,6,4,19.3,38.0
11881,038c472ae3fd7728,68dd7b3783c19f9c,270b89c00ef0c55c,2009-03-07,1,0,0,69,0,0,10,4,8,2,0,0,2,2,0,0,8,2,2.0,47.7
11882,011d818ec9bb3de6,b9d0fd83bb8a147a,ffc088e64fab57e9,2009-03-07,0,0,0,900,3,0,184,32,184,0,0,0,0,0,39,32,145,32,0.0,806.8
11883,011d818ec9bb3de6,ffc088e64fab57e9,b9d0fd83bb8a147a,2009-03-07,2,0,0,900,3,2,151,44,142,9,2,1,7,3,11,11,131,41,65.2,726.0
11884,fd05ac3ac2f7d042,30a09e43f15f1d75,dd37fd509af89f15,2009-02-21,1,0,0,209,0,0,24,4,24,0,0,0,0,0,3,3,21,4,0.0,207.0
11885,fd05ac3ac2f7d042,dd37fd509af89f15,30a09e43f15f1d75,2009-02-21,0,0,0,209,0,0,29,6,29,0,0,0,0,0,2,2,27,6,0.0,209.0
11886,d89b849df7bff79b,58bc81376286b3d3,e5c9de15bb58b1c6,2009-02-21,0,1,0,133,1,1,13,5,12,1,0,0,1,1,4,4,8,4,32.0,70.0
11887,d89b849df7bff79b,e5c9de15bb58b1c6,58bc81376286b3d3,2009-02-21,1,1,0,133,0,0,27,13,18,9,0,0,9,6,0,0,18,7,31.0,70.0
11888,cdfaa6f4154a0ee9,725a834930c2b5bf,aac5ac38148f0528,2009-02-21,1,0,0,900,4,4,82,31,75,7,0,0,7,3,11,7,64,28,44.4,551.0
11889,cdfaa6f4154a0ee9,aac5ac38148f0528,725a834930c2b5bf,2009-02-21,0,0,0,900,6,2,190,43,153,37,0,0,37,15,33,28,120,28,184.0,472.6
11890,c1b0670419fa0894,a8e6a69796280f17,af5b208e97f5d382,2009-02-21,1,1,0,790,6,2,102,37,85,17,1,1,16,12,32,29,53,25,112.9,531.0
11891,c1b0670419fa0894,af5b208e97f5d382,a8e6a69796280f17,2009-02-21,0,1,0,790,0,0,74,12,73,1,0,0,1,1,6,4,67,11,0.0,677.1
11892,995d42d9ff422ed1,427b5953ac8e3a27,48d1f690b763934c,2009-02-21,0,1,1,157,4,1,17,5,16,1,0,0,1,1,3,1,13,4,4.5,61.0
11893,995d42d9ff422ed1,48d1f690b763934c,427b5953ac8e3a27,2009-02-21,0,0,0,157,0,0,24,5,21,3,0,0,3,1,4,3,17,4,87.0,65.5
11894,95c229097cd2d7c3,63def5a5662a6917,ebc1f40e00e0c481,2009-02-21,2,0,0,54,0,0,18,9,15,3,0,0,3,2,4,3,11,7,1.8,48.0
11895,95c229097cd2d7c3,ebc1f40e00e0c481,63def5a5662a6917,2009-02-21,0,0,0,54,0,0,1,0,1,0,0,0,0,0,0,0,1,0,0.0,52.2
11896,9379672d351808a3,23a16ebe733e3041,473ce3aa581251a2,2009-02-21,0,0,0,69,0,0,7,2,7,0,0,0,0,0,1,0,6,2,0.0,67.0
11897,9379672d351808a3,473ce3aa581251a2,23a16ebe733e3041,2009-02-21,1,0,0,69,0,0,12,3,11,1,0,0,1,1,3,2,8,2,2.0,67.0
11898,56aac937d9f1d13a,79899ecf62020f6d,82e7929bf6c2b689,2009-02-21,0,1,0,900,4,0,145,34,144,1,0,0,1,1,10,7,134,33,2.2,876.0
11899,56aac937d9f1d13a,82e7929bf6c2b689,79899ecf62020f6d,2009-02-21,0,1,0,900,4,1,193,75,193,0,0,0,0,0,23,16,170,75,0.0,851.8
11900,0d395cb5d91f811f,36a432f22144843e,51b0bb73a1da34bc,2009-02-21,0,1,0,63,0,0,3,0,3,0,0,0,0,0,0,0,3,0,0.0,41.0
11901,0d395cb5d91f811f,51b0bb73a1da34bc,36a432f22144843e,2009-02-21,0,2,1,63,1,0,0,0,0,0,0,0,0,0,0,0,0,0,0.0,63.0
11902,0bf249717dacc5c3,3138fab619faf4d1,33011768c3c4dc9a,2009-02-21,0,0,0,310,4,2,13,0,13,0,0,0,0,0,1,0,12,0,0.0,178.0
11903,0bf249717dacc5c3,33011768c3c4dc9a,3138fab619faf4d1,2009-02-21,1,0,0,310,1,1,43,8,39,4,0,0,4,2,13,11,26,6,24.0,286.0
11904,e4420b9812501c17,2f3f12002564bb55,d023ae89a2a4a41e,2009-02-07,0,0,0,900,1,1,35,11,35,0,0,0,0,0,17,11,18,11,0.0,476.6
11905,e4420b9812501c17,d023ae89a2a4a41e,2f3f12002564bb55,2009-02-07,0,0,0,900,7,4,81,18,44,37,13,13,24,15,23,17,21,3,400.4,229.0
11906,df7f3c60c523ca55,86f582852a5b240a,d1a1314976c50bef,2009-02-07,1,0,0,516,1,0,66,23,59,7,0,0,7,2,13,10,46,21,56.6,292.1
11907,df7f3c60c523ca55,d1a1314976c50bef,86f582852a5b240a,2009-02-07,0,3,1,516,0,0,96,29,77,19,0,0,19,12,20,17,57,17,45.9,326.4
11908,c9721146eba68c2a,75e5fec9f72910ef,7d21de9c6d7c98b2,2009-02-07,0,1,1,275,3,2,10,5,6,4,0,0,4,2,2,2,4,3,100.5,74.0
11909,c9721146eba68c2a,7d21de9c6d7c98b2,75e5fec9f72910ef,2009-02-07,0,0,0,275,1,0,9,0,9,0,0,0,0,0,3,1,6,0,0.0,154.5
11910,868833557ae90877,365fee2da473b177,9583662df31d943f,2009-02-07,1,0,0,279,0,0,47,10,42,5,1,1,4,4,16,10,26,6,5.0,270.0
11911,868833557ae90877,9583662df31d943f,365fee2da473b177,2009-02-07,0,0,0,279,1,0,23,6,23,0,0,0,0,0,10,6,13,6,0.0,256.0
11912,83c5a944258d2332,18968f97ad34f15c,3bad7ef643840f67,2009-02-07,0,0,0,583,1,1,37,12,15,22,2,1,20,8,2,2,13,4,205.3,104.5
11913,83c5a944258d2332,3bad7ef643840f67,18968f97ad34f15c,2009-02-07,0,4,1,583,2,2,17,10,8,9,0,0,9,8,1,1,7,2,254.5,66.69999999999999
11914,6a663c04dfe5b88e,5731cc327790b731,bfc2fc38a0e20211,2009-02-07,1,0,0,274,3,1,29,11,23,6,0,0,6,2,2,1,21,9,31.5,134.9
11915,6a663c04dfe5b88e,bfc2fc38a0e20211,5731cc327790b731,2009-02-07,1,1,0,274,0,0,48,26,30,18,0,0,18,14,3,3,27,12,55.1,141.5
11916,2d80f60b67791b97,0ff11cc094e887bc,a421465acbe59c77,2009-02-07,1,0,0,454,4,1,140,47,128,12,0,0,12,10,43,41,85,37,34.2,246.0
11917,2d80f60b67791b97,a421465acbe59c77,0ff11cc094e887bc,2009-02-07,0,1,0,454,0,0,39,5,39,0,0,0,0,0,3,2,36,5,0.0,415.8
11918,26888b89fbd860cf,b05086131c6f5dc5,f8fe2053d73d7bcf,2009-02-07,0,0,0,375,6,1,2,0,2,0,0,0,0,0,2,2,0,0,0.0,84.19999999999999
11919,26888b89fbd860cf,f8fe2053d73d7bcf,b05086131c6f5dc5,2009-02-07,0,2,1,375,4,4,24,21,5,19,0,0,19,17,0,0,5,4,228.8,98.0
11920,14c3447726332f2b,4f2fcbefb668689d,d0c29452d3272603,2009-02-07,0,0,0,63,2,1,4,2,2,2,0,0,2,1,0,0,2,1,26.0,26.0
11921,14c3447726332f2b,d0c29452d3272603,4f2fcbefb668689d,2009-02-07,0,2,1,63,0,0,6,2,5,1,0,0,1,1,0,0,5,1,11.0,15.0
11922,0a1f2e1f9d91bc9a,aa1952ec0b3dd8e1,dc0f07928009a127,2009-02-07,0,1,1,494,5,1,58,10,55,3,0,0,3,3,9,6,46,7,66.8,351.7
11923,0a1f2e1f9d91bc9a,dc0f07928009a127,aa1952ec0b3dd8e1,2009-02-07,0,0,0,494,5,2,77,13,69,8,0,0,8,3,10,8,59,10,53.3,367.2
11924,fb7d31b36bebc5af,480b702debcb5433,de62052b2ede65ba,2009-01-31,0,0,0,900,0,0,68,22,3,65,2,2,63,20,0,0,3,2,653.0,122.7
11925,fb7d31b36bebc5af,de62052b2ede65ba,480b702debcb5433,2009-01-31,0,5,0,900,5,2,25,10,13,12,3,3,9,9,4,3,9,1,124.3,102.0
11926,e6dd15ef9fd7927e,8a59d346dc976a10,cc6f9d1e89f3449a,2009-01-31,0,0,0,900,7,3,64,24,47,17,0,0,17,9,4,3,43,15,261.8,490.8
11927,e6dd15ef9fd7927e,cc6f9d1e89f3449a,8a59d346dc976a10,2009-01-31,0,1,0,900,5,1,86,18,75,11,0,0,11,5,10,8,65,13,101.2,500.2
11928,c598261fac8cf23a,6f018c039b4d5d80,b2acebbef8da14ea,2009-01-31,0,2,0,900,7,4,70,15,47,23,7,4,16,9,23,21,24,6,325.2,243.6
11929,c598261fac8cf23a,b2acebbef8da14ea,6f018c039b4d5d80,2009-01-31,0,0,0,900,0,0,20,1,18,2,0,0,2,1,10,6,8,0,48.4,453.8
11930,afb9d3476c5caafa,07f72a2a7591b409,c6a33ff198aaaeeb,2009-01-31,1,0,0,900,10,7,62,24,50,12,2,2,10,8,25,19,25,16,76.6,647.5
11931,afb9d3476c5caafa,c6a33ff198aaaeeb,07f72a2a7591b409,2009-01-31,0,0,0,900,2,0,76,15,75,1,0,0,1,1,30,22,45,14,3.5,692.4
11932,aa161809e78bef96,349aaa3da11eb587,9bcf8603ceb25680,2009-01-31,0,1,0,900,12,2,47,13,45,2,0,0,2,2,13,11,32,11,28.5,543.3
11933,aa161809e78bef96,9bcf8603ceb25680,349aaa3da11eb587,2009-01-31,0,2,0,900,6,2,35,5,33,2,0,0,2,2,15,14,18,3,42.7,465.5
11934,a158e4ff7ea93d43,6506c1d34da9c013,73c7cfa551289285,2009-01-31,1,0,0,1200,7,4,122,51,71,51,8,8,43,31,39,33,32,20,579.1,303.0
11935,a158e4ff7ea93d43,73c7cfa551289285,6506c1d34da9c013,2009-01-31,0,0,0,1200,1,0,37,8,37,0,0,0,0,0,9,8,28,8,0.0,594.9
11936,92e9c53671ac8fe7,8355922d564b152c,c47df9303d318c67,2009-01-31,0,0,0,900,8,0,135,39,134,1,0,0,1,1,15,10,119,38,2.8,686.0
11937,92e9c53671ac8fe7,c47df9303d318c67,8355922d564b152c,2009-01-31,0,1,0,900,11,4,99,15,86,13,2,2,11,7,38,32,48,8,164.0,367.2
11938,41b9240c854b0956,2924886ee9c4c527,f7a7f7118d4b01b6,2009-01-31,0,0,0,299,2,0,10,1,10,0,0,0,0,0,5,1,5,1,0.0,141.8
11939,41b9240c854b0956,f7a7f7118d4b01b6,2924886ee9c4c527,2009-01-31,2,0,0,299,3,2,40,16,22,18,3,2,15,10,8,6,14,6,133.2,151.0
11940,1cb28e867dd749b8,20bcc9966affb19c,f1b2a4365799c48b,2009-01-31,1,0,0,900,11,9,84,25,76,8,0,0,8,3,0,0,76,22,147.8,586.0
11941,1cb28e867dd749b8,f1b2a4365799c48b,20bcc9966affb19c,2009-01-31,0,0,0,900,1,0,179,31,179,0,0,0,0,0,21,15,158,31,0.0,748.2
11942,08f5bdfe45082ec5,a56607a451e4c70d,fc31f896cde2bc2e,2009-01-31,0,2,0,900,6,2,82,18,59,23,10,9,13,7,25,18,34,11,133.1,432.9
11943,08f5bdfe45082ec5,fc31f896cde2bc2e,a56607a451e4c70d,2009-01-31,0,2,0,900,7,7,41,13,28,13,2,1,11,8,7,7,21,5,276.1,405.9
11944,f046dfa306dc7acb,04c15b52c3cc1cab,5f87a5c00b3d17ed,2009-01-17,0,0,0,825,2,1,102,17,94,8,0,0,8,4,39,31,55,13,87.2,716.0
11945,f046dfa306dc7acb,5f87a5c00b3d17ed,04c15b52c3cc1cab,2009-01-17,1,0,0,825,1,0,190,28,190,0,0,0,0,0,31,20,159,28,0.0,730.8
11946,e9658a79cfaafbb1,8b69839f3555a67b,8fd1f27e86661ede,2009-01-17,1,2,0,489,1,0,52,26,26,26,0,0,26,23,10,7,16,3,134.3,249.0
11947,e9658a79cfaafbb1,8fd1f27e86661ede,8b69839f3555a67b,2009-01-17,0,0,0,489,2,1,20,1,18,2,0,0,2,1,8,7,10,0,54.0,219.7
11948,e90dd017386025c4,91acd6910b802a9e,b7d524c77c27389b,2009-01-17,0,0,0,900,0,0,198,34,198,0,0,0,0,0,48,39,150,34,0.0,897.0
11949,e90dd017386025c4,b7d524c77c27389b,91acd6910b802a9e,2009-01-17,0,0,0,900,1,0,166,29,166,0,0,0,0,0,44,30,122,29,0.0,894.0
11950,dd5f7a14f5782f79,8d26912cd2aeb366,8ddf9c51c5fdea75,2009-01-17,0,1,0,900,1,1,36,5,34,2,0,0,2,1,2,2,32,4,22.8,243.10000000000002
11951,dd5f7a14f5782f79,8ddf9c51c5fdea75,8d26912cd2aeb366,2009-01-17,0,0,0,900,10,7,35,17,16,19,0,0,19,12,3,1,13,5,599.9,214.2
11952,cb7cfa8b9900878f,1ccf4e7caff270df,d897897060f10a3a,2009-01-17,0,0,0,900,6,4,88,18,67,21,3,3,18,8,21,15,46,10,221.6,587.4
11953,cb7cfa8b9900878f,d897897060f10a3a,1ccf4e7caff270df,2009-01-17,0,0,0,900,0,0,96,14,95,1,0,0,1,0,30,25,65,14,6.6,585.4
11954,5a3b530c73106c5c,679a9054e2815943,b23fca14c7b79935,2009-01-17,1,0,0,122,1,1,22,11,13,9,0,0,9,7,3,3,10,4,24.4,84.0
11955,5a3b530c73106c5c,b23fca14c7b79935,679a9054e2815943,2009-01-17,0,0,0,122,2,0,11,2,11,0,0,0,0,0,1,1,10,2,0.0,97.6
11956,591e7797363a6c89,3c241737a6069b9f,4130a743d9d22163,2009-01-17,0,1,0,576,5,3,55,17,43,12,0,0,12,7,10,9,33,10,257.2,233.0
11957,591e7797363a6c89,4130a743d9d22163,3c241737a6069b9f,2009-01-17,0,1,1,576,0,0,28,3,28,0,0,0,0,0,9,6,19,3,0.0,298.8
11958,4da34f2980b5c58d,3795fca327cbcf23,f59f1d3a2ff13edd,2009-01-17,0,0,0,215,0,0,5,2,4,1,0,0,1,1,1,1,3,1,9.0,20.0
11959,4da34f2980b5c58d,f59f1d3a2ff13edd,3795fca327cbcf23,2009-01-17,1,0,0,215,1,0,30,22,0,30,0,0,30,22,0,0,0,0,186.0,20.0
11960,396214fd188c2549,140745cbbcb023ac,21b8a0f5c231096f,2009-01-17,2,2,0,876,2,1,102,34,95,7,5,5,2,1,28,23,67,33,48.8,404.9
11961,396214fd188c2549,21b8a0f5c231096f,140745cbbcb023ac,2009-01-17,0,0,0,876,9,7,69,26,52,17,4,4,13,8,1,1,51,18,262.1,457.2
11962,20b84b2cbfb92dc7,28f3c2258a1d8874,eae4aec1a5a8ff01,2009-01-17,1,0,0,276,7,5,36,14,5,31,0,0,31,14,4,4,1,0,233.9,27.0
11963,20b84b2cbfb92dc7,eae4aec1a5a8ff01,28f3c2258a1d8874,2009-01-17,0,0,0,276,0,0,1,0,1,0,0,0,0,0,0,0,1,0,0.0,42.099999999999994
11964,f27bf6f21410547f,55a7b2d4e54ffac9,7e69a4b0961aa555,2008-12-27,0,0,0,900,2,0,181,31,180,1,0,0,1,1,37,32,143,30,0.0,882.4
11965,f27bf6f21410547f,7e69a4b0961aa555,55a7b2d4e54ffac9,2008-12-27,1,0,0,900,1,0,296,48,292,4,0,0,4,2,42,31,250,46,17.6,878.0
11966,c62d5962b99938de,a1f6999fe57236e0,ffc088e64fab57e9,2008-12-27,0,0,0,201,0,0,26,4,26,0,0,0,0,0,5,3,21,4,0.0,199.0
11967,c62d5962b99938de,ffc088e64fab57e9,a1f6999fe57236e0,2008-12-27,1,0,0,201,1,0,20,10,18,2,0,0,2,2,1,1,17,8,2.0,199.0
11968,b8927a3a2735acb0,5b2d7906aa894274,5d7bdab5e03e3216,2008-12-27,1,2,0,181,0,0,6,3,6,0,0,0,0,0,0,0,6,3,0.0,78.8
11969,b8927a3a2735acb0,5d7bdab5e03e3216,5b2d7906aa894274,2008-12-27,1,0,0,181,1,1,19,8,10,9,0,0,9,6,3,1,7,2,98.2,61.0
11970,b3f4583109b429af,1cf1310684a841f5,1eacf73d6a0055dc,2008-12-27,0,0,0,277,7,0,9,0,9,0,0,0,0,0,5,4,4,0,0.0,122.0
11971,b3f4583109b429af,1eacf73d6a0055dc,1cf1310684a841f5,2008-12-27,1,0,0,277,1,1,44,23,17,27,2,2,25,20,10,9,7,3,63.0,200.0
11972,8add23232cdb36ee,658c3465581ae46b,dd8aec6de7035943,2008-12-27,1,0,0,156,0,0,13,1,13,0,0,0,0,0,7,5,6,1,0.0,117.0
11973,8add23232cdb36ee,dd8aec6de7035943,658c3465581ae46b,2008-12-27,0,0,0,156,1,0,10,0,10,0,0,0,0,0,2,0,8,0,0.0,118.0
11974,59e653313c871c3f,69b69c0178c4004d,b51841e7c594090d,2008-12-27,1,2,0,429,0,0,59,34,32,27,0,0,27,25,13,12,19,9,54.0,254.0
11975,59e653313c871c3f,b51841e7c594090d,69b69c0178c4004d,2008-12-27,0,0,0,429,6,3,23,8,17,6,0,0,6,3,6,5,11,5,79.0,138.0
11976,539eff1fe2fb39ba,46e2ca71fd5089cb,98b80a717b9bda17,2008-12-27,0,0,0,439,0,0,73,20,73,0,0,0,0,0,19,14,54,20,0.0,421.8
11977,539eff1fe2fb39ba,98b80a717b9bda17,46e2ca71fd5089cb,2008-12-27,1,0,0,439,1,1,115,34,104,11,0,0,11,8,8,6,96,26,17.2,414.0
11978,4918b7e3600f67a1,68c6cd5287b473a7,acff437707625fc7,2008-12-27,0,0,0,900,11,0,39,2,39,0,0,0,0,0,6,4,33,2,0.0,446.5
11979,4918b7e3600f67a1,acff437707625fc7,68c6cd5287b473a7,2008-12-27,0,0,0,900,0,0,77,32,50,27,2,2,25,15,5,5,45,17,438.5,364.0
11980,041dd0fae4650970,ee779c43a8926d52,fcffee71cff5530e,2008-12-27,1,0,0,766,1,1,103,44,64,39,1,1,38,24,6,4,58,20,131.0,635.0
11981,041dd0fae4650970,fcffee71cff5530e,ee779c43a8926d52,2008-12-27,0,0,0,766,0,0,149,16,149,0,0,0,0,0,49,34,100,16,0.0,632.0
11982,02c54d382fb1c347,1ff9589f9065a9ed,ee9d73f4fee9cbdd,2008-12-27,3,0,0,414,1,1,101,30,82,19,2,1,17,9,8,6,74,21,35.4,373.0
11983,02c54d382fb1c347,ee9d73f4fee9cbdd,1ff9589f9065a9ed,2008-12-27,0,0,0,414,0,0,38,8,36,2,0,0,2,1,3,2,33,7,0.0,378.6
11984,f7cd0a90da3be3b2,365fee2da473b177,a6d8bfe9e0c8153b,2008-12-13,1,0,0,628,3,3,64,15,38,26,5,2,21,10,20,18,18,5,449.0,179.0
11985,f7cd0a90da3be3b2,a6d8bfe9e0c8153b,365fee2da473b177,2008-12-13,0,2,0,628,0,0,45,7,45,0,0,0,0,0,13,10,32,7,0.0,178.0
11986,edeba52fc9b2855f,5114f1b5ad4cdf72,59583ff832fe9d68,2008-12-13,0,0,0,507,5,1,26,2,26,0,0,0,0,0,7,5,19,2,0.0,280.2
11987,edeba52fc9b2855f,59583ff832fe9d68,5114f1b5ad4cdf72,2008-12-13,0,1,1,507,0,0,50,16,41,9,3,3,6,3,0,0,41,13,149.8,224.0
11988,ec8ad2966a6816b3,5669b828e7e11329,d74cba8566291bfa,2008-12-13,0,1,0,392,2,2,29,5,29,0,0,0,0,0,12,7,17,5,0.0,232.8
11989,ec8ad2966a6816b3,d74cba8566291bfa,5669b828e7e11329,2008-12-13,0,2,1,392,2,2,63,21,55,8,0,0,8,3,13,10,42,18,99.2,206.0
11990,e65da830a1928fe6,88a9bc81271ccd89,c0ab242c40decc55,2008-12-13,0,0,0,138,0,0,20,1,20,0,0,0,0,0,6,3,14,1,0.0,134.0
11991,e65da830a1928fe6,c0ab242c40decc55,88a9bc81271ccd89,2008-12-13,1,0,0,138,0,0,30,9,26,4,0,0,4,3,6,6,20,6,4.0,134.0
11992,bacb62c4f2058fd8,37b1696e6d115957,b18fb36a4aa00093,2008-12-13,1,3,1,438,4,1,27,8,18,9,2,2,7,4,9,5,9,4,246.0,192.0
11993,bacb62c4f2058fd8,b18fb36a4aa00093,37b1696e6d115957,2008-12-13,0,1,0,438,0,0,23,1,23,0,0,0,0,0,1,0,22,1,0.0,171.0
11994,86b8419f22f398c0,64360e618823a8e4,83fd97284f4bb4a4,2008-12-13,0,2,0,900,1,0,55,9,51,4,1,0,3,2,18,11,33,7,20.3,421.5
11995,86b8419f22f398c0,83fd97284f4bb4a4,64360e618823a8e4,2008-12-13,0,0,0,900,8,7,45,9,22,23,15,11,8,6,8,7,14,3,402.5,319.7
11996,59bd4e83d8f846ee,a08d909a5be6f410,d1dcd4e96464a53d,2008-12-13,0,2,1,87,1,1,15,8,14,1,0,0,1,1,0,0,14,7,16.2,22.0
11997,59bd4e83d8f846ee,d1dcd4e96464a53d,a08d909a5be6f410,2008-12-13,0,0,0,87,0,0,2,0,2,0,0,0,0,0,1,1,1,0,0.0,70.8
11998,52e07b6540fad19e,2db7fa8db6bc9632,3c0437fbeda06962,2008-12-13,0,2,0,900,10,3,32,10,12,20,0,0,20,8,0,0,12,2,415.7,356.6
11999,52e07b6540fad19e,3c0437fbeda06962,2db7fa8db6bc9632,2008-12-13,0,0,0,900,1,1,74,10,66,8,2,1,6,3,16,10,50,7,65.4,247.3
12000,0b58bd40373b1811,2be6596a9db33bf5,af5b208e97f5d382,2008-12-13,0,0,0,138,4,1,13,0,13,0,0,0,0,0,6,6,7,0,0.0,56.0
12001,0b58bd40373b1811,af5b208e97f5d382,2be6596a9db33bf5,2008-12-13,1,0,0,138,0,0,28,17,10,18,0,0,18,14,2,1,8,3,45.0,93.0
12002,09b36c7157770516,4d44f37107f01b9b,b959e8c7fd8390d2,2008-12-13,0,0,0,900,19,7,22,14,4,18,0,0,18,12,0,0,4,2,558.0,171.7
12003,09b36c7157770516,b959e8c7fd8390d2,4d44f37107f01b9b,2008-12-13,0,0,0,900,0,0,22,6,18,4,0,0,4,4,4,4,14,2,46.3,203.0
12004,d90567f7d4372160,d1941565abf50b16,eb29176b03dfa888,2008-12-10,0,2,0,900,6,4,137,50,94,43,0,0,43,24,17,11,77,26,338.7,262.0
12005,d90567f7d4372160,eb29176b03dfa888,d1941565abf50b16,2008-12-10,0,0,0,900,3,1,56,13,56,0,0,0,0,0,8,7,48,13,0.0,511.3
12006,d8f64b001cd590fa,38b50fd1e1b5b656,f1f9e48a0d150757,2008-12-10,0,0,0,244,1,0,56,5,56,0,0,0,0,0,10,8,46,5,0.0,180.2
12007,d8f64b001cd590fa,f1f9e48a0d150757,38b50fd1e1b5b656,2008-12-10,0,1,1,244,1,1,29,9,26,3,0,0,3,2,7,6,19,7,46.8,166.0
12008,c4e16d57dd9a1b39,058e4e08a1ad8aba,abbc737317f66b81,2008-12-10,1,0,0,320,0,0,18,0,18,0,0,0,0,0,12,8,6,0,0.0,172.0
12009,c4e16d57dd9a1b39,abbc737317f66b81,058e4e08a1ad8aba,2008-12-10,0,0,0,320,3,2,25,4,22,3,0,0,3,1,7,4,15,3,141.0,179.0
12010,83406cd29d3c2d0f,89b8d1bf1ff09d1d,cbf94e4c4af4ff6d,2008-12-10,1,0,0,600,1,1,131,39,124,7,0,0,7,2,16,13,108,37,98.9,388.0
12011,83406cd29d3c2d0f,cbf94e4c4af4ff6d,89b8d1bf1ff09d1d,2008-12-10,0,0,0,600,3,0,62,6,62,0,0,0,0,0,31,19,31,6,0.0,501.1
12012,79298011365a6d90,484acc7b0f856ce9,aa79d5399571068e,2008-12-10,1,0,0,109,0,0,51,35,51,0,0,0,0,0,8,7,43,35,0.0,61.0
12013,79298011365a6d90,aa79d5399571068e,484acc7b0f856ce9,2008-12-10,0,0,0,109,0,0,1,0,1,0,0,0,0,0,0,0,1,0,0.0,103.0
12014,44c9ca6a502db390,2f3f12002564bb55,3ba3b5cc94498437,2008-12-10,0,1,1,524,6,3,18,5,15,3,1,1,2,2,6,4,9,3,82.1,204.2
12015,44c9ca6a502db390,3ba3b5cc94498437,2f3f12002564bb55,2008-12-10,0,0,0,524,4,1,52,15,47,5,0,0,5,5,26,21,21,10,18.8,291.9
12016,2f736846aebbf12d,75f871836d41f90f,7f0b4a75ef3039a3,2008-12-10,1,0,0,900,4,1,88,29,88,0,0,0,0,0,22,11,66,29,0.0,498.6
12017,2f736846aebbf12d,7f0b4a75ef3039a3,75f871836d41f90f,2008-12-10,1,0,0,900,4,0,100,28,98,2,0,0,2,2,16,14,82,26,7.4,764.0
12018,11c3035dd9104e50,ab8900ae1f1dfd4c,dd37fd509af89f15,2008-12-10,0,0,0,135,0,0,17,1,17,0,0,0,0,0,11,5,6,1,0.0,135.0
12019,11c3035dd9104e50,dd37fd509af89f15,ab8900ae1f1dfd4c,2008-12-10,1,0,0,135,0,0,16,6,16,0,0,0,0,0,0,0,16,6,0.0,135.0
12020,0f235698600c962e,9fe85152f351e737,fb1538b46877a695,2008-12-10,1,0,0,33,0,0,8,7,3,5,0,0,5,5,0,0,3,2,9.0,24.0
12021,0f235698600c962e,fb1538b46877a695,9fe85152f351e737,2008-12-10,0,0,0,33,1,0,3,1,3,0,0,0,0,0,0,0,3,1,0.0,24.0
12022,e94d7bfb0c92e30d,270b89c00ef0c55c,7649c4c95b824488,2008-11-15,1,0,0,61,0,0,17,7,15,2,0,0,2,2,6,5,9,5,0.8,57.0
12023,e94d7bfb0c92e30d,7649c4c95b824488,270b89c00ef0c55c,2008-11-15,0,0,0,61,0,0,5,1,5,0,0,0,0,0,0,0,5,1,0.0,60.2
12024,c739195deef32b45,a149d6bc670cdb60,eff47295daf721a6,2008-11-15,0,3,1,239,0,0,21,5,19,2,0,0,2,1,7,5,12,4,0.0,239.0
12025,c739195deef32b45,eff47295daf721a6,a149d6bc670cdb60,2008-11-15,0,0,0,239,0,0,28,6,28,0,0,0,0,0,10,9,18,6,0.0,165.0
12026,bfd846ad4d597bbb,427b5953ac8e3a27,52cae54377b433b7,2008-11-15,0,1,1,133,2,1,4,2,2,2,0,0,2,2,0,0,2,0,105.0,28.0
12027,bfd846ad4d597bbb,52cae54377b433b7,427b5953ac8e3a27,2008-11-15,0,0,0,133,0,0,0,0,0,0,0,0,0,0,0,0,0,0,0.0,22.0
12028,b34fb9e15fbd6b3b,31123249b0bbf52e,b732b326c362fb62,2008-11-15,0,3,1,357,1,1,23,7,20,3,0,0,3,3,8,8,12,4,13.5,93.69999999999999
12029,b34fb9e15fbd6b3b,b732b326c362fb62,31123249b0bbf52e,2008-11-15,0,0,0,357,8,5,22,8,12,10,3,3,7,7,5,4,7,1,218.3,81.5
12030,9e99536eae6d709b,18968f97ad34f15c,6a2f7c151031653d,2008-11-15,1,0,0,639,0,0,46,13,27,19,2,1,17,11,8,8,19,2,134.9,497.0
12031,9e99536eae6d709b,6a2f7c151031653d,18968f97ad34f15c,2008-11-15,0,2,0,639,6,4,18,4,18,0,0,0,0,0,6,5,12,4,0.0,195.1
12032,958bd435389dd12a,04d5718ed2661e8c,f2c8ebbeafd45f2b,2008-11-15,0,0,0,900,4,1,199,46,199,0,0,0,0,0,33,24,166,46,0.0,845.0
12033,958bd435389dd12a,f2c8ebbeafd45f2b,04d5718ed2661e8c,2008-11-15,0,0,0,900,1,1,222,63,210,12,0,0,12,8,50,35,160,55,43.0,753.0
12034,821c27f0dbb27e86,79899ecf62020f6d,cb139171ed1b69fe,2008-11-15,0,0,0,243,3,1,18,3,18,0,0,0,0,0,5,3,13,3,0.0,116.5
12035,821c27f0dbb27e86,cb139171ed1b69fe,79899ecf62020f6d,2008-11-15,0,1,1,243,2,1,37,13,28,9,0,0,9,5,5,4,23,8,49.5,177.0
12036,8191b8edfde3b9c3,cbe79765d44bd172,cf9d24e4bd0cf2ce,2008-11-15,0,0,0,796,1,0,14,5,14,0,0,0,0,0,0,0,14,5,0.0,62.39999999999998
12037,8191b8edfde3b9c3,cf9d24e4bd0cf2ce,cbe79765d44bd172,2008-11-15,0,6,1,796,1,1,44,15,9,35,5,5,30,13,1,1,8,2,679.6,97.0
12038,75577b11361cb645,0aa92558424ced9e,513c6f1715e547a8,2008-11-15,0,0,0,487,3,1,19,6,19,0,0,0,0,0,6,5,13,6,0.0,212.9
12039,75577b11361cb645,513c6f1715e547a8,0aa92558424ced9e,2008-11-15,1,0,0,487,4,2,42,21,28,14,0,0,14,14,10,10,18,7,88.1,317.0
12040,d5a0e8c67ed8abe0,029880cdbf5ca089,20205040232ed0f3,2008-10-25,0,0,0,900,7,3,253,66,253,0,0,0,0,0,27,26,226,66,0.0,749.0
12041,d5a0e8c67ed8abe0,20205040232ed0f3,029880cdbf5ca089,2008-10-25,0,0,0,900,2,0,240,50,240,0,0,0,0,0,32,24,208,50,0.0,900.0
12042,cfbeeffd65101ae1,0359313549d230a1,6da99156486ed6c2,2008-10-25,0,1,0,900,10,1,123,52,123,0,0,0,0,0,14,13,109,52,0.0,706.3
12043,cfbeeffd65101ae1,6da99156486ed6c2,0359313549d230a1,2008-10-25,0,0,0,900,6,4,112,37,99,13,3,3,10,10,12,10,87,27,111.7,668.0
12044,af4cbb9072814a86,492b202d2064e7a9,63def5a5662a6917,2008-10-25,0,0,0,81,0,0,6,1,6,0,0,0,0,0,5,5,1,1,0.0,78.0
12045,af4cbb9072814a86,63def5a5662a6917,492b202d2064e7a9,2008-10-25,1,0,0,81,0,0,11,5,7,4,0,0,4,4,4,2,3,1,3.0,78.0
12046,854c64fe481e65ee,04643fd03d9159cc,e0ec3c3b6b611f7e,2008-10-25,0,0,0,900,9,1,104,34,102,2,0,0,2,2,7,6,95,32,55.0,790.0
12047,854c64fe481e65ee,e0ec3c3b6b611f7e,04643fd03d9159cc,2008-10-25,0,0,0,900,0,0,122,24,122,0,0,0,0,0,51,36,71,24,0.0,843.0
12048,80fd1902547e0744,9f1641c08cf8fbe2,f34312c2ccfa0e00,2008-10-25,0,1,0,836,13,2,46,7,44,2,1,1,1,1,22,20,22,6,50.5,433.8
12049,80fd1902547e0744,f34312c2ccfa0e00,9f1641c08cf8fbe2,2008-10-25,1,2,1,836,2,0,54,13,50,4,2,1,2,1,21,16,29,12,23.2,617.5
12050,64da1f4774624b72,31ee470ef5dc8d7f,dd37fd509af89f15,2008-10-25,2,0,0,900,2,0,181,43,179,2,0,0,2,2,47,37,132,41,1.8,883.0
12051,64da1f4774624b72,dd37fd509af89f15,31ee470ef5dc8d7f,2008-10-25,0,0,0,900,5,0,128,25,128,0,0,0,0,0,22,14,106,25,0.0,740.2
12052,3feb2a8de9cf37da,1fd4fbdcc67de844,cfb65863d5099327,2008-10-25,0,0,0,78,0,0,2,1,2,0,0,0,0,0,1,0,1,1,0.0,78.0
12053,3feb2a8de9cf37da,cfb65863d5099327,1fd4fbdcc67de844,2008-10-25,0,1,1,78,2,1,0,0,0,0,0,0,0,0,0,0,0,0,0.0,15.0
12054,34d1bfdde8ea3e11,049d698d773eb3e1,d0c29452d3272603,2008-10-25,0,5,0,900,0,0,24,10,17,7,3,3,4,4,2,2,15,6,97.1,138.10000000000002
12055,34d1bfdde8ea3e11,d0c29452d3272603,049d698d773eb3e1,2008-10-25,0,0,0,900,7,6,49,26,18,31,3,3,28,16,2,2,16,10,539.9,175.9
12056,27868eac1d141498,7d21de9c6d7c98b2,7d96bc577e5178b2,2008-10-25,0,0,0,900,0,0,42,3,38,4,2,1,2,1,3,3,35,2,5.2,383.5
12057,27868eac1d141498,7d96bc577e5178b2,7d21de9c6d7c98b2,2008-10-25,0,2,0,900,7,5,61,17,48,13,1,1,12,5,5,4,43,12,503.5,313.8
12058,2281dea0c5903a2f,1f454354805b6f75,9fa3bd637edd9aa2,2008-10-25,1,0,0,639,1,1,40,11,39,1,0,0,1,1,19,18,20,10,8.8,532.7
12059,2281dea0c5903a2f,9fa3bd637edd9aa2,1f454354805b6f75,2008-10-25,0,0,0,639,3,0,49,3,47,2,0,0,2,2,22,13,25,1,9.3,602.2
12060,f24db9d7c3636a2a,91acd6910b802a9e,9b74de674c355425,2008-10-18,0,0,0,900,3,2,194,54,191,3,3,3,0,0,60,45,131,54,21.8,421.0
12061,f24db9d7c3636a2a,9b74de674c355425,91acd6910b802a9e,2008-10-18,0,0,0,900,2,0,160,42,160,0,0,0,0,0,51,43,109,42,0.0,814.2
12062,cd5336ef8b2329f4,33011768c3c4dc9a,501b07aec9b8fc2d,2008-10-18,0,0,0,900,2,0,192,35,192,0,0,0,0,0,49,34,143,35,0.0,897.0
12063,cd5336ef8b2329f4,501b07aec9b8fc2d,33011768c3c4dc9a,2008-10-18,0,0,0,900,1,1,288,15,288,0,0,0,0,0,72,40,216,15,0.0,895.0
12064,cc9cabc1fc747aaf,aac5ac38148f0528,b7d524c77c27389b,2008-10-18,0,1,0,436,1,1,56,2,56,0,0,0,0,0,1,1,55,2,0.0,367.0
12065,cc9cabc1fc747aaf,b7d524c77c27389b,aac5ac38148f0528,2008-10-18,0,1,1,436,1,1,63,12,62,1,0,0,1,1,17,13,45,11,46.0,390.0
12066,9b8c29f50d452025,80c0bed43da0e27b,d1941565abf50b16,2008-10-18,0,1,0,799,1,0,16,5,16,0,0,0,0,0,2,2,14,5,0.0,174.89999999999998
12067,9b8c29f50d452025,d1941565abf50b16,80c0bed43da0e27b,2008-10-18,0,5,1,799,6,5,28,10,13,15,1,1,14,10,6,4,7,0,569.1,154.0
12068,781017bfa44d4058,24b033b3daf1c9df,d1152823307d7e7c,2008-10-18,1,0,0,555,0,0,78,37,65,13,0,0,13,11,6,4,59,26,9.4,542.0
12069,781017bfa44d4058,d1152823307d7e7c,24b033b3daf1c9df,2008-10-18,0,0,0,555,1,0,82,16,82,0,0,0,0,0,17,12,65,16,0.0,545.6
12070,757c11f17278b06a,1208ffc5be6e31ad,58bc81376286b3d3,2008-10-18,0,1,0,707,2,1,56,16,40,16,2,2,14,5,7,5,33,11,203.5,308.0
12071,757c11f17278b06a,58bc81376286b3d3,1208ffc5be6e31ad,2008-10-18,0,5,1,707,5,1,42,14,30,12,0,0,12,9,20,17,10,5,81.0,260.5
12072,550daf3853d050ba,68dd7b3783c19f9c,6b7bc7eaf2465387,2008-10-18,1,0,0,91,2,1,23,11,6,17,0,0,17,11,2,2,4,0,50.2,29.0
12073,550daf3853d050ba,6b7bc7eaf2465387,68dd7b3783c19f9c,2008-10-18,0,0,0,91,0,0,8,4,8,0,0,0,0,0,0,0,8,4,0.0,40.8
12074,194f8d501f318ada,1efa064872f089d0,a8aba6fd8a463043,2008-10-18,0,0,0,900,11,7,53,32,23,30,1,1,29,19,3,3,20,13,363.7,155.1
12075,194f8d501f318ada,a8aba6fd8a463043,1efa064872f089d0,2008-10-18,0,2,0,900,1,1,25,12,11,14,0,0,14,7,0,0,11,5,150.9,342.3
12076,1776c84e3d22d7cc,2b93ebd9f5417ad2,d43a048a880efdff,2008-10-18,0,0,0,900,3,1,160,52,160,0,0,0,0,0,27,18,133,52,0.0,870.0
12077,1776c84e3d22d7cc,d43a048a880efdff,2b93ebd9f5417ad2,2008-10-18,0,0,0,900,2,1,164,22,164,0,0,0,0,0,47,29,117,22,0.0,853.0
12078,0510d12ad43ede89,473ce3aa581251a2,b2acebbef8da14ea,2008-10-18,0,0,0,900,0,0,186,24,186,0,0,0,0,0,53,33,133,24,0.0,883.3
12079,0510d12ad43ede89,b2acebbef8da14ea,473ce3aa581251a2,2008-10-18,0,0,0,900,4,3,107,28,105,2,0,0,2,2,44,28,61,26,14.7,834.0
12080,01d71345ba7ea6f9,b9d0fd83bb8a147a,fa315e6c77eee106,2008-10-18,1,0,0,900,4,2,131,35,108,23,2,1,21,9,15,14,93,26,101.2,660.1
12081,01d71345ba7ea6f9,fa315e6c77eee106,b9d0fd83bb8a147a,2008-10-18,1,0,0,900,1,1,86,27,75,11,2,2,9,7,22,19,53,20,19.9,760.8
12082,f6ea148cfeb1aaf7,3bad7ef643840f67,a6959da32f0e6b5d,2008-09-17,1,2,0,394,2,1,54,22,39,15,0,0,15,11,1,1,38,11,25.2,357.0
12083,f6ea148cfeb1aaf7,a6959da32f0e6b5d,3bad7ef643840f67,2008-09-17,0,0,0,394,0,0,48,10,48,0,0,0,0,0,9,8,39,10,0.0,366.8
12084,d460961065f1198b,86f582852a5b240a,c47df9303d318c67,2008-09-17,0,0,0,900,3,1,108,31,108,0,0,0,0,0,7,5,101,31,0.0,733.7
12085,d460961065f1198b,c47df9303d318c67,86f582852a5b240a,2008-09-17,0,0,0,900,18,10,106,19,96,10,1,1,9,5,26,23,70,14,132.3,384.0
12086,d23b05f33b741c47,497ba5b12a4bfc47,6803d4d6908354ac,2008-09-17,1,1,0,474,1,1,42,29,0,42,5,5,37,29,0,0,0,0,447.0,27.0
12087,d23b05f33b741c47,6803d4d6908354ac,497ba5b12a4bfc47,2008-09-17,0,0,0,474,0,0,4,3,4,0,0,0,0,0,1,1,3,3,0.0,22.0
12088,9fc232c3829a1ef0,8355922d564b152c,d1a1314976c50bef,2008-09-17,0,0,0,900,11,5,72,21,50,22,3,3,19,12,22,16,28,9,201.6,367.0
12089,9fc232c3829a1ef0,d1a1314976c50bef,8355922d564b152c,2008-09-17,0,4,0,900,8,4,50,20,40,10,1,1,9,5,9,5,31,15,84.0,362.4
12090,830bf05d0ee635a1,7f955f71fa2ce7ac,d35c3ed553b71fa2,2008-09-17,1,0,0,87,0,0,10,3,9,1,0,0,1,1,4,4,5,2,0.0,87.0
12091,830bf05d0ee635a1,d35c3ed553b71fa2,7f955f71fa2ce7ac,2008-09-17,0,0,0,87,3,0,9,5,9,0,0,0,0,0,2,2,7,5,0.0,64.0
12092,505d3d9b006014c8,0541480fbf719d86,f59f1d3a2ff13edd,2008-09-17,0,0,0,293,0,0,21,7,12,9,0,0,9,5,6,5,6,2,18.0,96.80000000000001
12093,505d3d9b006014c8,f59f1d3a2ff13edd,0541480fbf719d86,2008-09-17,0,2,1,293,4,1,38,21,7,31,0,0,31,21,6,3,1,0,164.2,79.0
12094,43e8fcd8e4d015fb,aae99701b21554e4,af5b208e97f5d382,2008-09-17,0,0,0,424,2,2,72,28,18,54,2,1,52,23,1,1,17,5,216.0,204.0
12095,43e8fcd8e4d015fb,af5b208e97f5d382,aae99701b21554e4,2008-09-17,0,2,1,424,1,1,19,3,19,0,0,0,0,0,6,5,13,3,0.0,194.0
12096,3818a33c9103c88f,06f36cf4bd97ec77,4130a743d9d22163,2008-09-17,0,2,0,900,12,5,130,33,115,15,2,2,13,8,18,8,97,25,127.5,611.0
12097,3818a33c9103c88f,4130a743d9d22163,06f36cf4bd97ec77,2008-09-17,0,0,0,900,0,0,90,29,90,0,0,0,0,0,30,25,60,29,0.0,628.5
12098,2822226962195259,1fd4fbdcc67de844,5b2d7906aa894274,2008-09-17,0,1,0,88,0,0,4,3,1,3,0,0,3,3,0,0,1,0,0.0,88.0
12099,2822226962195259,5b2d7906aa894274,1fd4fbdcc67de844,2008-09-17,0,1,1,88,1,1,0,0,0,0,0,0,0,0,0,0,0,0,0.0,7.0
12100,1992dcae0699200e,054defd5420a551f,d0c29452d3272603,2008-09-17,0,0,0,87,1,0,1,0,1,0,0,0,0,0,0,0,1,0,0.0,79.0
12101,1992dcae0699200e,d0c29452d3272603,054defd5420a551f,2008-09-17,0,2,1,87,0,0,1,0,1,0,0,0,0,0,0,0,1,0,0.0,25.0
12102,cafb86764ea92268,31123249b0bbf52e,9bcf8603ceb25680,2008-09-06,0,2,0,900,2,1,79,11,65,14,3,2,11,7,47,35,18,4,113.5,398.5
12103,cafb86764ea92268,9bcf8603ceb25680,31123249b0bbf52e,2008-09-06,0,1,0,900,14,3,28,11,21,7,0,0,7,4,1,1,20,7,193.5,482.5
12104,c5574b79e31a1b2b,98b80a717b9bda17,d897897060f10a3a,2008-09-06,0,0,0,639,6,1,58,7,56,2,0,0,2,1,6,6,50,6,5.3,606.2
12105,c5574b79e31a1b2b,d897897060f10a3a,98b80a717b9bda17,2008-09-06,1,0,0,639,0,0,136,36,133,3,0,0,3,3,39,35,94,33,0.8,629.7
12106,b74ecc368d3ecbc4,8b69839f3555a67b,a8e6a69796280f17,2008-09-06,0,0,0,82,0,0,7,1,7,0,0,0,0,0,1,0,6,1,0.0,72.5
12107,b74ecc368d3ecbc4,a8e6a69796280f17,8b69839f3555a67b,2008-09-06,1,0,0,82,0,0,36,19,32,4,0,0,4,2,5,3,27,17,1.5,71.0
12108,a34dc525a16ce375,1ccf4e7caff270df,8ddf9c51c5fdea75,2008-09-06,1,0,0,900,0,0,82,42,59,23,0,0,23,14,1,0,58,28,105.7,735.4
12109,a34dc525a16ce375,8ddf9c51c5fdea75,1ccf4e7caff270df,2008-09-06,0,1,0,900,16,2,63,23,61,2,0,0,2,1,6,4,55,22,17.6,706.3
12110,9a596aaa2b9a18db,1c86754617d9813a,55a7b2d4e54ffac9,2008-09-06,0,1,0,900,6,2,38,16,20,18,0,0,18,10,2,2,18,6,273.4,165.89999999999998
12111,9a596aaa2b9a18db,55a7b2d4e54ffac9,1c86754617d9813a,2008-09-06,0,0,0,900,0,0,58,11,21,37,8,5,29,10,7,7,14,1,415.1,166.60000000000002
12112,976f7f5e7537c62b,8a59d346dc976a10,aa1952ec0b3dd8e1,2008-09-06,0,0,0,900,11,1,72,13,60,12,2,2,10,4,8,3,52,9,176.6,425.8
12113,976f7f5e7537c62b,aa1952ec0b3dd8e1,8a59d346dc976a10,2008-09-06,2,1,0,900,2,1,97,50,61,36,4,4,32,26,8,7,53,24,268.2,343.4
12114,81734d11cb6a8ebb,2be6596a9db33bf5,5be86bb2f78fef2f,2008-09-06,0,1,1,380,2,2,18,10,10,8,0,0,8,6,0,0,10,4,284.8,24.0
12115,81734d11cb6a8ebb,5be86bb2f78fef2f,2be6596a9db33bf5,2008-09-06,0,2,0,380,0,0,5,1,5,0,0,0,0,0,0,0,5,1,0.0,95.19999999999999
12116,3e126f482e9a84b8,a390eb8a9b2df298,ee779c43a8926d52,2008-09-06,0,0,0,411,0,0,50,7,50,0,0,0,0,0,5,3,45,7,0.0,411.0
12117,3e126f482e9a84b8,ee779c43a8926d52,a390eb8a9b2df298,2008-09-06,1,0,0,411,0,0,35,9,35,0,0,0,0,0,4,4,31,9,0.0,411.0
12118,0568994b8323d640,83d0de122f2f9664,c80095f6092271a7,2008-09-06,0,0,0,123,1,0,21,3,21,0,0,0,0,0,8,6,13,3,0.0,118.6
12119,0568994b8323d640,c80095f6092271a7,83d0de122f2f9664,2008-09-06,1,0,0,123,0,0,31,11,23,8,0,0,8,6,4,4,19,5,4.4,118.0
12120,e915c1987050eac8,cc6f9d1e89f3449a,dc0f07928009a127,2008-08-09,0,0,0,12,0,0,3,0,3,0,0,0,0,0,0,0,3,0,0.0,9.0
12121,e915c1987050eac8,dc0f07928009a127,cc6f9d1e89f3449a,2008-08-09,1,0,0,12,0,0,3,3,2,1,0,0,1,1,0,0,2,2,3.0,9.0
12122,e2a61ec3bc83da98,93ce4ac89e3d7652,eff47295daf721a6,2008-08-09,0,1,0,900,2,1,25,2,21,4,0,0,4,2,14,9,7,0,44.3,343.9
12123,e2a61ec3bc83da98,eff47295daf721a6,93ce4ac89e3d7652,2008-08-09,0,7,0,900,7,4,44,22,20,24,1,1,23,15,4,3,16,7,423.1,238.7
12124,c92a4fe402579c49,2f3f12002564bb55,a56607a451e4c70d,2008-08-09,0,0,0,900,13,1,18,2,18,0,0,0,0,0,4,3,14,2,0.0,427.0
12125,c92a4fe402579c49,a56607a451e4c70d,2f3f12002564bb55,2008-08-09,3,2,0,900,2,2,72,28,48,24,8,8,16,13,18,11,30,15,405.0,360.0
12126,c5e0e4ee11903076,07f72a2a7591b409,cc300e9aa3063431,2008-08-09,0,0,0,900,5,2,102,25,97,5,0,0,5,3,29,17,68,22,22.9,644.0
12127,c5e0e4ee11903076,cc300e9aa3063431,07f72a2a7591b409,2008-08-09,0,0,0,900,1,0,84,11,84,0,0,0,0,0,35,23,49,11,0.0,770.1
12128,c2fd7ee22721846c,cb139171ed1b69fe,daf1b84aebd6602b,2008-08-09,0,0,0,900,7,5,99,38,85,14,0,0,14,12,22,13,63,26,68.6,727.0
12129,c2fd7ee22721846c,daf1b84aebd6602b,cb139171ed1b69fe,2008-08-09,0,0,0,900,5,0,103,19,98,5,1,1,4,4,27,13,71,15,26.0,753.4
12130,b2013a8b4ed68c8d,513c6f1715e547a8,7450525c7ba032a0,2008-08-09,1,1,0,900,6,5,52,15,17,35,21,21,14,12,9,9,8,3,577.5,182.4
12131,b2013a8b4ed68c8d,7450525c7ba032a0,513c6f1715e547a8,2008-08-09,0,0,0,900,0,0,21,3,18,3,0,0,3,1,7,6,11,2,24.6,207.5
12132,a23b4817f0b773c8,6506c1d34da9c013,6f018c039b4d5d80,2008-08-09,3,1,0,1500,9,7,226,103,156,70,6,6,64,43,27,22,129,60,628.1,795.6
12133,a23b4817f0b773c8,6f018c039b4d5d80,6506c1d34da9c013,2008-08-09,0,0,0,1500,6,0,132,22,125,7,1,1,6,4,22,14,103,18,31.4,759.9
12134,4f7a7a0b67f085b3,1eacf73d6a0055dc,dd8aec6de7035943,2008-08-09,1,0,0,295,2,2,34,9,17,17,7,5,10,7,11,9,6,2,170.0,65.0
12135,4f7a7a0b67f085b3,dd8aec6de7035943,1eacf73d6a0055dc,2008-08-09,0,2,0,295,0,0,9,0,9,0,0,0,0,0,3,2,6,0,0.0,125.0
12136,31362d9ea15127b2,2be6596a9db33bf5,427b5953ac8e3a27,2008-08-09,0,4,0,764,2,0,15,4,10,5,0,0,5,3,3,3,7,1,225.7,106.89999999999998
12137,31362d9ea15127b2,427b5953ac8e3a27,2be6596a9db33bf5,2008-08-09,0,3,1,764,4,2,59,26,14,45,0,0,45,25,6,4,8,1,341.1,159.3
12138,204fe39cf94f45dc,484acc7b0f856ce9,b732b326c362fb62,2008-08-09,1,2,1,448,1,1,58,22,52,6,1,1,5,5,20,18,32,17,124.0,200.0
12139,204fe39cf94f45dc,b732b326c362fb62,484acc7b0f856ce9,2008-08-09,0,2,0,448,7,0,53,7,53,0,0,0,0,0,9,5,44,7,0.0,302.0
12140,f8b6468621db85ca,3ba3b5cc94498437,cbf94e4c4af4ff6d,2008-07-19,0,0,0,261,0,0,15,6,6,9,0,0,9,5,1,1,5,1,246.0,15.0
12141,f8b6468621db85ca,cbf94e4c4af4ff6d,3ba3b5cc94498437,2008-07-19,0,2,1,261,0,0,3,0,3,0,0,0,0,0,3,1,0,0,0.0,15.0
12142,b9b8509c568dc144,89b8d1bf1ff09d1d,a0b91014e9d16a76,2008-07-19,1,0,0,114,0,0,68,19,66,2,0,0,2,2,2,0,64,17,2.0,112.0
12143,b9b8509c568dc144,a0b91014e9d16a76,89b8d1bf1ff09d1d,2008-07-19,0,0,0,114,0,0,22,2,22,0,0,0,0,0,5,4,17,2,0.0,112.0
12144,9f14f080b08e6869,e0ec3c3b6b611f7e,f2688492b9a525a3,2008-07-19,0,1,0,900,0,0,38,13,38,0,0,0,0,0,7,5,31,13,0.0,234.60000000000002
12145,9f14f080b08e6869,f2688492b9a525a3,e0ec3c3b6b611f7e,2008-07-19,0,0,0,900,11,10,112,51,27,85,11,11,74,43,7,7,20,8,665.4,172.0
12146,8d26509990b6e518,058e4e08a1ad8aba,9f1641c08cf8fbe2,2008-07-19,0,2,0,213,0,0,6,0,6,0,0,0,0,0,2,1,4,0,0.0,23.0
12147,8d26509990b6e518,9f1641c08cf8fbe2,058e4e08a1ad8aba,2008-07-19,0,2,1,213,1,1,8,1,4,4,2,1,2,0,1,1,3,1,190.0,23.0
12148,82f2afc6d7db44f3,23a16ebe733e3041,91d73ee59347ac16,2008-07-19,1,0,0,97,0,0,22,5,22,0,0,0,0,0,1,1,21,5,0.0,96.0
12149,82f2afc6d7db44f3,91d73ee59347ac16,23a16ebe733e3041,2008-07-19,0,0,0,97,0,0,32,16,32,0,0,0,0,0,2,2,30,16,0.0,94.0
12150,62f487635d7a9bb0,7e69a4b0961aa555,f74e037b97917027,2008-07-19,4,0,0,449,0,0,87,46,60,27,2,1,25,17,8,6,52,29,168.9,230.0
12151,62f487635d7a9bb0,f74e037b97917027,7e69a4b0961aa555,2008-07-19,0,0,0,449,6,0,33,4,33,0,0,0,0,0,5,5,28,4,0.0,252.1
12152,51ae1d8a663ae1fe,365fee2da473b177,a6d8bfe9e0c8153b,2008-07-19,0,0,0,815,6,5,98,27,87,11,2,1,9,4,25,23,62,23,165.8,407.0
12153,51ae1d8a663ae1fe,a6d8bfe9e0c8153b,365fee2da473b177,2008-07-19,1,0,0,815,1,0,83,12,82,1,0,0,1,1,33,25,49,11,1.0,632.2
12154,512f2d10f92d0d36,46e2ca71fd5089cb,fa315e6c77eee106,2008-07-19,0,0,0,900,5,1,53,8,52,1,0,0,1,1,28,22,24,7,15.7,649.5
12155,512f2d10f92d0d36,fa315e6c77eee106,46e2ca71fd5089cb,2008-07-19,0,0,0,900,4,2,74,17,68,6,2,1,4,3,23,20,45,14,30.5,696.3
12156,4eafb2657c3781f5,1f454354805b6f75,a7f4d0902bb64092,2008-07-19,1,0,0,61,0,0,13,11,5,8,0,0,8,8,2,2,3,3,6.0,55.0
12157,4eafb2657c3781f5,a7f4d0902bb64092,1f454354805b6f75,2008-07-19,0,0,0,61,0,0,3,0,3,0,0,0,0,0,1,0,2,0,0.0,55.0
12158,403bed9fe983b10a,5d7bdab5e03e3216,dd992d569aaebee6,2008-07-19,0,2,1,238,1,0,7,2,5,2,0,0,2,1,2,2,3,1,31.6,70.5
12159,403bed9fe983b10a,dd992d569aaebee6,5d7bdab5e03e3216,2008-07-19,0,0,0,238,3,1,13,2,6,7,0,0,7,1,2,2,4,1,88.5,67.4
12160,333c9e6f3cc8f91e,0ff11cc094e887bc,20bcc9966affb19c,2008-07-19,1,0,0,122,1,1,26,23,2,24,0,0,24,23,1,1,1,0,108.5,9.0
12161,333c9e6f3cc8f91e,20bcc9966affb19c,0ff11cc094e887bc,2008-07-19,0,0,0,122,0,0,1,1,1,0,0,0,0,0,0,0,1,1,0.0,13.5
12162,bcefcb29bec709d6,231926533134ec1f,abbc737317f66b81,2008-07-05,0,1,1,537,0,0,80,13,80,0,0,0,0,0,24,11,56,13,0.0,483.4
12163,bcefcb29bec709d6,abbc737317f66b81,231926533134ec1f,2008-07-05,0,0,0,537,2,2,88,27,81,7,0,0,7,1,11,7,70,26,42.6,385.0
12164,bbe3d2a2ad8d204e,270b89c00ef0c55c,75f871836d41f90f,2008-07-05,0,1,1,117,1,1,8,1,4,4,3,3,1,0,2,2,2,1,76.0,41.0
12165,bbe3d2a2ad8d204e,75f871836d41f90f,270b89c00ef0c55c,2008-07-05,0,0,0,117,0,0,9,0,9,0,0,0,0,0,4,2,5,0,0.0,41.0
12166,ae674ec42bd0a979,fcffee71cff5530e,ffc088e64fab57e9,2008-07-05,0,3,0,1500,1,0,276,31,248,28,1,1,27,12,70,45,178,19,200.9,1143.3
12167,ae674ec42bd0a979,ffc088e64fab57e9,fcffee71cff5530e,2008-07-05,1,0,0,1500,1,0,138,38,127,11,1,1,10,6,12,11,115,32,69.7,1109.1
12168,ac82d28aaa5faaf0,91acd6910b802a9e,dd37fd509af89f15,2008-07-05,0,5,0,900,0,0,65,11,65,0,0,0,0,0,9,5,56,11,0.0,358.5
12169,ac82d28aaa5faaf0,dd37fd509af89f15,91acd6910b802a9e,2008-07-05,0,0,0,900,4,2,58,33,20,38,2,2,36,27,3,3,17,6,528.5,302.0
12170,6760e48a36571feb,91186547a7f3f758,9fa3bd637edd9aa2,2008-07-05,0,2,0,900,11,2,62,15,41,21,8,8,13,7,4,3,37,8,270.3,569.0
12171,6760e48a36571feb,9fa3bd637edd9aa2,91186547a7f3f758,2008-07-05,0,0,0,900,0,0,64,13,60,4,1,1,3,2,11,10,49,11,35.0,524.7
12172,66f0238fac31130f,04d5718ed2661e8c,282fa667ff9c51ed,2008-07-05,0,0,0,888,3,3,127,34,119,8,0,0,8,3,26,20,93,31,60.2,596.6
12173,66f0238fac31130f,282fa667ff9c51ed,04d5718ed2661e8c,2008-07-05,0,2,1,888,2,1,141,24,129,12,1,1,11,9,29,16,100,15,50.4,701.8
12174,61f0ceb980c1ae81,04643fd03d9159cc,20205040232ed0f3,2008-07-05,0,1,0,900,4,0,80,13,80,0,0,0,0,0,7,7,73,13,0.0,589.0
12175,61f0ceb980c1ae81,20205040232ed0f3,04643fd03d9159cc,2008-07-05,0,0,0,900,3,3,175,47,143,32,8,5,24,15,60,40,83,32,282.0,521.0
12176,51b0cc51799e7d5d,75e5fec9f72910ef,79899ecf62020f6d,2008-07-05,0,1,0,477,5,5,24,4,23,1,0,0,1,1,0,0,23,3,37.8,270.6
12177,51b0cc51799e7d5d,79899ecf62020f6d,75e5fec9f72910ef,2008-07-05,1,2,1,477,3,1,27,8,25,2,0,0,2,2,4,4,21,6,55.4,245.2
12178,13858ffdaaef5671,5f87a5c00b3d17ed,ccd1299e0345e0ce,2008-07-05,0,0,0,36,0,0,1,0,1,0,0,0,0,0,0,0,1,0,0.0,16.0
12179,13858ffdaaef5671,ccd1299e0345e0ce,5f87a5c00b3d17ed,2008-07-05,2,0,0,36,0,0,15,10,5,10,0,0,10,6,0,0,5,4,20.0,16.0
12180,98b1ee14ad4ea1c6,234f3767ff0e5701,8f2d9ee27f206f1f,2008-06-21,0,1,0,900,0,0,96,47,96,0,0,0,0,0,12,12,84,47,0.0,677.4
12181,98b1ee14ad4ea1c6,8f2d9ee27f206f1f,234f3767ff0e5701,2008-06-21,0,0,0,900,8,3,47,15,41,6,0,0,6,3,12,12,29,12,140.6,361.0
12182,98a1121ffbc47657,05866d8c3a321856,1fd4fbdcc67de844,2008-06-21,0,0,0,68,3,1,6,3,6,0,0,0,0,0,0,0,6,3,0.0,55.8
12183,98a1121ffbc47657,1fd4fbdcc67de844,05866d8c3a321856,2008-06-21,1,0,0,68,1,1,32,15,31,1,0,0,1,1,5,4,26,14,0.2,63.0
12184,7ddaf46a81b7e616,18968f97ad34f15c,f34312c2ccfa0e00,2008-06-21,0,3,0,900,4,2,55,15,44,11,2,1,9,5,10,7,34,10,84.7,392.4
12185,7ddaf46a81b7e616,f34312c2ccfa0e00,18968f97ad34f15c,2008-06-21,0,0,0,900,5,1,104,32,62,42,3,3,39,16,26,21,36,16,353.6,293.3
12186,6aee27cc2610b56a,31123249b0bbf52e,de62052b2ede65ba,2008-06-21,1,1,0,520,0,0,65,22,40,25,3,1,22,10,11,9,29,12,140.5,293.2
12187,6aee27cc2610b56a,de62052b2ede65ba,31123249b0bbf52e,2008-06-21,0,0,0,520,6,2,64,18,60,4,0,0,4,3,11,8,49,15,18.8,271.5
12188,688c8b695e521ce8,6da99156486ed6c2,a149d6bc670cdb60,2008-06-21,0,0,0,586,1,1,60,20,48,12,1,1,11,8,20,13,28,12,134.4,362.0
12189,688c8b695e521ce8,a149d6bc670cdb60,6da99156486ed6c2,2008-06-21,0,3,1,586,1,1,43,9,43,0,0,0,0,0,7,4,36,9,0.0,409.6
12190,61d89b0cb175430c,288aaa8f82040e02,d023ae89a2a4a41e,2008-06-21,0,0,0,900,5,0,64,11,61,3,0,0,3,1,38,23,23,10,9.7,602.0
12191,61d89b0cb175430c,d023ae89a2a4a41e,288aaa8f82040e02,2008-06-21,0,2,0,900,6,5,80,15,61,19,11,10,8,7,44,35,17,8,149.0,341.3
12192,5288ef3edf1eda6e,68c6cd5287b473a7,8d26912cd2aeb366,2008-06-21,0,1,1,232,4,1,22,5,20,2,0,0,2,1,1,1,19,4,20.0,192.0
12193,5288ef3edf1eda6e,8d26912cd2aeb366,68c6cd5287b473a7,2008-06-21,0,0,0,232,0,0,28,2,28,0,0,0,0,0,1,0,27,2,0.0,137.0
12194,31c2d8648b06a001,82e7929bf6c2b689,9583662df31d943f,2008-06-21,2,1,0,847,8,0,116,41,92,24,2,1,22,13,9,9,83,28,57.9,736.0
12195,31c2d8648b06a001,9583662df31d943f,82e7929bf6c2b689,2008-06-21,0,1,0,847,3,1,80,18,80,0,0,0,0,0,13,9,67,18,0.0,744.1
12196,0700b74037329215,054defd5420a551f,42078a86d3dd037b,2008-06-21,0,4,1,238,1,1,13,9,2,11,0,0,11,8,0,0,2,1,93.0,13.0
12197,0700b74037329215,42078a86d3dd037b,054defd5420a551f,2008-06-21,0,0,0,238,1,1,6,0,1,5,4,4,1,0,1,1,0,0,132.0,13.0
12198,0064bbc554d85421,2650e2f846a30f64,5d7bdab5e03e3216,2008-06-21,0,2,1,182,0,0,5,0,5,0,0,0,0,0,3,2,2,0,0.0,49.0
12199,0064bbc554d85421,5d7bdab5e03e3216,2650e2f846a30f64,2008-06-21,0,0,0,182,1,1,16,4,4,12,2,1,10,3,1,1,3,1,133.0,49.0
12200,ff872fa3e9ec32a9,9fe85152f351e737,b7d524c77c27389b,2008-06-07,0,1,0,900,2,2,86,14,41,45,6,6,39,11,19,12,22,3,360.0,349.5
12201,ff872fa3e9ec32a9,b7d524c77c27389b,9fe85152f351e737,2008-06-07,0,2,0,900,5,3,55,20,50,5,0,0,5,4,14,11,36,16,30.5,406.0
12202,f8f73efa2d4cc566,1c86754617d9813a,a6d8bfe9e0c8153b,2008-06-07,0,0,0,530,6,2,30,10,7,23,0,0,23,10,2,2,5,0,423.0,66.5
12203,f8f73efa2d4cc566,a6d8bfe9e0c8153b,1c86754617d9813a,2008-06-07,0,1,1,530,0,0,13,7,10,3,0,0,3,3,2,1,8,4,40.5,53.0
12204,b976eb99de0f63ca,24b033b3daf1c9df,5be86bb2f78fef2f,2008-06-07,3,0,0,127,0,0,28,14,26,2,0,0,2,2,1,1,25,12,10.8,73.0
12205,b976eb99de0f63ca,5be86bb2f78fef2f,24b033b3daf1c9df,2008-06-07,0,0,0,127,2,0,23,4,23,0,0,0,0,0,5,4,18,4,0.0,102.2
12206,b3a3341a5db2d484,31ee470ef5dc8d7f,621a6c59f88a44fe,2008-06-07,1,0,0,362,1,1,16,8,8,8,0,0,8,5,2,2,6,3,69.6,92.0
12207,b3a3341a5db2d484,621a6c59f88a44fe,31ee470ef5dc8d7f,2008-06-07,0,0,0,362,7,1,13,2,3,10,7,7,3,2,0,0,3,0,183.0,109.4
12208,96c95cff535291d9,9b74de674c355425,a8aba6fd8a463043,2008-06-07,1,0,0,900,1,1,86,24,62,24,4,3,20,7,18,18,44,17,87.2,571.8
12209,96c95cff535291d9,a8aba6fd8a463043,9b74de674c355425,2008-06-07,0,1,0,900,13,7,70,27,63,7,0,0,7,5,9,8,54,22,139.2,275.8
12210,94f880f25dd011cd,8a59d346dc976a10,eb29176b03dfa888,2008-06-07,0,3,0,417,3,1,35,11,25,10,0,0,10,3,3,2,22,8,137.4,137.8
12211,94f880f25dd011cd,eb29176b03dfa888,8a59d346dc976a10,2008-06-07,1,1,0,417,4,2,34,12,31,3,0,0,3,3,8,6,23,9,18.2,206.6
12212,8a8400c6c42df59a,69b69c0178c4004d,7f0b4a75ef3039a3,2008-06-07,1,0,0,555,0,0,75,32,75,0,0,0,0,0,19,16,56,32,0.0,486.7
12213,8a8400c6c42df59a,7f0b4a75ef3039a3,69b69c0178c4004d,2008-06-07,2,0,0,555,4,2,67,32,65,2,0,0,2,1,1,1,64,31,25.3,264.0
12214,761681c1ab0fdead,2b93ebd9f5417ad2,a6fd2173d5e2d7f0,2008-06-07,1,0,0,222,2,2,43,18,18,25,2,2,23,15,5,5,13,3,118.3,80.0
12215,761681c1ab0fdead,a6fd2173d5e2d7f0,2b93ebd9f5417ad2,2008-06-07,0,0,0,222,0,0,12,3,12,0,0,0,0,0,5,4,7,3,0.0,100.7
12216,4a482ad5b021bb25,8b69839f3555a67b,cb46dface0e28a2c,2008-06-07,0,2,1,164,1,1,9,2,5,4,0,0,4,2,2,2,3,0,101.6,37.0
12217,4a482ad5b021bb25,cb46dface0e28a2c,8b69839f3555a67b,2008-06-07,0,1,0,164,0,0,6,0,6,0,0,0,0,0,2,2,4,0,0.0,59.400000000000006
12218,171007deb1cc56aa,a8e6a69796280f17,cfb65863d5099327,2008-06-07,0,0,0,900,7,5,72,23,49,23,1,1,22,15,16,11,33,8,295.5,396.9
12219,171007deb1cc56aa,cfb65863d5099327,a8e6a69796280f17,2008-06-07,1,2,0,900,1,0,45,12,38,7,0,0,7,4,4,1,34,8,79.1,491.5
12220,0fe3681eb934bdc3,492b202d2064e7a9,fa315e6c77eee106,2008-06-07,1,0,0,280,4,2,36,10,18,18,2,1,16,7,5,4,13,3,95.8,141.7
12221,0fe3681eb934bdc3,fa315e6c77eee106,492b202d2064e7a9,2008-06-07,0,0,0,280,0,0,22,6,20,2,0,0,2,2,10,9,10,4,5.3,147.2
12222,e57d1260201e5101,2924886ee9c4c527,3795fca327cbcf23,2008-05-24,1,1,0,144,0,0,23,14,5,18,2,2,16,13,3,3,2,1,74.6,53.3
12223,e57d1260201e5101,3795fca327cbcf23,2924886ee9c4c527,2008-05-24,1,0,0,144,2,1,12,1,11,1,0,0,1,0,4,4,7,1,3.7,47.400000000000006
12224,c9d3ccbfef600989,029880cdbf5ca089,73c7cfa551289285,2008-05-24,0,0,0,900,2,0,162,26,162,0,0,0,0,0,20,20,142,26,0.0,898.4
12225,c9d3ccbfef600989,73c7cfa551289285,029880cdbf5ca089,2008-05-24,1,0,0,900,1,0,175,109,172,3,0,0,3,3,13,13,159,106,1.6,893.0
12226,c5bef3da17e595ee,132f860d02953f4c,af5b208e97f5d382,2008-05-24,1,0,0,495,0,0,63,27,44,19,0,0,19,11,10,6,34,16,68.0,382.7
12227,c5bef3da17e595ee,af5b208e97f5d382,132f860d02953f4c,2008-05-24,1,0,0,495,0,0,73,22,54,19,0,0,19,7,14,11,40,15,44.3,357.0
12228,bd5edc0bfa0db8c8,2f732dd9210d301f,f7a7f7118d4b01b6,2008-05-24,0,2,0,900,7,0,53,2,53,0,0,0,0,0,18,14,35,2,0.0,719.5
12229,bd5edc0bfa0db8c8,f7a7f7118d4b01b6,2f732dd9210d301f,2008-05-24,1,0,0,900,1,1,60,18,48,12,2,1,10,5,24,22,24,13,161.5,725.0
12230,b376a6fb0ca4862e,ab8900ae1f1dfd4c,cd7bafbeee1f29a0,2008-05-24,0,1,1,56,1,1,3,1,3,0,0,0,0,0,0,0,3,1,0.0,18.0
12231,b376a6fb0ca4862e,cd7bafbeee1f29a0,ab8900ae1f1dfd4c,2008-05-24,0,0,0,56,0,0,2,0,2,0,0,0,0,0,1,1,1,0,0.0,56.0
12232,6baa381a75582d98,a1f6999fe57236e0,b9d0fd83bb8a147a,2008-05-24,2,0,0,36,0,0,18,11,10,8,0,0,8,6,0,0,10,5,9.0,27.0
12233,6baa381a75582d98,b9d0fd83bb8a147a,a1f6999fe57236e0,2008-05-24,0,0,0,36,0,0,4,0,4,0,0,0,0,0,1,1,3,0,0.0,27.0
12234,628d02b6046d5f73,68dd7b3783c19f9c,f1b2a4365799c48b,2008-05-24,1,0,0,44,0,0,14,5,12,2,0,0,2,2,0,0,12,3,0.0,44.0
12235,628d02b6046d5f73,f1b2a4365799c48b,68dd7b3783c19f9c,2008-05-24,0,0,0,44,0,0,11,2,11,0,0,0,0,0,0,0,11,2,0.0,44.0
12236,1d00497a573d7f4c,9bcf8603ceb25680,ad3041e61896b975,2008-05-24,1,0,0,625,3,3,92,74,30,62,0,0,62,53,3,3,27,21,336.1,175.0
12237,1d00497a573d7f4c,ad3041e61896b975,9bcf8603ceb25680,2008-05-24,0,0,0,625,6,0,14,1,14,0,0,0,0,0,1,1,13,1,0.0,179.89999999999998
12238,03d30a534dee8ac5,394f55ebca199124,8ddf9c51c5fdea75,2008-05-24,0,0,0,156,0,0,1,0,1,0,0,0,0,0,1,1,0,0,0.0,156.0
12239,03d30a534dee8ac5,8ddf9c51c5fdea75,394f55ebca199124,2008-05-24,0,3,1,156,1,1,0,0,0,0,0,0,0,0,0,0,0,0,0.0,19.0
12240,02d2da0420fbdd39,33011768c3c4dc9a,7d21de9c6d7c98b2,2008-05-24,1,1,0,900,0,0,61,13,57,4,0,0,4,1,15,10,42,12,17.5,386.1
12241,02d2da0420fbdd39,7d21de9c6d7c98b2,33011768c3c4dc9a,2008-05-24,0,0,0,900,8,4,47,14,36,11,2,1,9,6,5,5,31,8,465.9,289.5
12242,004b9368337d3cd6,b034747dc1d15491,d1152823307d7e7c,2008-05-24,0,0,0,300,0,0,23,1,23,0,0,0,0,0,5,5,18,1,0.0,299.0
12243,004b9368337d3cd6,d1152823307d7e7c,b034747dc1d15491,2008-05-24,1,0,0,300,0,0,46,7,44,2,0,0,2,2,19,19,25,5,1.0,297.0
12244,eb1b371dfc37fcdb,0ff11cc094e887bc,6803d4d6908354ac,2008-04-19,3,0,0,130,0,0,55,33,15,40,0,0,40,26,3,3,12,7,96.0,22.0
12245,eb1b371dfc37fcdb,6803d4d6908354ac,0ff11cc094e887bc,2008-04-19,0,0,0,130,1,0,4,1,4,0,0,0,0,0,0,0,4,1,0.0,34.0
12246,df3b75809b7fe252,86f582852a5b240a,cf9d24e4bd0cf2ce,2008-04-19,1,2,1,828,1,1,88,42,52,36,0,0,36,22,5,4,47,20,264.9,289.9
12247,df3b75809b7fe252,cf9d24e4bd0cf2ce,86f582852a5b240a,2008-04-19,0,0,0,828,9,3,77,15,53,24,3,3,21,7,5,4,48,8,251.1,270.1
12248,be38ed9ccfe2ee03,9d4522df6fc49a47,fb1538b46877a695,2008-04-19,1,0,0,427,5,1,50,19,26,24,0,0,24,12,2,2,24,7,77.0,350.0
12249,be38ed9ccfe2ee03,fb1538b46877a695,9d4522df6fc49a47,2008-04-19,2,0,0,427,0,0,78,18,78,0,0,0,0,0,14,13,64,18,0.0,330.0
12250,b675c94f20551631,52cae54377b433b7,c8136ab8aa32c974,2008-04-19,0,0,0,900,0,0,164,31,164,0,0,0,0,0,58,53,106,31,0.0,891.8
12251,b675c94f20551631,c8136ab8aa32c974,52cae54377b433b7,2008-04-19,0,0,0,900,3,1,53,7,52,1,0,0,1,0,8,5,44,7,8.2,859.0
12252,af178adff964d854,06f36cf4bd97ec77,427b5953ac8e3a27,2008-04-19,0,0,0,447,1,1,32,11,6,26,1,1,25,10,4,3,2,1,197.6,45.19999999999999
12253,af178adff964d854,427b5953ac8e3a27,06f36cf4bd97ec77,2008-04-19,0,3,1,447,8,1,21,12,4,17,1,1,16,11,3,2,1,1,173.8,65.4
12254,96da5813683649f5,2be6596a9db33bf5,dbaaf42313af90fa,2008-04-19,1,2,0,354,2,1,17,9,5,12,3,3,9,9,1,1,4,0,84.0,36.0
12255,96da5813683649f5,dbaaf42313af90fa,2be6596a9db33bf5,2008-04-19,0,3,0,354,1,1,6,1,4,2,1,1,1,1,2,2,2,0,227.0,43.0
12256,920194911d727a38,4130a743d9d22163,a6fd2173d5e2d7f0,2008-04-19,0,0,0,238,1,1,8,1,5,3,1,1,2,0,2,1,3,1,162.0,76.0
12257,920194911d727a38,a6fd2173d5e2d7f0,4130a743d9d22163,2008-04-19,1,0,0,238,0,0,43,24,43,0,0,0,0,0,5,5,38,24,0.0,76.0
12258,8153c30fad5b2ad8,2b93ebd9f5417ad2,da97d6c97d09c030,2008-04-19,1,0,0,300,0,0,90,19,87,3,1,1,2,1,24,19,63,18,4.7,228.0
12259,8153c30fad5b2ad8,da97d6c97d09c030,2b93ebd9f5417ad2,2008-04-19,0,1,0,300,1,1,12,0,12,0,0,0,0,0,1,1,11,0,0.0,233.3
12260,6ae2cd7feede5a33,622f015c81a9b13a,d897897060f10a3a,2008-04-19,0,1,0,481,9,1,9,1,7,2,0,0,2,1,0,0,7,0,202.0,230.0
12261,6ae2cd7feede5a33,d897897060f10a3a,622f015c81a9b13a,2008-04-19,1,0,0,481,0,0,43,18,36,7,1,1,6,3,10,9,26,15,49.0,153.0
12262,67948da92e6c9bdc,6506c1d34da9c013,86dfed7cc24a9fa7,2008-04-19,1,0,0,585,5,4,54,23,14,40,16,16,24,14,3,3,11,9,468.6,93.0
12263,67948da92e6c9bdc,86dfed7cc24a9fa7,6506c1d34da9c013,2008-04-19,0,0,0,585,0,0,18,1,18,0,0,0,0,0,2,2,16,1,0.0,116.39999999999998
12264,219bd976b8ca745d,501b07aec9b8fc2d,7d21de9c6d7c98b2,2008-04-19,0,0,0,900,1,0,176,24,176,0,0,0,0,0,30,24,146,24,0.0,704.4
12265,219bd976b8ca745d,7d21de9c6d7c98b2,501b07aec9b8fc2d,2008-04-19,0,3,0,900,9,3,102,29,98,4,0,0,4,3,11,11,87,26,184.6,577.0
12266,f35b859289fba80e,1208ffc5be6e31ad,c47df9303d318c67,2008-04-02,0,0,0,255,0,0,22,4,22,0,0,0,0,0,1,0,21,4,0.0,139.0
12267,f35b859289fba80e,c47df9303d318c67,1208ffc5be6e31ad,2008-04-02,1,0,0,255,1,1,26,10,11,15,1,1,14,8,1,0,10,2,116.0,139.0
12268,dbe6c361530958bc,98b80a717b9bda17,c80095f6092271a7,2008-04-02,1,0,0,385,1,1,71,30,52,19,0,0,19,13,1,1,51,17,124.3,227.9
12269,dbe6c361530958bc,c80095f6092271a7,98b80a717b9bda17,2008-04-02,0,0,0,385,1,0,58,9,57,1,0,0,1,0,10,9,47,9,0.1,258.7
12270,b89dea8c3e6bba6f,c9bbf1a0285a8076,cc6f9d1e89f3449a,2008-04-02,0,0,0,101,1,0,4,0,4,0,0,0,0,0,2,2,2,0,0.0,28.0
12271,b89dea8c3e6bba6f,cc6f9d1e89f3449a,c9bbf1a0285a8076,2008-04-02,0,1,1,101,5,1,4,0,4,0,0,0,0,0,3,3,1,0,0.0,87.0
12272,9103686732816d77,40a604761ca7d64d,d1a1314976c50bef,2008-04-02,0,0,0,900,5,2,84,17,84,0,0,0,0,0,3,3,81,17,0.0,449.2
12273,9103686732816d77,d1a1314976c50bef,40a604761ca7d64d,2008-04-02,0,0,0,900,4,3,164,60,100,64,0,0,64,42,25,20,75,18,357.8,408.0
12274,78f46acac9223859,31ee470ef5dc8d7f,349aaa3da11eb587,2008-04-02,1,0,0,324,0,0,48,12,45,3,0,0,3,3,5,5,40,9,1.2,264.5
12275,78f46acac9223859,349aaa3da11eb587,31ee470ef5dc8d7f,2008-04-02,0,0,0,324,4,1,45,7,41,4,1,1,3,1,2,2,39,6,57.5,207.8
12276,6ca284a75c21c2e0,04643fd03d9159cc,35dc6220b113b7ec,2008-04-02,1,1,1,16,0,0,11,6,5,6,0,0,6,5,0,0,5,1,6.0,10.0
12277,6ca284a75c21c2e0,35dc6220b113b7ec,04643fd03d9159cc,2008-04-02,0,0,0,16,0,0,1,0,1,0,0,0,0,0,0,0,1,0,0.0,10.0
12278,53e9e8fefa2c2f42,2961be02cfb0d2c1,896c322f56b8be5a,2008-04-02,0,0,0,444,0,0,12,0,11,1,0,0,1,0,4,2,7,0,18.0,106.69999999999999
12279,53e9e8fefa2c2f42,896c322f56b8be5a,2961be02cfb0d2c1,2008-04-02,1,3,0,444,4,3,35,20,14,21,1,1,20,16,1,0,13,4,301.3,96.0
12280,362f78f23304c6f4,3bad7ef643840f67,cb139171ed1b69fe,2008-04-02,0,2,0,508,3,2,12,5,8,4,0,0,4,2,1,0,7,3,111.0,173.0
12281,362f78f23304c6f4,cb139171ed1b69fe,3bad7ef643840f67,2008-04-02,1,0,0,508,4,2,74,26,12,62,3,3,59,26,6,6,6,0,224.0,173.0
12282,30aa9b4d266eb622,1411c630ba711b64,365fee2da473b177,2008-04-02,0,0,0,51,2,0,7,0,7,0,0,0,0,0,0,0,7,0,0.0,50.7
12283,30aa9b4d266eb622,365fee2da473b177,1411c630ba711b64,2008-04-02,1,0,0,51,0,0,25,14,23,2,0,0,2,2,1,1,22,12,0.3,50.0
12284,190c61d5a67018b5,7d96bc577e5178b2,f2688492b9a525a3,2008-04-02,0,0,0,900,10,9,65,15,60,5,2,1,3,2,5,3,55,13,171.8,522.0
12285,190c61d5a67018b5,f2688492b9a525a3,7d96bc577e5178b2,2008-04-02,0,0,0,900,5,1,75,20,75,0,0,0,0,0,6,6,69,20,0.0,697.2
12286,10b19bb48aadc6bd,0541480fbf719d86,a7f4d0902bb64092,2008-04-02,0,0,0,8,0,0,1,0,1,0,0,0,0,0,0,0,1,0,0.0,6.0
12287,10b19bb48aadc6bd,a7f4d0902bb64092,0541480fbf719d86,2008-04-02,1,0,0,8,0,0,4,3,1,3,0,0,3,2,0,0,1,1,2.0,6.0
12288,089dd2e0cc6395fa,8355922d564b152c,aa1952ec0b3dd8e1,2008-04-02,0,1,1,486,1,1,17,0,16,1,1,1,0,0,6,5,10,0,11.7,74.39999999999998
12289,089dd2e0cc6395fa,aa1952ec0b3dd8e1,8355922d564b152c,2008-04-02,0,0,0,486,3,3,34,19,5,29,1,1,28,19,0,0,5,0,329.6,133.3
12290,d036a7aeab47cf8c,04d5718ed2661e8c,88c8f47241d90040,2008-03-01,0,0,0,900,5,1,137,43,74,63,0,0,63,33,26,25,48,10,443.6,359.5
12291,d036a7aeab47cf8c,88c8f47241d90040,04d5718ed2661e8c,2008-03-01,0,2,0,900,0,0,102,29,94,8,0,0,8,3,16,15,78,26,19.5,395.4
12292,bcf49463525efbee,1efa064872f089d0,82e7929bf6c2b689,2008-03-01,0,0,0,283,0,0,1,0,1,0,0,0,0,0,1,1,0,0,0.0,13.0
12293,bcf49463525efbee,82e7929bf6c2b689,1efa064872f089d0,2008-03-01,1,0,0,283,1,1,50,21,1,49,3,3,46,21,0,0,1,0,270.0,13.0
12294,a53b8686b748849f,1ccf4e7caff270df,1f454354805b6f75,2008-03-01,0,0,0,592,3,1,40,11,28,12,0,0,12,7,10,9,18,4,117.4,236.3
12295,a53b8686b748849f,1f454354805b6f75,1ccf4e7caff270df,2008-03-01,0,1,1,592,0,0,59,28,28,31,10,10,21,18,9,9,19,10,130.7,318.6
12296,8b15591a73aa7eb0,20bcc9966affb19c,3738e68d2261e60f,2008-03-01,0,0,0,557,14,2,12,3,10,2,0,0,2,2,1,1,9,1,142.0,162.5
12297,8b15591a73aa7eb0,3738e68d2261e60f,20bcc9966affb19c,2008-03-01,1,0,0,557,1,1,35,8,22,13,0,0,13,7,8,6,14,1,110.5,296.0
12298,825aa322af15780a,a149d6bc670cdb60,dd37fd509af89f15,2008-03-01,0,2,0,384,0,0,59,12,58,1,0,0,1,1,9,8,49,11,0.0,352.0
12299,825aa322af15780a,dd37fd509af89f15,a149d6bc670cdb60,2008-03-01,1,0,0,384,1,1,59,14,55,4,0,0,4,2,12,10,43,12,32.0,312.0
12300,65352762d807cd59,1eacf73d6a0055dc,7450525c7ba032a0,2008-03-01,0,0,0,900,5,5,60,17,18,42,17,15,25,15,13,13,5,2,393.8,72.60000000000002
12301,65352762d807cd59,7450525c7ba032a0,1eacf73d6a0055dc,2008-03-01,1,0,0,900,4,3,80,9,16,64,52,45,12,7,6,3,10,2,330.4,155.2
12302,5182daf3d8726f6d,93ce4ac89e3d7652,9583662df31d943f,2008-03-01,0,0,0,900,1,0,39,9,34,5,0,0,5,3,10,7,24,6,11.8,293.4
12303,5182daf3d8726f6d,9583662df31d943f,93ce4ac89e3d7652,2008-03-01,0,0,0,900,16,13,75,26,17,58,6,5,52,21,3,1,14,5,566.6,253.2
12304,50325e08203fedbd,7f955f71fa2ce7ac,d43a048a880efdff,2008-03-01,0,0,0,196,0,0,33,12,33,0,0,0,0,0,2,1,31,12,0.0,188.4
12305,50325e08203fedbd,d43a048a880efdff,7f955f71fa2ce7ac,2008-03-01,1,0,0,196,1,0,50,15,45,5,0,0,5,4,15,9,30,11,7.6,170.0
12306,04476d021385a621,8f2d9ee27f206f1f,acff437707625fc7,2008-03-01,0,0,0,480,3,1,44,6,44,0,0,0,0,0,18,13,26,6,0.0,363.0
12307,04476d021385a621,acff437707625fc7,8f2d9ee27f206f1f,2008-03-01,2,0,0,480,0,0,58,14,58,0,0,0,0,0,13,12,45,14,0.0,443.0
12308,029cd254fe02d4b8,6f018c039b4d5d80,a56607a451e4c70d,2008-03-01,0,0,0,900,9,4,76,19,54,22,9,7,13,11,21,14,33,8,404.5,422.0
12309,029cd254fe02d4b8,a56607a451e4c70d,6f018c039b4d5d80,2008-03-01,0,1,0,900,0,0,52,10,52,0,0,0,0,0,18,12,34,10,0.0,487.5
12310,fc6d1396755692b4,2a542ee8a8b83559,ee9d73f4fee9cbdd,2008-02-02,1,0,0,688,0,0,131,51,117,14,0,0,14,9,2,2,115,42,88.4,568.0
12311,fc6d1396755692b4,ee9d73f4fee9cbdd,2a542ee8a8b83559,2008-02-02,0,1,1,688,11,2,70,22,70,0,0,0,0,0,7,6,63,22,0.0,568.6
12312,f0b42c9e55025ad3,1ff9589f9065a9ed,513c6f1715e547a8,2008-02-02,0,3,1,90,0,0,3,0,3,0,0,0,0,0,2,2,1,0,0.0,22.0
12313,f0b42c9e55025ad3,513c6f1715e547a8,1ff9589f9065a9ed,2008-02-02,0,0,0,90,1,1,24,16,1,23,0,0,23,15,0,0,1,1,68.0,22.0
12314,dd47c3359dc1b7d0,20205040232ed0f3,75e5fec9f72910ef,2008-02-02,0,0,0,900,2,0,119,26,119,0,0,0,0,0,41,34,78,26,0.0,658.7
12315,dd47c3359dc1b7d0,75e5fec9f72910ef,20205040232ed0f3,2008-02-02,0,0,0,900,8,6,93,19,87,6,1,1,5,5,4,3,83,14,141.3,688.0
12316,d9a8d19107d2bd9e,4f95f74620a6b7a4,c80095f6092271a7,2008-02-02,0,0,0,292,0,0,31,5,31,0,0,0,0,0,2,2,29,5,0.0,291.1
12317,d9a8d19107d2bd9e,c80095f6092271a7,4f95f74620a6b7a4,2008-02-02,1,0,0,292,2,1,60,25,56,4,0,0,4,4,19,17,37,21,0.9,286.0
12318,c5f56797c68ecbeb,65ddc8a9ac4e8531,dc0f07928009a127,2008-02-02,1,0,0,900,4,4,191,53,189,2,0,0,2,0,5,4,184,53,11.7,812.0
12319,c5f56797c68ecbeb,dc0f07928009a127,65ddc8a9ac4e8531,2008-02-02,0,0,0,900,0,0,212,44,210,2,0,0,2,2,38,37,172,42,0.0,888.3
12320,bb6eacc986791dcd,91acd6910b802a9e,a6959da32f0e6b5d,2008-02-02,1,0,0,33,0,0,17,11,13,4,0,0,4,3,1,1,12,8,2.3,29.0
12321,bb6eacc986791dcd,a6959da32f0e6b5d,91acd6910b802a9e,2008-02-02,0,0,0,33,1,0,3,0,3,0,0,0,0,0,0,0,3,0,0.0,30.7
12322,96828ec042f211bf,42078a86d3dd037b,91186547a7f3f758,2008-02-02,0,0,0,68,0,0,11,2,10,1,0,0,1,1,0,0,10,1,5.0,44.0
12323,96828ec042f211bf,91186547a7f3f758,42078a86d3dd037b,2008-02-02,0,1,1,68,1,1,6,2,5,1,0,0,1,1,2,2,3,1,19.0,44.0
12324,8f560a1fa19c122a,8d26912cd2aeb366,a8e6a69796280f17,2008-02-02,0,1,0,397,3,1,11,4,6,5,0,0,5,3,2,1,4,1,59.3,158.4
12325,8f560a1fa19c122a,a8e6a69796280f17,8d26912cd2aeb366,2008-02-02,1,1,1,397,2,2,30,16,13,17,0,0,17,10,6,6,7,6,155.6,99.7
12326,7929542a0003799f,05866d8c3a321856,6a92caba39b64752,2008-02-02,0,0,0,900,3,1,89,16,89,0,0,0,0,0,25,24,64,16,0.0,646.0
12327,7929542a0003799f,6a92caba39b64752,05866d8c3a321856,2008-02-02,0,0,0,900,8,1,85,11,85,0,0,0,0,0,42,39,43,11,0.0,566.0
12328,fc0d77057ec806fe,231926533134ec1f,eb29176b03dfa888,2008-01-23,0,0,0,176,0,0,10,3,10,0,0,0,0,0,0,0,10,3,0.0,16.0
12329,fc0d77057ec806fe,eb29176b03dfa888,231926533134ec1f,2008-01-23,0,3,1,176,1,1,9,5,2,7,0,0,7,5,1,1,1,0,160.0,16.0
12330,e1c333892d395a35,abbc737317f66b81,c6d8ae3b016d5ad5,2008-01-23,1,0,0,337,0,0,40,19,17,23,3,3,20,17,7,7,10,2,168.4,132.0
12331,e1c333892d395a35,c6d8ae3b016d5ad5,abbc737317f66b81,2008-01-23,0,0,0,337,10,0,10,0,10,0,0,0,0,0,1,0,9,0,0.0,149.6
12332,d9decf169a2da676,8355922d564b152c,cbe79765d44bd172,2008-01-23,0,2,1,219,2,2,8,3,2,6,0,0,6,2,0,0,2,1,151.0,11.0
12333,d9decf169a2da676,cbe79765d44bd172,8355922d564b152c,2008-01-23,0,2,0,219,0,0,5,2,1,4,0,0,4,2,0,0,1,0,57.0,11.0
12334,d470bb3cb98d9ed7,1fd4fbdcc67de844,9fa3bd637edd9aa2,2008-01-23,0,0,0,104,0,0,15,2,15,0,0,0,0,0,6,6,9,2,0.0,102.0
12335,d470bb3cb98d9ed7,9fa3bd637edd9aa2,1fd4fbdcc67de844,2008-01-23,1,0,0,104,0,0,31,13,25,6,0,0,6,6,4,1,21,7,2.0,101.0
12336,c4b0ef8f42eecbcc,18968f97ad34f15c,282fa667ff9c51ed,2008-01-23,1,0,0,584,1,1,54,24,18,36,4,3,32,21,4,3,14,3,259.0,220.6
12337,c4b0ef8f42eecbcc,282fa667ff9c51ed,18968f97ad34f15c,2008-01-23,0,3,0,584,1,0,29,4,23,6,0,0,6,3,1,1,22,1,104.4,151.0
12338,b5bef60f79b38e69,8a59d346dc976a10,9f842be1a5337be6,2008-01-23,0,0,0,900,14,7,43,14,36,7,0,0,7,4,10,5,26,10,155.9,338.0
12339,b5bef60f79b38e69,9f842be1a5337be6,8a59d346dc976a10,2008-01-23,0,2,0,900,1,1,32,6,18,14,3,3,11,6,2,2,16,0,161.0,514.1
12340,804eff79a58ad250,5f87a5c00b3d17ed,7d96bc577e5178b2,2008-01-23,0,0,0,900,2,1,40,11,35,5,0,0,5,1,7,5,28,10,96.9,148.79999999999995
12341,804eff79a58ad250,7d96bc577e5178b2,5f87a5c00b3d17ed,2008-01-23,1,3,0,900,2,2,66,23,20,46,3,2,43,18,1,1,19,5,596.2,155.1
12342,3957d820e11275f7,25433871e4eee0f4,aa1952ec0b3dd8e1,2008-01-23,1,2,0,415,4,0,26,3,26,0,0,0,0,0,2,1,24,3,0.0,270.2
12343,3957d820e11275f7,aa1952ec0b3dd8e1,25433871e4eee0f4,2008-01-23,1,0,0,415,2,1,51,19,42,9,1,1,8,5,5,3,37,14,99.8,293.0
12344,20fc3b3ab2d2fecf,6da99156486ed6c2,9fe85152f351e737,2008-01-23,0,0,0,900,10,1,83,9,83,0,0,0,0,0,37,30,46,9,0.0,556.0
12345,20fc3b3ab2d2fecf,9fe85152f351e737,6da99156486ed6c2,2008-01-23,0,0,0,900,0,0,101,11,101,0,0,0,0,0,47,43,54,11,0.0,816.0
12346,f9b600343a31227b,270b89c00ef0c55c,492b202d2064e7a9,2008-01-19,0,0,0,574,4,3,33,5,28,5,0,0,5,3,17,14,11,2,86.4,333.7
12347,f9b600343a31227b,492b202d2064e7a9,270b89c00ef0c55c,2008-01-19,1,0,0,574,1,0,89,43,53,36,2,1,34,21,3,2,50,22,119.3,318.6
12348,db68ff7bf2487971,501b07aec9b8fc2d,58bc81376286b3d3,2008-01-19,0,0,0,900,0,0,127,10,100,27,11,10,16,7,18,13,82,3,235.9,568.0
12349,db68ff7bf2487971,58bc81376286b3d3,501b07aec9b8fc2d,2008-01-19,0,1,0,900,30,2,43,5,43,0,0,0,0,0,17,15,26,5,0.0,482.1
12350,d98d5a3800cd21fb,73c7cfa551289285,79899ecf62020f6d,2008-01-19,2,1,1,542,0,0,69,38,40,29,2,2,27,16,1,1,39,22,367.6,149.0
12351,d98d5a3800cd21fb,79899ecf62020f6d,73c7cfa551289285,2008-01-19,0,0,0,542,0,0,36,11,26,10,4,4,6,4,3,2,23,7,0.0,174.39999999999998
12352,cfca060f39db1742,9b74de674c355425,aac5ac38148f0528,2008-01-19,0,3,0,900,1,1,81,29,60,21,0,0,21,13,14,14,46,16,42.0,196.89999999999998
12353,cfca060f39db1742,aac5ac38148f0528,9b74de674c355425,2008-01-19,0,0,0,900,3,3,139,57,51,88,7,7,81,39,7,6,44,18,621.1,131.0
12354,74c98716b4a74a3d,234f3767ff0e5701,cb46dface0e28a2c,2008-01-19,0,0,0,80,0,0,1,0,1,0,0,0,0,0,0,0,1,0,0.0,15.0
12355,74c98716b4a74a3d,cb46dface0e28a2c,234f3767ff0e5701,2008-01-19,1,0,0,80,1,1,38,27,12,26,0,0,26,19,1,1,11,8,65.0,15.0
12356,524ce5c0d6db74bb,a8aba6fd8a463043,b7d524c77c27389b,2008-01-19,0,0,0,64,0,0,8,0,8,0,0,0,0,0,6,4,2,0,0.0,62.0
12357,524ce5c0d6db74bb,b7d524c77c27389b,a8aba6fd8a463043,2008-01-19,1,0,0,64,0,0,5,4,3,2,0,0,2,2,1,1,2,2,2.0,62.0
12358,26ad51050ea55600,1a1a4d7a29041d77,69b69c0178c4004d,2008-01-19,0,0,0,17,0,0,2,0,2,0,0,0,0,0,0,0,2,0,0.0,17.0
12359,26ad51050ea55600,69b69c0178c4004d,1a1a4d7a29041d77,2008-01-19,1,0,0,17,0,0,7,2,7,0,0,0,0,0,4,3,3,2,0.0,13.0
12360,1197b94bb4b56cc2,7f955f71fa2ce7ac,863d06a7ef8bc98c,2008-01-19,1,0,0,90,0,0,10,8,2,8,0,0,8,8,0,0,2,0,8.0,82.0
12361,1197b94bb4b56cc2,863d06a7ef8bc98c,7f955f71fa2ce7ac,2008-01-19,0,0,0,90,4,2,1,0,1,0,0,0,0,0,0,0,1,0,0.0,40.0
12362,0e37ea649c51fba9,5be86bb2f78fef2f,af5b208e97f5d382,2008-01-19,0,0,0,337,1,1,56,16,11,45,7,6,38,16,5,5,6,0,271.9,40.0
12363,0e37ea649c51fba9,af5b208e97f5d382,5be86bb2f78fef2f,2008-01-19,1,4,0,337,1,0,14,5,12,2,0,0,2,1,0,0,12,4,7.0,58.10000000000002
12364,c1b59b145d064048,cf9d24e4bd0cf2ce,d3de4a24f7eefac8,2007-12-29,0,0,0,900,17,7,58,16,37,21,0,0,21,11,10,10,27,5,382.8,262.0
12365,c1b59b145d064048,d3de4a24f7eefac8,cf9d24e4bd0cf2ce,2007-12-29,0,1,0,900,1,1,66,14,66,0,0,0,0,0,8,8,58,14,0.0,465.2
12366,b03816c9ccd089d7,1c86754617d9813a,6ad9058b7c7898b0,2007-12-29,1,2,0,513,3,3,27,19,13,14,2,2,12,12,3,3,10,7,211.5,157.0
12367,b03816c9ccd089d7,6ad9058b7c7898b0,1c86754617d9813a,2007-12-29,0,1,0,513,0,0,15,6,10,5,1,1,4,3,2,2,8,3,69.0,163.5
12368,afedd038b986cebc,45bc8f98d62bd096,68c6cd5287b473a7,2007-12-29,0,0,0,900,0,0,89,12,84,5,2,1,3,0,13,7,71,12,16.4,764.3
12369,afedd038b986cebc,68c6cd5287b473a7,45bc8f98d62bd096,2007-12-29,0,0,0,900,10,2,99,17,91,8,0,0,8,6,28,14,63,11,89.7,726.6
12370,71e3272f7ebcca26,621a6c59f88a44fe,6506c1d34da9c013,2007-12-29,0,0,0,594,3,0,13,3,8,5,0,0,5,3,2,2,6,0,12.1,202.0
12371,71e3272f7ebcca26,6506c1d34da9c013,621a6c59f88a44fe,2007-12-29,0,3,1,594,3,3,40,18,15,25,5,5,20,17,8,5,7,1,375.0,161.9
12372,6d691b736d8c98b0,60029bcf496bd707,7f0b4a75ef3039a3,2007-12-29,0,0,0,804,1,1,37,6,35,2,0,0,2,0,19,15,16,6,31.7,449.4
12373,6d691b736d8c98b0,7f0b4a75ef3039a3,60029bcf496bd707,2007-12-29,1,0,0,804,5,1,115,39,114,1,0,0,1,0,17,13,97,39,5.6,571.3
12374,478b0eaf22475be0,04c15b52c3cc1cab,cc6f9d1e89f3449a,2007-12-29,0,0,0,91,0,0,3,2,2,1,0,0,1,1,0,0,2,1,12.0,20.0
12375,478b0eaf22475be0,cc6f9d1e89f3449a,04c15b52c3cc1cab,2007-12-29,0,1,1,91,3,1,6,2,4,2,0,0,2,1,1,1,3,1,59.0,20.0
12376,2c9ddc75869894c5,a1f6999fe57236e0,a390eb8a9b2df298,2007-12-29,1,0,0,900,0,0,177,31,176,1,0,0,1,0,16,13,160,31,0.3,898.0
12377,2c9ddc75869894c5,a390eb8a9b2df298,a1f6999fe57236e0,2007-12-29,0,0,0,900,2,2,175,51,175,0,0,0,0,0,12,7,163,51,0.0,829.7
12378,2b2a50d442da2b84,24b033b3daf1c9df,a7f4d0902bb64092,2007-12-29,0,0,0,111,1,1,20,6,19,1,0,0,1,1,3,3,16,5,12.0,99.0
12379,2b2a50d442da2b84,a7f4d0902bb64092,24b033b3daf1c9df,2007-12-29,0,0,0,111,1,0,19,2,19,0,0,0,0,0,4,3,15,2,0.0,98.0
12380,2886e831af3994b7,d1152823307d7e7c,f7a7f7118d4b01b6,2007-12-29,0,2,0,560,4,2,24,4,22,2,0,0,2,1,4,2,18,3,11.0,214.8
12381,2886e831af3994b7,f7a7f7118d4b01b6,d1152823307d7e7c,2007-12-29,1,5,1,560,0,0,48,12,18,30,3,1,27,10,9,8,9,2,323.2,215.0
12382,17404e252bdab9e7,7d21de9c6d7c98b2,ccd1299e0345e0ce,2007-12-29,0,2,1,280,2,2,9,1,9,0,0,0,0,0,5,5,4,1,0.0,172.0
12383,17404e252bdab9e7,ccd1299e0345e0ce,7d21de9c6d7c98b2,2007-12-29,0,0,0,280,1,1,18,5,18,0,0,0,0,0,0,0,18,5,0.0,252.0
12384,fc1f199c8ba32a19,c4b6099f0d25f75e,cd7bafbeee1f29a0,2007-12-08,1,1,0,721,4,2,70,40,17,53,0,0,53,32,0,0,17,8,200.3,64.0
12385,fc1f199c8ba32a19,cd7bafbeee1f29a0,c4b6099f0d25f75e,2007-12-08,1,0,0,721,2,1,48,27,9,39,1,1,38,25,1,1,8,2,434.0,86.69999999999999
12386,f62c29310e1d6253,318e629d1eb7aa49,725a834930c2b5bf,2007-12-08,0,0,0,260,1,1,56,14,55,1,0,0,1,0,8,6,47,14,1.7,222.6
12387,f62c29310e1d6253,725a834930c2b5bf,318e629d1eb7aa49,2007-12-08,1,0,0,260,2,0,38,16,35,3,0,0,3,3,14,14,21,13,18.4,160.3
12388,e301a2c3a415cd33,2f1700b3a4a09bc7,fb1538b46877a695,2007-12-08,0,0,0,282,2,0,30,9,26,4,0,0,4,3,3,3,23,6,0.0,70.0
12389,e301a2c3a415cd33,fb1538b46877a695,2f1700b3a4a09bc7,2007-12-08,0,1,1,282,3,3,17,10,9,8,1,1,7,6,0,0,9,4,212.0,70.0
12390,d3e37d1c95a5f382,5f6038bcdb95e3e4,de62052b2ede65ba,2007-12-08,0,0,0,282,2,0,5,1,3,2,0,0,2,1,0,0,3,0,202.0,20.0
12391,d3e37d1c95a5f382,de62052b2ede65ba,5f6038bcdb95e3e4,2007-12-08,0,5,1,282,0,0,8,4,4,4,0,0,4,4,0,0,4,0,60.0,20.0
12392,d1ce7361cb4e442b,3c48019bc387b80c,896c322f56b8be5a,2007-12-08,0,0,0,96,2,0,3,0,3,0,0,0,0,0,0,0,3,0,0.0,5.0
12393,d1ce7361cb4e442b,896c322f56b8be5a,3c48019bc387b80c,2007-12-08,0,1,1,96,0,0,3,2,1,2,0,0,2,2,0,0,1,0,72.0,24.0
12394,7f47865cfb9b0d55,484acc7b0f856ce9,f12f979b657ab876,2007-12-08,0,4,0,900,0,0,25,10,16,9,3,3,6,6,5,5,11,4,224.4,282.9
12395,7f47865cfb9b0d55,f12f979b657ab876,484acc7b0f856ce9,2007-12-08,0,0,0,900,12,1,17,6,7,10,0,0,10,6,6,6,1,0,268.1,246.6
12396,759659ca9303c720,2961be02cfb0d2c1,ee4b670e159f4a33,2007-12-08,0,1,1,23,1,1,0,0,0,0,0,0,0,0,0,0,0,0,0.0,11.0
12397,759659ca9303c720,ee4b670e159f4a33,2961be02cfb0d2c1,2007-12-08,0,0,0,23,0,0,2,0,2,0,0,0,0,0,1,0,1,0,0.0,23.0
12398,6ed5847dd874d2d2,c47df9303d318c67,daf1b84aebd6602b,2007-12-08,1,1,0,651,11,6,85,32,57,28,11,9,17,8,7,6,50,24,353.0,248.0
12399,6ed5847dd874d2d2,daf1b84aebd6602b,c47df9303d318c67,2007-12-08,0,3,1,651,0,0,102,28,99,3,0,0,3,2,6,3,93,26,50.0,248.0
12400,0fd639e6e28c51bb,1411c630ba711b64,86f582852a5b240a,2007-12-08,0,0,0,121,0,0,7,0,7,0,0,0,0,0,5,4,2,0,0.0,50.7
12401,0fd639e6e28c51bb,86f582852a5b240a,1411c630ba711b64,2007-12-08,0,1,1,121,2,1,14,5,6,8,0,0,8,5,6,5,0,0,42.3,47.0
12402,ec041009ce404879,b2acebbef8da14ea,eff47295daf721a6,2007-11-17,1,1,1,499,1,1,44,4,38,6,2,2,4,2,29,21,9,2,85.1,343.0
12403,ec041009ce404879,eff47295daf721a6,b2acebbef8da14ea,2007-11-17,0,0,0,499,0,0,62,14,62,0,0,0,0,0,21,17,41,14,0.0,346.9
12404,bdd782059be98dfb,06f36cf4bd97ec77,dbaaf42313af90fa,2007-11-17,1,0,0,639,3,2,74,31,34,40,9,8,31,20,4,4,30,11,297.4,245.0
12405,bdd782059be98dfb,dbaaf42313af90fa,06f36cf4bd97ec77,2007-11-17,0,3,0,639,5,1,19,5,19,0,0,0,0,0,4,4,15,5,0.0,227.60000000000002
12406,9d59ae86a2e6c444,0541480fbf719d86,2924886ee9c4c527,2007-11-17,0,0,0,205,1,1,8,0,8,0,0,0,0,0,3,2,5,0,0.0,71.6
12407,9d59ae86a2e6c444,2924886ee9c4c527,0541480fbf719d86,2007-11-17,1,0,0,205,1,1,35,16,8,27,2,2,25,13,4,4,4,3,104.4,89.0
12408,71440bf87b9c58a1,02500fb9fd79a974,3bad7ef643840f67,2007-11-17,0,0,0,74,0,0,3,1,3,0,0,0,0,0,0,0,3,1,0.0,46.0
12409,71440bf87b9c58a1,3bad7ef643840f67,02500fb9fd79a974,2007-11-17,0,1,1,74,2,1,7,3,5,2,0,0,2,2,2,2,3,1,28.0,18.0
12410,63cfbf28e44febc2,04643fd03d9159cc,68d76fd9ecf7431d,2007-11-17,1,0,0,269,4,1,27,15,14,13,1,1,12,11,5,4,9,4,103.3,126.0
12411,63cfbf28e44febc2,68d76fd9ecf7431d,04643fd03d9159cc,2007-11-17,0,0,0,269,1,0,13,3,13,0,0,0,0,0,4,3,9,3,0.0,150.7
12412,177201b1a7fa0dd0,31ee470ef5dc8d7f,91acd6910b802a9e,2007-11-17,1,0,0,600,0,0,90,14,87,3,0,0,3,2,31,25,56,12,4.6,560.2
12413,177201b1a7fa0dd0,91acd6910b802a9e,31ee470ef5dc8d7f,2007-11-17,0,0,0,600,1,1,128,23,127,1,0,0,1,1,26,19,101,22,7.8,446.4
12414,0dddf7ec457caab3,f2688492b9a525a3,f34312c2ccfa0e00,2007-11-17,0,0,0,900,12,8,79,39,10,69,3,3,66,34,0,0,10,5,767.7,110.0
12415,0dddf7ec457caab3,f34312c2ccfa0e00,f2688492b9a525a3,2007-11-17,0,0,0,900,0,0,21,3,20,1,0,0,1,1,4,3,16,2,0.0,132.29999999999995
12416,0b217fc503bd0585,2b93ebd9f5417ad2,ee779c43a8926d52,2007-11-17,0,0,0,900,2,2,96,23,96,0,0,0,0,0,18,17,78,23,0.0,519.5
12417,0b217fc503bd0585,ee779c43a8926d52,2b93ebd9f5417ad2,2007-11-17,0,0,0,900,16,6,87,22,75,12,0,0,12,4,1,1,74,18,346.5,438.0
12418,04995619538ae939,349aaa3da11eb587,55a7b2d4e54ffac9,2007-11-17,0,0,0,900,9,7,110,45,63,47,0,0,47,25,5,4,58,20,372.6,447.5
12419,04995619538ae939,55a7b2d4e54ffac9,349aaa3da11eb587,2007-11-17,0,0,0,900,0,0,87,15,85,2,0,0,2,0,26,20,59,15,8.5,417.4
12420,f4e5f49ca3831e64,c6a33ff198aaaeeb,f59f1d3a2ff13edd,2007-10-20,1,0,0,467,0,0,54,26,18,36,3,2,33,22,2,2,16,4,202.0,208.3
12421,f4e5f49ca3831e64,f59f1d3a2ff13edd,c6a33ff198aaaeeb,2007-10-20,0,1,0,467,5,1,17,3,15,2,0,0,2,2,11,10,4,1,28.7,136.0
12422,c7f6da6cd8e940b2,2be6596a9db33bf5,acff437707625fc7,2007-10-20,0,0,0,900,9,0,49,0,49,0,0,0,0,0,27,25,22,0,0.0,379.1
12423,c7f6da6cd8e940b2,acff437707625fc7,2be6596a9db33bf5,2007-10-20,0,1,0,900,1,1,82,33,47,35,2,1,33,18,8,7,39,15,387.9,368.0
12424,a9e13a29a332c886,6da99156486ed6c2,e86bc32f5997a8f7,2007-10-20,1,2,0,900,13,3,87,34,81,6,1,1,5,5,15,9,66,29,50.0,723.8
12425,a9e13a29a332c886,e86bc32f5997a8f7,6da99156486ed6c2,2007-10-20,0,0,0,900,0,0,138,30,134,4,0,0,4,1,47,35,87,29,26.2,634.0
12426,91f7986d6fee7d57,b2f743746e8dcfa2,bfc2fc38a0e20211,2007-10-20,0,7,0,900,1,0,20,7,15,5,0,0,5,5,3,3,12,2,20.0,167.0
12427,91f7986d6fee7d57,bfc2fc38a0e20211,b2f743746e8dcfa2,2007-10-20,1,0,0,900,3,3,73,38,21,52,1,1,51,30,6,5,15,8,697.0,116.0
12428,5498622706d8dc17,427b5953ac8e3a27,aae99701b21554e4,2007-10-20,0,1,1,160,2,2,3,1,1,2,1,1,1,1,1,1,0,0,146.0,14.0
12429,5498622706d8dc17,aae99701b21554e4,427b5953ac8e3a27,2007-10-20,0,0,0,160,0,0,3,2,1,2,0,0,2,2,0,0,1,0,0.0,14.0
12430,431282ab4ee417f6,4130a743d9d22163,c8136ab8aa32c974,2007-10-20,1,0,0,399,0,0,100,37,100,0,0,0,0,0,23,20,77,37,0.0,348.0
12431,431282ab4ee417f6,c8136ab8aa32c974,4130a743d9d22163,2007-10-20,0,0,0,399,3,1,89,34,89,0,0,0,0,0,10,6,79,34,0.0,371.0
12432,3fe3208df1098fdc,1f454354805b6f75,d897897060f10a3a,2007-10-20,3,0,0,367,1,0,47,24,45,2,0,0,2,0,16,15,29,24,3.4,315.0
12433,3fe3208df1098fdc,d897897060f10a3a,1f454354805b6f75,2007-10-20,0,0,0,367,2,1,56,8,56,0,0,0,0,0,15,14,41,8,0.0,272.6
12434,2e43a2f6e9336e2b,2a542ee8a8b83559,fa315e6c77eee106,2007-10-20,0,0,0,900,0,0,121,31,121,0,0,0,0,0,45,37,76,31,0.0,423.2
12435,2e43a2f6e9336e2b,fa315e6c77eee106,2a542ee8a8b83559,2007-10-20,0,0,0,900,1,1,72,16,68,4,2,2,2,2,41,40,27,14,16.8,715.0
12436,2571e91b263df9fb,04d5718ed2661e8c,cbe79765d44bd172,2007-10-20,0,0,0,900,0,0,12,3,3,9,0,0,9,3,1,0,2,0,370.0,74.0
12437,2571e91b263df9fb,cbe79765d44bd172,04d5718ed2661e8c,2007-10-20,0,1,0,900,4,2,78,42,15,63,0,0,63,37,3,2,12,5,456.0,45.0
12438,a1b912fe361f75bc,18968f97ad34f15c,4f4dac51adc1af4f,2007-09-22,0,0,0,900,2,2,90,39,26,64,6,4,58,35,7,7,19,4,591.0,178.0
12439,a1b912fe361f75bc,4f4dac51adc1af4f,18968f97ad34f15c,2007-09-22,0,2,0,900,0,0,29,8,21,8,0,0,8,5,5,3,16,3,131.0,178.0
12440,90fb826944c46000,b034747dc1d15491,f7a7f7118d4b01b6,2007-09-22,0,0,0,900,10,2,31,6,30,1,0,0,1,0,10,9,20,6,5.9,531.3
12441,90fb826944c46000,f7a7f7118d4b01b6,b034747dc1d15491,2007-09-22,0,1,0,900,3,2,89,36,57,32,8,6,24,15,28,28,29,21,261.7,346.1
12442,73726e32d26c17ee,9f842be1a5337be6,eb29176b03dfa888,2007-09-22,0,1,0,900,2,1,64,32,52,12,0,0,12,5,1,1,51,27,31.0,251.10000000000002
12443,73726e32d26c17ee,eb29176b03dfa888,9f842be1a5337be6,2007-09-22,0,0,0,900,5,4,108,53,39,69,6,4,63,39,4,2,35,14,537.9,183.0
12444,6773055965441b18,140745cbbcb023ac,fcffee71cff5530e,2007-09-22,0,0,0,885,12,5,75,21,53,22,0,0,22,10,6,6,47,11,256.1,288.0
12445,6773055965441b18,fcffee71cff5530e,140745cbbcb023ac,2007-09-22,0,3,1,885,2,2,130,44,61,69,8,7,61,34,18,15,43,10,306.0,291.9
12446,669e3927b38a36fb,20205040232ed0f3,8a59d346dc976a10,2007-09-22,0,1,0,900,6,2,66,15,46,20,4,2,16,7,12,12,34,8,256.8,425.0
12447,669e3927b38a36fb,8a59d346dc976a10,20205040232ed0f3,2007-09-22,0,4,0,900,9,4,21,1,21,0,0,0,0,0,6,5,15,1,0.0,407.2
12448,51696044aafb2037,ac70a4f1db1b8c40,f1b2a4365799c48b,2007-09-22,0,0,0,199,0,0,28,8,28,0,0,0,0,0,12,9,16,8,0.0,125.0
12449,51696044aafb2037,f1b2a4365799c48b,ac70a4f1db1b8c40,2007-09-22,0,2,1,199,1,1,11,0,11,0,0,0,0,0,8,6,3,0,0.0,151.0
12450,4a7d39ebc9dce5db,365fee2da473b177,7d21de9c6d7c98b2,2007-09-22,1,3,0,485,2,1,50,15,35,15,1,1,14,10,8,6,27,5,97.5,234.0
12451,4a7d39ebc9dce5db,7d21de9c6d7c98b2,365fee2da473b177,2007-09-22,0,2,1,485,2,1,24,9,18,6,0,0,6,6,6,3,12,3,108.0,225.5
12452,344e6898a381648f,6f018c039b4d5d80,82e7929bf6c2b689,2007-09-22,0,0,0,900,3,3,40,18,25,15,1,1,14,12,6,6,19,6,414.3,293.0
12453,344e6898a381648f,82e7929bf6c2b689,6f018c039b4d5d80,2007-09-22,0,5,0,900,9,2,18,3,17,1,0,0,1,1,8,8,9,2,27.0,269.7
12454,068e118edac9e057,a390eb8a9b2df298,b9d0fd83bb8a147a,2007-09-22,0,0,0,900,0,0,138,25,138,0,0,0,0,0,10,6,128,25,0.0,900.0
12455,068e118edac9e057,b9d0fd83bb8a147a,a390eb8a9b2df298,2007-09-22,1,0,0,900,0,0,176,38,176,0,0,0,0,0,51,45,125,38,0.0,894.0
12456,e7d444e279914116,6a92caba39b64752,d43a048a880efdff,2007-09-19,0,0,0,836,6,4,104,32,95,9,2,2,7,3,14,11,81,29,107.7,412.9
12457,e7d444e279914116,d43a048a880efdff,6a92caba39b64752,2007-09-19,1,1,0,836,1,0,101,24,99,2,0,0,2,2,33,29,66,22,4.1,641.3
12458,c86702c01c4cfee2,7d96bc577e5178b2,c6d8ae3b016d5ad5,2007-09-19,1,0,0,9,0,0,4,3,1,3,0,0,3,2,0,0,1,1,2.0,7.0
12459,c86702c01c4cfee2,c6d8ae3b016d5ad5,7d96bc577e5178b2,2007-09-19,0,0,0,9,0,0,0,0,0,0,0,0,0,0,0,0,0,0,0.0,7.0
12460,c536a1119406c0f0,31ee470ef5dc8d7f,9d4522df6fc49a47,2007-09-19,1,0,0,544,0,0,97,28,85,12,0,0,12,6,25,20,60,22,22.3,462.9
12461,c536a1119406c0f0,9d4522df6fc49a47,31ee470ef5dc8d7f,2007-09-19,0,0,0,544,6,2,39,7,37,2,0,0,2,2,9,8,28,5,27.1,426.7
12462,be307e6647a655c8,282fa667ff9c51ed,917e53fa0adea0d3,2007-09-19,0,10,0,900,2,1,48,20,17,31,0,0,31,17,1,1,16,3,678.0,77.0
12463,be307e6647a655c8,917e53fa0adea0d3,282fa667ff9c51ed,2007-09-19,0,0,0,900,1,0,32,11,17,15,3,3,12,8,2,2,15,3,145.0,77.0
12464,b46679306287ea79,0359313549d230a1,52cae54377b433b7,2007-09-19,1,0,0,644,4,2,114,42,112,2,1,1,1,1,13,10,99,41,18.9,489.4
12465,b46679306287ea79,52cae54377b433b7,0359313549d230a1,2007-09-19,1,0,0,644,1,0,129,29,126,3,0,0,3,3,42,35,84,26,3.6,602.1
12466,a1950f4bd19ed06f,8355922d564b152c,d0d7160824278840,2007-09-19,1,3,1,250,3,1,11,6,11,0,0,0,0,0,4,4,7,6,0.0,130.6
12467,a1950f4bd19ed06f,d0d7160824278840,8355922d564b152c,2007-09-19,0,0,0,250,2,1,14,2,12,2,1,1,1,1,5,4,7,1,26.4,131.0
12468,997eda9196aad7f9,93ce4ac89e3d7652,afdb76fbd86f6d11,2007-09-19,1,0,0,105,0,0,19,4,18,1,0,0,1,1,5,2,13,3,2.0,103.0
12469,997eda9196aad7f9,afdb76fbd86f6d11,93ce4ac89e3d7652,2007-09-19,0,0,0,105,0,0,16,1,16,0,0,0,0,0,6,4,10,1,0.0,103.0
12470,88295b0ab9868db5,a149d6bc670cdb60,fb1538b46877a695,2007-09-19,0,2,1,74,0,0,5,3,5,0,0,0,0,0,0,0,5,3,0.0,74.0
12471,88295b0ab9868db5,fb1538b46877a695,a149d6bc670cdb60,2007-09-19,0,0,0,74,1,1,0,0,0,0,0,0,0,0,0,0,0,0,0.0,26.0
12472,62dd8808ce397fa6,40a604761ca7d64d,cb139171ed1b69fe,2007-09-19,0,0,0,271,1,0,15,3,11,4,0,0,4,2,1,0,10,1,12.0,148.0
12473,62dd8808ce397fa6,cb139171ed1b69fe,40a604761ca7d64d,2007-09-19,0,1,1,271,2,2,57,21,17,40,3,3,37,19,4,3,13,2,102.0,157.0
12474,b953a9b5357cbf99,9b74de674c355425,b7d524c77c27389b,2007-09-08,1,0,0,254,0,0,30,12,19,11,0,0,11,7,5,4,14,5,48.4,49.099999999999994
12475,b953a9b5357cbf99,b7d524c77c27389b,9b74de674c355425,2007-09-08,0,1,1,254,3,1,40,22,17,23,0,0,23,16,3,2,14,6,138.9,54.6
12476,a3dfa0ac05433450,2924886ee9c4c527,679a9054e2815943,2007-09-08,1,1,0,563,4,0,105,31,105,0,0,0,0,0,28,17,77,31,0.0,532.2
12477,a3dfa0ac05433450,679a9054e2815943,2924886ee9c4c527,2007-09-08,0,0,0,563,2,1,127,29,124,3,0,0,3,2,17,14,107,27,5.8,499.0
12478,9971f8bcd3b10069,33011768c3c4dc9a,75e5fec9f72910ef,2007-09-08,0,0,0,900,1,0,34,8,34,0,0,0,0,0,11,10,23,8,0.0,199.0
12479,9971f8bcd3b10069,75e5fec9f72910ef,33011768c3c4dc9a,2007-09-08,0,0,0,900,10,7,23,12,6,17,2,2,15,12,0,0,6,0,701.0,199.0
12480,8f5e57a21383fa87,918d9d89d4d52acc,a8aba6fd8a463043,2007-09-08,0,0,0,250,0,0,26,7,26,0,0,0,0,0,6,6,20,7,0.0,190.6
12481,8f5e57a21383fa87,a8aba6fd8a463043,918d9d89d4d52acc,2007-09-08,2,0,0,250,1,0,67,31,61,6,0,0,6,3,7,7,54,28,13.4,192.0
12482,79db1d9b15e16b1d,0541480fbf719d86,7f955f71fa2ce7ac,2007-09-08,1,0,0,61,0,0,36,17,14,22,0,0,22,13,2,1,12,4,11.4,47.0
12483,79db1d9b15e16b1d,7f955f71fa2ce7ac,0541480fbf719d86,2007-09-08,0,0,0,61,2,1,5,1,5,0,0,0,0,0,0,0,5,1,0.0,40.6
12484,76d490a8bb168c78,1eacf73d6a0055dc,c32fb8c0f6471a4d,2007-09-08,0,0,0,900,4,1,103,11,95,8,3,2,5,4,62,50,33,7,75.0,449.2
12485,76d490a8bb168c78,c32fb8c0f6471a4d,1eacf73d6a0055dc,2007-09-08,0,0,0,900,1,1,33,8,28,5,0,0,5,3,13,7,15,5,56.8,700.0
12486,59d456f0da1159cf,2b93ebd9f5417ad2,98b80a717b9bda17,2007-09-08,0,0,0,900,0,0,162,35,162,0,0,0,0,0,12,12,150,35,0.0,713.0
12487,59d456f0da1159cf,98b80a717b9bda17,2b93ebd9f5417ad2,2007-09-08,0,0,0,900,12,6,124,55,121,3,0,0,3,3,2,1,119,52,186.0,652.0
12488,574b4599ae9cb64e,5f87a5c00b3d17ed,bc8f6b42767e28df,2007-09-08,1,0,0,424,2,0,66,25,36,30,0,0,30,16,7,3,29,9,176.2,195.0
12489,574b4599ae9cb64e,bc8f6b42767e28df,5f87a5c00b3d17ed,2007-09-08,0,2,0,424,0,0,30,4,30,0,0,0,0,0,7,5,23,4,0.0,242.8
12490,49458279eafdaf94,1ccf4e7caff270df,ffc088e64fab57e9,2007-09-08,0,3,0,1500,8,3,95,22,78,17,8,8,9,5,33,30,45,17,150.3,639.0
12491,49458279eafdaf94,ffc088e64fab57e9,1ccf4e7caff270df,2007-09-08,1,0,0,1500,3,2,108,34,74,34,10,9,24,16,31,31,43,18,313.0,769.7
12492,fa2271eecde701ed,04643fd03d9159cc,c47df9303d318c67,2007-08-25,0,0,0,900,3,0,135,39,135,0,0,0,0,0,1,1,134,39,0.0,735.2
12493,fa2271eecde701ed,c47df9303d318c67,04643fd03d9159cc,2007-08-25,2,0,0,900,1,0,181,27,169,12,2,2,10,5,24,15,145,22,164.8,694.0
12494,f00b588a0d9a90e4,79899ecf62020f6d,aa1952ec0b3dd8e1,2007-08-25,0,3,0,900,3,3,84,40,43,41,0,0,41,26,5,2,38,14,220.2,349.1
12495,f00b588a0d9a90e4,aa1952ec0b3dd8e1,79899ecf62020f6d,2007-08-25,0,1,0,900,5,3,91,25,77,14,1,1,13,9,4,1,73,16,303.9,310.8
12496,e7ff18a0cfa09702,1ff9589f9065a9ed,69b69c0178c4004d,2007-08-25,0,1,1,77,1,1,5,2,3,2,0,0,2,2,2,2,1,0,63.0,14.0
12497,e7ff18a0cfa09702,69b69c0178c4004d,1ff9589f9065a9ed,2007-08-25,0,0,0,77,0,0,3,0,3,0,0,0,0,0,1,1,2,0,0.0,12.0
12498,cc17e4d182235a95,234f3767ff0e5701,9fa3bd637edd9aa2,2007-08-25,0,0,0,285,1,0,27,3,27,0,0,0,0,0,12,9,15,3,0.0,146.4
12499,cc17e4d182235a95,9fa3bd637edd9aa2,234f3767ff0e5701,2007-08-25,1,1,0,285,2,0,31,15,17,14,0,0,14,11,6,5,11,4,132.6,124.0
12500,6ce5d8041189d652,25433871e4eee0f4,daf1b84aebd6602b,2007-08-25,0,3,0,710,7,0,6,0,6,0,0,0,0,0,5,4,1,0,0.0,93.0
12501,6ce5d8041189d652,daf1b84aebd6602b,25433871e4eee0f4,2007-08-25,1,0,0,710,0,0,64,20,12,52,7,4,45,19,2,2,10,1,392.0,318.0
12502,6b38906e77607c77,4f95f74620a6b7a4,d468288756ae3982,2007-08-25,0,0,0,510,0,0,11,6,4,7,0,0,7,5,0,0,4,1,144.0,66.39999999999998
12503,6b38906e77607c77,d468288756ae3982,4f95f74620a6b7a4,2007-08-25,0,3,1,510,2,1,95,45,8,87,14,14,73,43,1,1,7,2,299.6,63.0
12504,675cbe90f6d96feb,6506c1d34da9c013,dd37fd509af89f15,2007-08-25,0,5,0,900,2,2,61,17,39,22,4,4,18,10,20,17,19,7,558.0,255.0
12505,675cbe90f6d96feb,dd37fd509af89f15,6506c1d34da9c013,2007-08-25,0,0,0,900,4,1,41,4,38,3,0,0,3,2,1,0,37,2,87.0,255.0
12506,4a9b3b97fa2bbca9,aae99701b21554e4,cfb65863d5099327,2007-08-25,0,1,0,227,0,0,26,8,21,5,0,0,5,3,6,3,15,5,25.0,114.0
12507,4a9b3b97fa2bbca9,cfb65863d5099327,aae99701b21554e4,2007-08-25,0,2,1,227,4,3,18,1,17,1,1,1,0,0,9,8,8,1,73.0,129.0
12508,2f22e38844aa7d96,0aa92558424ced9e,270b89c00ef0c55c,2007-08-25,1,0,0,697,10,3,87,50,67,20,0,0,20,15,14,13,53,35,148.2,156.0
12509,2f22e38844aa7d96,270b89c00ef0c55c,0aa92558424ced9e,2007-08-25,0,1,0,697,1,0,38,6,38,0,0,0,0,0,5,5,33,6,0.0,545.8
12510,eff9207427f0e02c,1f454354805b6f75,a8e6a69796280f17,2007-07-07,1,0,0,290,1,1,15,9,5,10,1,1,9,5,0,0,5,4,43.0,103.0
12511,eff9207427f0e02c,a8e6a69796280f17,1f454354805b6f75,2007-07-07,0,0,0,290,2,1,11,1,6,5,0,0,5,1,2,2,4,0,144.0,103.0
12512,a8bab8884249f634,04d5718ed2661e8c,4f4dac51adc1af4f,2007-07-07,0,0,0,900,0,0,230,57,196,34,1,1,33,15,15,9,181,42,180.9,585.4
12513,a8bab8884249f634,4f4dac51adc1af4f,04d5718ed2661e8c,2007-07-07,0,0,0,900,2,0,166,42,162,4,0,0,4,2,11,7,151,40,0.6,716.1
12514,6a9e343bd12dfa64,029880cdbf5ca089,e0ec3c3b6b611f7e,2007-07-07,0,2,0,1500,19,16,55,24,14,41,9,9,32,23,2,2,12,1,1310.0,137.5
12515,6a9e343bd12dfa64,e0ec3c3b6b611f7e,029880cdbf5ca089,2007-07-07,1,3,0,1500,0,0,23,5,20,3,0,0,3,1,1,1,19,4,20.5,149.0
12516,4dd2cd7da33e35d7,7450525c7ba032a0,ee9d73f4fee9cbdd,2007-07-07,1,0,0,900,0,0,127,19,115,12,0,0,12,5,18,12,97,14,45.3,724.3
12517,4dd2cd7da33e35d7,ee9d73f4fee9cbdd,7450525c7ba032a0,2007-07-07,0,2,0,900,5,4,120,44,116,4,0,0,4,2,11,11,105,42,73.7,633.7
12518,3aa19b85fbf4114c,91720876db0ee468,91acd6910b802a9e,2007-07-07,0,0,0,135,0,0,7,0,5,2,0,0,2,0,3,3,2,0,3.3,13.0
12519,3aa19b85fbf4114c,91acd6910b802a9e,91720876db0ee468,2007-07-07,0,5,1,135,1,1,8,2,4,4,1,1,3,1,2,2,2,1,117.0,14.7
12520,340a08b1f3d1dd36,330ec26453c44a59,c6a33ff198aaaeeb,2007-07-07,0,0,0,134,2,1,9,1,8,1,0,0,1,0,1,1,7,1,42.0,92.0
12521,340a08b1f3d1dd36,c6a33ff198aaaeeb,330ec26453c44a59,2007-07-07,0,2,1,134,0,0,5,1,5,0,0,0,0,0,1,1,4,1,0.0,27.0
12522,2748001ead121b8a,cf9d24e4bd0cf2ce,f2688492b9a525a3,2007-07-07,0,0,0,295,5,0,38,6,38,0,0,0,0,0,3,0,35,6,0.0,200.2
12523,2748001ead121b8a,f2688492b9a525a3,cf9d24e4bd0cf2ce,2007-07-07,1,0,0,295,0,0,54,28,39,15,3,3,12,9,1,0,38,19,94.8,156.0
12524,19da32f5af2e8e2b,cb139171ed1b69fe,cbe79765d44bd172,2007-07-07,1,0,0,270,5,3,32,16,7,25,1,1,24,16,3,3,4,0,131.5,117.3
12525,19da32f5af2e8e2b,cbe79765d44bd172,cb139171ed1b69fe,2007-07-07,0,0,0,270,1,1,16,4,15,1,0,0,1,0,2,2,13,4,10.7,63.5
12526,0ec579db0efcf0c6,2f732dd9210d301f,ee779c43a8926d52,2007-07-07,0,1,0,900,11,3,57,10,57,0,0,0,0,0,17,14,40,10,0.0,547.0
12527,0ec579db0efcf0c6,ee779c43a8926d52,2f732dd9210d301f,2007-07-07,0,0,0,900,9,2,64,13,64,0,0,0,0,0,7,6,57,13,0.0,747.0
12528,fda850240fb80339,917e53fa0adea0d3,aebfb84d1f6d2d8c,2007-06-23,0,1,1,262,0,0,6,3,2,4,0,0,4,2,1,1,1,1,77.0,25.0
12529,fda850240fb80339,aebfb84d1f6d2d8c,917e53fa0adea0d3,2007-06-23,0,1,0,262,2,2,5,4,1,4,0,0,4,4,0,0,1,0,160.0,25.0
12530,62454fb3a4fd5737,15edcf67ccf5be84,eb29176b03dfa888,2007-06-23,0,0,0,129,0,0,4,1,4,0,0,0,0,0,1,0,3,1,0.0,25.0
12531,62454fb3a4fd5737,eb29176b03dfa888,15edcf67ccf5be84,2007-06-23,1,0,0,129,2,1,33,19,5,28,1,1,27,19,1,1,4,0,104.0,25.0
12532,5ab0e805e90d20d5,2b06b6ad5db63348,3bad7ef643840f67,2007-06-23,0,0,0,429,0,0,23,5,19,4,0,0,4,1,2,1,17,4,82.0,72.0
12533,5ab0e805e90d20d5,3bad7ef643840f67,2b06b6ad5db63348,2007-06-23,0,6,1,429,4,3,11,3,7,4,1,1,3,3,0,0,7,0,275.0,72.0
12534,53343bd123bcf651,7d96bc577e5178b2,dc0f07928009a127,2007-06-23,0,1,0,339,2,2,36,13,17,19,5,5,14,8,2,2,15,5,179.8,74.0
12535,53343bd123bcf651,dc0f07928009a127,7d96bc577e5178b2,2007-06-23,0,1,0,339,1,1,11,3,11,0,0,0,0,0,0,0,11,3,0.0,149.2
12536,518fec4812ed1587,d3de4a24f7eefac8,daf1b84aebd6602b,2007-06-23,0,0,0,510,5,4,51,12,46,5,0,0,5,2,10,8,36,10,50.6,202.2
12537,518fec4812ed1587,daf1b84aebd6602b,d3de4a24f7eefac8,2007-06-23,1,0,0,510,6,0,78,21,55,23,2,1,21,12,14,12,41,9,135.8,276.4
12538,41c979b223b3fb56,282fa667ff9c51ed,476414d2f18cd059,2007-06-23,1,0,0,70,0,0,32,11,20,12,0,0,12,8,3,1,17,3,11.2,55.0
12539,41c979b223b3fb56,476414d2f18cd059,282fa667ff9c51ed,2007-06-23,0,0,0,70,1,0,11,3,11,0,0,0,0,0,3,1,8,3,0.0,58.8
12540,3542c5c5c5180090,8355922d564b152c,cc6f9d1e89f3449a,2007-06-23,0,1,1,320,1,0,5,2,5,0,0,0,0,0,1,0,4,2,0.0,89.4
12541,3542c5c5c5180090,cc6f9d1e89f3449a,8355922d564b152c,2007-06-23,0,1,0,320,4,1,34,12,9,25,0,0,25,10,4,4,5,2,205.6,65.0
12542,30d7a9a1d99b327c,44260175069b6276,73c7cfa551289285,2007-06-23,0,0,0,492,0,0,18,5,13,5,0,0,5,2,1,1,12,3,83.6,113.80000000000001
12543,30d7a9a1d99b327c,73c7cfa551289285,44260175069b6276,2007-06-23,0,3,1,492,3,3,31,21,16,15,0,0,15,13,2,2,14,8,261.2,112.4
12544,1c36ff6c6284a523,5330fe7e4c3af81c,cfb65863d5099327,2007-06-23,0,0,0,230,0,0,7,1,7,0,0,0,0,0,2,2,5,1,0.0,43.0
12545,1c36ff6c6284a523,cfb65863d5099327,5330fe7e4c3af81c,2007-06-23,0,1,1,230,3,2,10,2,4,6,2,2,4,2,3,2,1,0,149.0,81.0
12546,f1c1890491959bcf,ad3041e61896b975,b7d524c77c27389b,2007-06-16,0,0,0,75,0,0,13,0,13,0,0,0,0,0,8,6,5,0,0.0,72.6
12547,f1c1890491959bcf,b7d524c77c27389b,ad3041e61896b975,2007-06-16,1,0,0,75,0,0,14,9,10,4,0,0,4,4,0,0,10,5,2.4,72.0
12548,e8005a8c3c029a73,2be6596a9db33bf5,546015aa2ad945fd,2007-06-16,1,0,0,498,7,2,49,19,15,34,2,2,32,18,10,9,5,1,292.9,111.3
12549,e8005a8c3c029a73,546015aa2ad945fd,2be6596a9db33bf5,2007-06-16,0,1,0,498,2,1,25,10,21,4,0,0,4,2,7,7,14,8,7.7,157.10000000000002
12550,dbc30717a3efba58,acff437707625fc7,d897897060f10a3a,2007-06-16,0,3,0,900,2,1,59,9,55,4,0,0,4,3,13,8,42,6,58.5,750.6
12551,dbc30717a3efba58,d897897060f10a3a,acff437707625fc7,2007-06-16,0,0,0,900,3,1,102,13,100,2,0,0,2,1,29,23,71,12,32.4,663.5
12552,d4fa680b2a912534,1a1a4d7a29041d77,7f0b4a75ef3039a3,2007-06-16,0,2,0,332,1,1,50,26,18,32,0,0,32,20,11,10,7,6,86.4,100.9
12553,d4fa680b2a912534,7f0b4a75ef3039a3,1a1a4d7a29041d77,2007-06-16,1,0,0,332,2,1,67,38,24,43,0,0,43,25,6,3,18,13,96.1,102.6
12554,805bc227bd40b0cc,06f36cf4bd97ec77,3410cf010558dc8b,2007-06-16,0,2,1,445,5,3,43,24,14,29,0,0,29,19,1,0,13,5,277.7,50.0
12555,805bc227bd40b0cc,3410cf010558dc8b,06f36cf4bd97ec77,2007-06-16,0,2,0,445,0,0,6,3,3,3,0,0,3,3,0,0,3,0,12.0,151.3
12556,6603ed5f10bd8047,d1759b2b7be9be56,fcffee71cff5530e,2007-06-16,0,0,0,900,3,2,74,19,71,3,0,0,3,1,3,1,68,18,12.0,864.0
12557,6603ed5f10bd8047,fcffee71cff5530e,d1759b2b7be9be56,2007-06-16,0,0,0,900,1,0,246,53,246,0,0,0,0,0,92,60,154,53,0.0,879.0
12558,62048467be051636,710d93f1508f7104,a149d6bc670cdb60,2007-06-16,0,0,0,170,0,0,28,5,28,0,0,0,0,0,3,2,25,5,0.0,134.0
12559,62048467be051636,a149d6bc670cdb60,710d93f1508f7104,2007-06-16,0,1,1,170,0,0,34,16,27,7,0,0,7,6,4,4,23,10,17.0,153.0
12560,071d716229f5ae7f,20205040232ed0f3,c47df9303d318c67,2007-06-16,0,2,0,900,2,2,87,31,68,19,4,4,15,13,15,15,53,18,71.4,389.3
12561,071d716229f5ae7f,c47df9303d318c67,20205040232ed0f3,2007-06-16,0,2,0,900,14,4,65,22,36,29,10,9,19,11,5,5,31,11,401.7,357.6
12562,ff8802aae3b81c3f,75e5fec9f72910ef,c9bbf1a0285a8076,2007-06-12,0,1,1,112,0,0,5,3,5,0,0,0,0,0,0,0,5,3,0.0,56.0
12563,ff8802aae3b81c3f,c9bbf1a0285a8076,75e5fec9f72910ef,2007-06-12,0,0,0,112,1,1,4,0,4,0,0,0,0,0,0,0,4,0,0.0,100.0
12564,ee071b5125ced92a,04c15b52c3cc1cab,68d76fd9ecf7431d,2007-06-12,0,0,0,900,0,0,185,60,185,0,0,0,0,0,13,10,172,60,0.0,900.0
12565,ee071b5125ced92a,68d76fd9ecf7431d,04c15b52c3cc1cab,2007-06-12,1,0,0,900,1,0,128,19,128,0,0,0,0,0,14,9,114,19,0.0,899.0
12566,a6edcccdfccb9132,8a59d346dc976a10,b2f743746e8dcfa2,2007-06-12,0,2,1,469,4,2,18,10,3,15,0,0,15,9,1,1,2,1,305.0,76.0
12567,a6edcccdfccb9132,b2f743746e8dcfa2,8a59d346dc976a10,2007-06-12,0,2,0,469,0,0,4,0,3,1,0,0,1,0,2,0,1,0,88.0,76.0
12568,764e5910ac779ae9,365fee2da473b177,d8022d5526b1d937,2007-06-12,1,0,0,13,0,0,7,3,7,0,0,0,0,0,0,0,7,3,0.0,12.0
12569,764e5910ac779ae9,d8022d5526b1d937,365fee2da473b177,2007-06-12,0,0,0,13,0,0,9,1,9,0,0,0,0,0,1,1,8,1,0.0,13.0
12570,59da727c3ae7b497,1c86754617d9813a,6f018c039b4d5d80,2007-06-12,0,1,0,367,4,2,10,1,8,2,0,0,2,1,5,3,3,0,72.3,99.5
12571,59da727c3ae7b497,6f018c039b4d5d80,1c86754617d9813a,2007-06-12,0,1,1,367,1,0,34,14,19,15,1,1,14,8,3,3,16,6,50.5,220.7
12572,3b52291052353eef,1fd4fbdcc67de844,45bc8f98d62bd096,2007-06-12,1,0,0,33,0,0,10,6,8,2,0,0,2,2,0,0,8,4,3.0,30.0
12573,3b52291052353eef,45bc8f98d62bd096,1fd4fbdcc67de844,2007-06-12,0,0,0,33,0,0,2,0,2,0,0,0,0,0,1,1,1,0,0.0,30.0
12574,1e12c4828d576b5c,9583662df31d943f,e86bc32f5997a8f7,2007-06-12,0,0,0,900,1,0,121,14,121,0,0,0,0,0,34,31,87,14,0.0,899.0
12575,1e12c4828d576b5c,e86bc32f5997a8f7,9583662df31d943f,2007-06-12,0,0,0,900,0,0,272,21,272,0,0,0,0,0,40,19,232,21,0.0,900.0
12576,1d127ec120dcb58e,c3ea8deeba00462b,eff47295daf721a6,2007-06-12,0,0,0,424,0,0,34,16,6,28,1,1,27,13,2,2,4,3,270.0,104.5
12577,1d127ec120dcb58e,eff47295daf721a6,c3ea8deeba00462b,2007-06-12,0,2,1,424,5,2,14,5,10,4,1,1,3,3,5,2,5,2,49.5,55.0
12578,07018cb7ae879456,501b07aec9b8fc2d,f34312c2ccfa0e00,2007-06-12,0,0,0,900,0,0,286,40,286,0,0,0,0,0,58,36,228,40,0.0,890.0
12579,07018cb7ae879456,f34312c2ccfa0e00,501b07aec9b8fc2d,2007-06-12,0,0,0,900,2,0,239,57,239,0,0,0,0,0,41,31,198,57,0.0,891.0
12580,dab2d3e9f2052047,aa03a3ca00ac6827,af5b208e97f5d382,2007-05-26,0,0,0,186,4,0,7,0,7,0,0,0,0,0,2,1,5,0,0.0,174.3
12581,dab2d3e9f2052047,af5b208e97f5d382,aa03a3ca00ac6827,2007-05-26,1,1,1,186,0,0,31,11,28,3,0,0,3,3,7,7,21,8,11.7,147.0
12582,cc444b10ea87c381,2924886ee9c4c527,a7f4d0902bb64092,2007-05-26,1,0,0,66,2,1,1,0,1,0,0,0,0,0,1,1,0,0,0.0,13.0
12583,cc444b10ea87c381,a7f4d0902bb64092,2924886ee9c4c527,2007-05-26,0,1,0,66,0,0,4,2,2,2,0,0,2,2,1,1,1,0,17.0,49.0
12584,b6462127cf553ff3,4130a743d9d22163,7c0847d3854a95f2,2007-05-26,0,1,1,53,0,0,2,0,2,0,0,0,0,0,0,0,2,0,0.0,48.0
12585,b6462127cf553ff3,7c0847d3854a95f2,4130a743d9d22163,2007-05-26,0,0,0,53,1,0,1,0,0,1,1,1,0,0,0,0,0,0,5.0,48.0
12586,a6cb909888f6a495,18968f97ad34f15c,40a604761ca7d64d,2007-05-26,0,0,0,464,0,0,35,5,27,8,1,0,7,2,4,2,23,3,66.0,156.0
12587,a6cb909888f6a495,40a604761ca7d64d,18968f97ad34f15c,2007-05-26,0,2,1,464,2,1,37,5,35,2,0,0,2,2,7,5,28,3,242.0,156.0
12588,88b225f6f1fa5c59,a390eb8a9b2df298,ffc088e64fab57e9,2007-05-26,0,0,0,113,0,0,11,2,11,0,0,0,0,0,2,2,9,2,0.0,109.0
12589,88b225f6f1fa5c59,ffc088e64fab57e9,a390eb8a9b2df298,2007-05-26,1,0,0,113,0,0,8,6,4,4,0,0,4,3,0,0,4,3,4.0,109.0
12590,71348fd10e392dac,c8136ab8aa32c974,d43a048a880efdff,2007-05-26,0,0,0,900,3,2,79,21,54,25,3,2,22,11,30,24,24,10,192.5,583.6
12591,71348fd10e392dac,d43a048a880efdff,c8136ab8aa32c974,2007-05-26,0,0,0,900,0,0,135,20,131,4,1,1,3,2,40,23,91,18,8.4,629.5
12592,5157988b77ca1097,0541480fbf719d86,b9d0fd83bb8a147a,2007-05-26,2,0,0,48,0,0,20,14,16,4,0,0,4,3,3,3,13,11,4.2,28.0
12593,5157988b77ca1097,b9d0fd83bb8a147a,0541480fbf719d86,2007-05-26,0,0,0,48,0,0,8,4,8,0,0,0,0,0,1,1,7,4,0.0,43.8
12594,2ce541a11b2eb392,349aaa3da11eb587,6da99156486ed6c2,2007-05-26,0,0,0,900,7,2,126,38,123,3,1,1,2,1,16,15,107,37,7.6,794.6
12595,2ce541a11b2eb392,6da99156486ed6c2,349aaa3da11eb587,2007-05-26,0,0,0,900,12,2,91,10,89,2,0,0,2,1,7,6,82,9,16.4,736.4
12596,1ac335f049ed4e5e,394f55ebca199124,6a92caba39b64752,2007-05-26,0,0,0,124,0,0,9,0,9,0,0,0,0,0,5,5,4,0,0.0,98.3
12597,1ac335f049ed4e5e,6a92caba39b64752,394f55ebca199124,2007-05-26,1,0,0,124,3,1,20,5,16,4,0,0,4,4,4,2,12,1,25.7,79.0
12598,e7a7ab126225540c,270b89c00ef0c55c,c32fb8c0f6471a4d,2007-04-21,1,0,0,291,1,1,46,18,18,28,0,0,28,17,2,1,16,1,185.0,106.0
12599,e7a7ab126225540c,c32fb8c0f6471a4d,270b89c00ef0c55c,2007-04-21,0,0,0,291,0,0,3,0,3,0,0,0,0,0,1,1,2,0,0.0,106.0
12600,d8b098e5598509cc,663b76da637402c3,7f955f71fa2ce7ac,2007-04-21,0,0,0,104,4,0,10,0,10,0,0,0,0,0,0,0,10,0,0.0,99.0
12601,d8b098e5598509cc,7f955f71fa2ce7ac,663b76da637402c3,2007-04-21,1,0,0,104,0,0,23,6,23,0,0,0,0,0,0,0,23,6,0.0,104.0
12602,bc8e4abec782fd2b,5f87a5c00b3d17ed,a8aba6fd8a463043,2007-04-21,0,0,0,81,1,1,3,0,3,0,0,0,0,0,2,2,1,0,0.0,81.0
12603,bc8e4abec782fd2b,a8aba6fd8a463043,5f87a5c00b3d17ed,2007-04-21,0,1,1,81,0,0,5,0,5,0,0,0,0,0,3,1,2,0,0.0,38.0
12604,8dbd4d1df2e7ff67,33011768c3c4dc9a,bfc2fc38a0e20211,2007-04-21,0,3,1,288,0,0,9,2,9,0,0,0,0,0,3,3,6,2,0.0,44.30000000000001
12605,8dbd4d1df2e7ff67,bfc2fc38a0e20211,33011768c3c4dc9a,2007-04-21,0,0,0,288,1,1,38,20,3,35,6,6,29,20,0,0,3,0,214.7,61.0
12606,89b27e0bfa4ef4c3,4f95f74620a6b7a4,f7a7f7118d4b01b6,2007-04-21,0,0,0,900,1,0,46,3,46,0,0,0,0,0,11,5,35,3,0.0,789.0
12607,89b27e0bfa4ef4c3,f7a7f7118d4b01b6,4f95f74620a6b7a4,2007-04-21,1,1,0,900,0,0,101,34,72,29,8,5,21,13,28,28,44,21,111.0,743.0
12608,67160b93dec2b399,1eacf73d6a0055dc,e091482fa6648261,2007-04-21,0,1,0,900,0,0,113,40,107,6,1,1,5,3,30,23,77,37,31.2,636.8
12609,67160b93dec2b399,e091482fa6648261,1eacf73d6a0055dc,2007-04-21,0,0,0,900,12,6,24,4,23,1,0,0,1,1,10,9,13,3,86.2,437.8
12610,57a71ab365d2b64d,9b74de674c355425,afdb76fbd86f6d11,2007-04-21,1,0,0,637,0,0,198,44,188,10,1,0,9,3,44,34,144,41,5.3,629.0
12611,57a71ab365d2b64d,afdb76fbd86f6d11,9b74de674c355425,2007-04-21,0,0,0,637,5,0,142,20,142,0,0,0,0,0,32,26,110,20,0.0,612.7
12612,57871671074ceb4c,3738e68d2261e60f,492b202d2064e7a9,2007-04-21,1,0,0,900,0,0,81,9,76,5,5,4,0,0,39,15,37,9,14.2,863.0
12613,57871671074ceb4c,492b202d2064e7a9,3738e68d2261e60f,2007-04-21,0,0,0,900,3,0,78,15,78,0,0,0,0,0,9,8,69,15,0.0,835.8
12614,4563e02bc4c1a1ef,8caca5857ce0e30b,d0d7160824278840,2007-04-21,0,0,0,415,4,0,24,3,24,0,0,0,0,0,13,9,11,3,0.0,338.9
12615,4563e02bc4c1a1ef,d0d7160824278840,8caca5857ce0e30b,2007-04-21,1,2,1,415,1,0,49,21,44,5,0,0,5,5,8,8,36,16,53.1,107.0
12616,05b7bfd4fe75af69,2b93ebd9f5417ad2,817e0bdf08efce2e,2007-04-21,1,0,0,400,1,1,77,30,15,62,4,4,58,25,3,2,12,5,286.0,84.5
12617,05b7bfd4fe75af69,817e0bdf08efce2e,2b93ebd9f5417ad2,2007-04-21,1,2,0,400,0,0,20,2,17,3,0,0,3,1,8,6,9,1,29.5,55.0
12618,fc4e42a55ba285f6,82e7929bf6c2b689,dd37fd509af89f15,2007-04-07,0,0,0,900,0,0,116,6,116,0,0,0,0,0,8,6,108,6,0.0,894.0
12619,fc4e42a55ba285f6,dd37fd509af89f15,82e7929bf6c2b689,2007-04-07,0,0,0,900,1,1,116,23,116,0,0,0,0,0,9,7,107,23,0.0,886.0
12620,f25e367b1cb8fab5,b7d524c77c27389b,c3ea8deeba00462b,2007-04-07,0,1,1,477,3,3,20,6,18,2,0,0,2,1,0,0,18,5,220.7,138.0
12621,f25e367b1cb8fab5,c3ea8deeba00462b,b7d524c77c27389b,2007-04-07,0,0,0,477,0,0,21,3,19,2,0,0,2,0,7,4,12,3,8.0,236.3
12622,e7fdbd5c65798a5c,917e53fa0adea0d3,daf1b84aebd6602b,2007-04-07,0,2,0,900,1,0,89,23,84,5,0,0,5,3,14,6,70,20,12.5,420.2
12623,e7fdbd5c65798a5c,daf1b84aebd6602b,917e53fa0adea0d3,2007-04-07,0,0,0,900,7,6,206,79,118,88,7,5,81,44,1,1,117,35,414.8,279.5
12624,cb93f5f9d09b29f1,9fe85152f351e737,acff437707625fc7,2007-04-07,0,0,0,900,0,0,99,14,98,1,0,0,1,1,22,14,76,13,3.7,489.7
12625,cb93f5f9d09b29f1,acff437707625fc7,9fe85152f351e737,2007-04-07,0,2,0,900,9,4,55,24,38,17,1,1,16,11,4,3,34,13,351.3,462.3
12626,9f60dd19c5705d45,6506c1d34da9c013,86dfed7cc24a9fa7,2007-04-07,0,0,0,205,1,0,23,4,23,0,0,0,0,0,3,2,20,4,0.0,200.0
12627,9f60dd19c5705d45,86dfed7cc24a9fa7,6506c1d34da9c013,2007-04-07,2,0,0,205,0,0,40,13,29,11,0,0,11,7,9,7,20,6,0.0,205.0
12628,579f0be80b359d8b,4908c5ee68a50ee5,7450525c7ba032a0,2007-04-07,0,2,0,900,2,1,52,15,44,8,0,0,8,4,5,4,39,11,37.0,356.5
12629,579f0be80b359d8b,7450525c7ba032a0,4908c5ee68a50ee5,2007-04-07,2,0,0,900,1,1,123,53,73,50,9,9,41,24,2,2,71,29,469.5,309.0
12630,54cf1ffbc6e7a9fd,0359313549d230a1,cfb65863d5099327,2007-04-07,0,2,0,900,0,0,14,1,11,3,0,0,3,1,4,2,7,0,36.0,264.5
12631,54cf1ffbc6e7a9fd,cfb65863d5099327,0359313549d230a1,2007-04-07,0,4,0,900,8,3,84,48,29,55,0,0,55,41,9,8,20,7,599.5,210.0
12632,33b9285aec39e37f,234f3767ff0e5701,4130a743d9d22163,2007-04-07,0,2,1,582,1,1,74,25,61,13,0,0,13,8,22,16,39,17,87.9,232.0
12633,33b9285aec39e37f,4130a743d9d22163,234f3767ff0e5701,2007-04-07,0,0,0,582,7,1,13,0,12,1,1,1,0,0,7,7,5,0,66.0,362.1
12634,32b058d82c9e38de,6ef58dabef8beb15,93ce4ac89e3d7652,2007-04-07,0,0,0,465,4,1,55,4,55,0,0,0,0,0,7,5,48,4,0.0,442.0
12635,32b058d82c9e38de,93ce4ac89e3d7652,6ef58dabef8beb15,2007-04-07,1,0,0,465,1,0,89,19,89,0,0,0,0,0,23,19,66,19,0.0,436.0
12636,fc4fc81d3b7cc3bd,69b69c0178c4004d,75f871836d41f90f,2007-04-05,0,1,0,900,0,0,35,10,35,0,0,0,0,0,17,16,18,10,0.0,111.89999999999998
12637,fc4fc81d3b7cc3bd,75f871836d41f90f,69b69c0178c4004d,2007-04-05,0,0,0,900,5,3,40,19,4,36,0,0,36,18,2,2,2,1,788.1,90.0
12638,e9390cff6e5d52d0,79899ecf62020f6d,ccd1299e0345e0ce,2007-04-05,0,1,1,27,1,1,3,2,2,1,0,0,1,0,0,0,2,2,11.0,16.0
12639,e9390cff6e5d52d0,ccd1299e0345e0ce,79899ecf62020f6d,2007-04-05,0,0,0,27,0,0,7,1,7,0,0,0,0,0,0,0,7,1,0.0,13.0
12640,e89db3b111f92587,8a59d346dc976a10,bc8f6b42767e28df,2007-04-05,0,2,0,900,6,4,28,13,11,17,5,5,12,11,5,3,6,2,308.0,458.9
12641,e89db3b111f92587,bc8f6b42767e28df,8a59d346dc976a10,2007-04-05,0,1,0,900,2,1,30,3,27,3,0,0,3,1,13,9,14,2,133.1,237.0
12642,de2b0b8ef112f3b7,93b9496275bbbf80,af5b208e97f5d382,2007-04-05,0,0,0,339,1,1,30,4,30,0,0,0,0,0,4,4,26,4,0.0,155.2
12643,de2b0b8ef112f3b7,af5b208e97f5d382,93b9496275bbbf80,2007-04-05,0,1,1,339,1,1,39,10,18,21,0,0,21,9,10,7,8,1,169.8,145.0
12644,b2443846570bee7b,b14a68c533f4a4aa,cb139171ed1b69fe,2007-04-05,0,2,0,837,10,1,36,4,31,5,0,0,5,1,6,2,25,3,44.5,363.0
12645,b2443846570bee7b,cb139171ed1b69fe,b14a68c533f4a4aa,2007-04-05,0,1,1,837,1,1,72,25,35,37,0,0,37,19,15,13,20,6,385.0,355.5
12646,b15bebf4c6b6f495,04c15b52c3cc1cab,aa1952ec0b3dd8e1,2007-04-05,0,0,0,178,0,0,11,4,6,5,0,0,5,2,3,2,3,2,0.0,65.0
12647,b15bebf4c6b6f495,aa1952ec0b3dd8e1,04c15b52c3cc1cab,2007-04-05,0,1,1,178,2,1,7,3,2,5,1,1,4,3,0,0,2,0,113.0,65.0
12648,73ed365b57dc1a6e,65ddc8a9ac4e8531,d814f5192e58fb2f,2007-04-05,0,0,0,900,2,2,88,29,75,13,1,1,12,5,2,2,73,24,94.1,475.2
12649,73ed365b57dc1a6e,d814f5192e58fb2f,65ddc8a9ac4e8531,2007-04-05,0,0,0,900,5,2,174,36,104,70,10,10,60,19,39,33,65,17,243.8,401.9
12650,6d370bfe4248dc88,9d4522df6fc49a47,e86bc32f5997a8f7,2007-04-05,0,1,0,900,12,5,45,20,18,27,3,2,24,17,4,4,14,3,525.2,297.0
12651,6d370bfe4248dc88,e86bc32f5997a8f7,9d4522df6fc49a47,2007-04-05,0,0,0,900,0,0,35,4,35,0,0,0,0,0,7,3,28,4,0.0,326.79999999999995
12652,460b421493dd9fb8,1c86754617d9813a,7d21de9c6d7c98b2,2007-04-05,0,4,0,900,8,7,36,16,22,14,1,1,13,5,5,5,17,11,414.2,190.0
12653,460b421493dd9fb8,7d21de9c6d7c98b2,1c86754617d9813a,2007-04-05,0,0,0,900,0,0,27,5,27,0,0,0,0,0,4,4,23,5,0.0,477.8
12654,94df6c8cd2256f54,6f018c039b4d5d80,9583662df31d943f,2007-03-03,0,2,1,485,7,2,42,7,27,15,4,2,11,5,13,10,14,2,156.6,224.0
12655,94df6c8cd2256f54,9583662df31d943f,6f018c039b4d5d80,2007-03-03,0,0,0,485,0,0,25,3,25,0,0,0,0,0,12,11,13,3,0.0,291.4
12656,8ca1bb1b2517f2e5,5be86bb2f78fef2f,d468288756ae3982,2007-03-03,2,0,0,516,2,2,30,15,14,16,1,1,15,7,3,3,11,8,113.2,260.4
12657,8ca1bb1b2517f2e5,d468288756ae3982,5be86bb2f78fef2f,2007-03-03,0,1,0,516,1,1,22,4,19,3,0,0,3,1,7,1,12,3,64.6,165.8
12658,8afc674a60abab61,98b80a717b9bda17,b5ea750025697880,2007-03-03,1,0,0,240,1,0,49,28,30,19,0,0,19,15,2,1,28,13,45.1,183.0
12659,8afc674a60abab61,b5ea750025697880,98b80a717b9bda17,2007-03-03,0,0,0,240,4,0,32,3,32,0,0,0,0,0,12,8,20,3,0.0,194.9
12660,85e130a7c48f25f6,91720876db0ee468,a54fc2d6fc224dc3,2007-03-03,0,0,0,94,0,0,2,0,2,0,0,0,0,0,0,0,2,0,0.0,14.0
12661,85e130a7c48f25f6,a54fc2d6fc224dc3,91720876db0ee468,2007-03-03,0,2,1,94,1,1,13,6,1,12,0,0,12,6,1,1,0,0,80.0,14.0
12662,808d47f905e84e7e,75e5fec9f72910ef,fa8b9e6b0c2269f8,2007-03-03,0,1,0,900,6,5,83,33,25,58,3,2,55,28,1,1,24,5,744.0,156.0
12663,808d47f905e84e7e,fa8b9e6b0c2269f8,75e5fec9f72910ef,2007-03-03,0,0,0,900,0,0,42,4,41,1,0,0,1,1,15,8,26,3,0.0,156.0
12664,7401d0f8ededa102,0aa92558424ced9e,2a542ee8a8b83559,2007-03-03,1,0,0,1500,10,7,138,57,92,46,10,9,36,22,9,7,83,35,911.4,532.9
12665,7401d0f8ededa102,2a542ee8a8b83559,0aa92558424ced9e,2007-03-03,0,0,0,1500,0,0,106,22,101,5,0,0,5,5,4,3,97,17,16.1,543.6
12666,3404f9095676a556,2be6596a9db33bf5,d897897060f10a3a,2007-03-03,0,0,0,600,11,1,27,0,26,1,1,1,0,0,15,15,11,0,9.0,237.9
12667,3404f9095676a556,d897897060f10a3a,2be6596a9db33bf5,2007-03-03,1,0,0,600,1,1,89,44,35,54,0,0,54,30,6,5,29,14,245.1,296.0
12668,204932945d332406,621a6c59f88a44fe,91acd6910b802a9e,2007-03-03,0,3,0,900,3,2,21,11,0,21,2,2,19,11,0,0,0,0,789.0,66.0
12669,204932945d332406,91acd6910b802a9e,621a6c59f88a44fe,2007-03-03,0,3,0,900,0,0,16,1,9,7,5,4,2,0,0,0,9,1,45.0,66.0
12670,0653b6227894cfd7,1fd4fbdcc67de844,8b69839f3555a67b,2007-03-03,1,0,0,246,0,0,33,16,28,5,0,0,5,4,1,0,27,12,6.1,179.5
12671,0653b6227894cfd7,8b69839f3555a67b,1fd4fbdcc67de844,2007-03-03,0,1,1,246,1,1,32,9,27,5,2,2,3,2,7,4,20,7,55.5,117.9
12672,f0b7729fba7e4533,3410cf010558dc8b,9fa3bd637edd9aa2,2007-02-03,0,0,0,900,3,0,90,28,90,0,0,0,0,0,14,6,76,28,0.0,701.6
12673,f0b7729fba7e4533,9fa3bd637edd9aa2,3410cf010558dc8b,2007-02-03,0,0,0,900,3,1,86,24,79,7,0,0,7,3,30,26,49,21,26.4,753.0
12674,d6e35b8c66732da6,4f4dac51adc1af4f,a149d6bc670cdb60,2007-02-03,0,0,0,900,8,4,32,12,26,6,0,0,6,4,3,2,23,8,344.0,332.7
12675,d6e35b8c66732da6,a149d6bc670cdb60,4f4dac51adc1af4f,2007-02-03,0,1,0,900,1,1,105,39,54,51,0,0,51,21,9,5,45,18,223.3,302.0
12676,ca5b6d6a26891f4b,7f0b4a75ef3039a3,c32fb8c0f6471a4d,2007-02-03,0,0,0,273,0,0,40,4,40,0,0,0,0,0,2,1,38,4,0.0,229.2
12677,ca5b6d6a26891f4b,c32fb8c0f6471a4d,7f0b4a75ef3039a3,2007-02-03,1,0,0,273,0,0,39,16,29,10,0,0,10,7,5,4,24,9,43.8,216.0
12678,c742bd1673635ded,6a92caba39b64752,cb46dface0e28a2c,2007-02-03,1,0,0,14,0,0,4,4,1,3,0,0,3,3,0,0,1,1,5.0,9.0
12679,c742bd1673635ded,cb46dface0e28a2c,6a92caba39b64752,2007-02-03,0,0,0,14,0,0,2,0,2,0,0,0,0,0,2,1,0,0,0.0,9.0
12680,c1df212ba092c404,05866d8c3a321856,ffc088e64fab57e9,2007-02-03,0,0,0,529,1,0,54,9,54,0,0,0,0,0,7,6,47,9,0.0,496.5
12681,c1df212ba092c404,ffc088e64fab57e9,05866d8c3a321856,2007-02-03,1,0,0,529,1,0,74,31,73,1,0,0,1,1,15,14,58,30,1.5,468.0
12682,77df989840c76a08,84a067c46306a737,f7a7f7118d4b01b6,2007-02-03,0,0,0,900,7,1,47,6,46,1,0,0,1,0,10,5,36,6,4.2,508.1
12683,77df989840c76a08,f7a7f7118d4b01b6,84a067c46306a737,2007-02-03,1,0,0,900,4,4,95,42,62,33,5,3,28,19,21,17,41,23,366.9,428.8
12684,5d06b45564f62c80,88c8f47241d90040,daf1b84aebd6602b,2007-02-03,0,0,0,19,0,0,2,0,2,0,0,0,0,0,1,1,1,0,0.0,7.0
12685,5d06b45564f62c80,daf1b84aebd6602b,88c8f47241d90040,2007-02-03,1,0,0,19,1,1,18,13,1,17,0,0,17,13,0,0,1,0,12.0,7.0
12686,33065e87a42a74a2,1f454354805b6f75,622f015c81a9b13a,2007-02-03,0,2,1,431,0,0,11,8,3,8,1,0,7,7,1,1,2,1,26.0,110.0
12687,33065e87a42a74a2,622f015c81a9b13a,1f454354805b6f75,2007-02-03,0,0,0,431,5,3,16,7,2,14,1,1,13,7,0,0,2,0,295.0,110.0
12688,063599b1d4107289,20205040232ed0f3,f2688492b9a525a3,2007-02-03,0,4,0,900,6,3,115,18,114,1,0,0,1,1,24,20,90,17,16.5,672.4
12689,063599b1d4107289,f2688492b9a525a3,20205040232ed0f3,2007-02-03,0,0,0,900,15,8,100,43,77,23,7,7,16,11,7,5,70,32,128.6,581.5
12690,9c9039f921aa86ca,40a604761ca7d64d,c47df9303d318c67,2007-01-25,0,1,0,900,0,0,113,28,110,3,0,0,3,2,5,5,105,26,14.4,473.4
12691,9c9039f921aa86ca,c47df9303d318c67,40a604761ca7d64d,2007-01-25,0,0,0,900,16,5,105,29,72,33,0,0,33,19,6,4,66,10,378.6,472.6
12692,88d9e7ec7f228908,7c0847d3854a95f2,ee779c43a8926d52,2007-01-25,0,0,0,366,3,2,28,10,21,7,0,0,7,6,1,0,20,4,30.3,313.8
12693,88d9e7ec7f228908,ee779c43a8926d52,7c0847d3854a95f2,2007-01-25,1,0,0,366,0,0,35,10,34,1,0,0,1,1,5,3,29,9,0.2,333.7
12694,830e59a396dddec3,20bcc9966affb19c,7450525c7ba032a0,2007-01-25,0,1,0,900,8,6,41,12,20,21,1,1,20,10,0,0,20,2,598.0,271.2
12695,830e59a396dddec3,7450525c7ba032a0,20bcc9966affb19c,2007-01-25,1,1,0,900,1,1,61,9,52,9,1,1,8,6,1,1,51,3,30.8,261.0
12696,7253daded133e97c,68c6cd5287b473a7,a8e6a69796280f17,2007-01-25,0,0,0,900,11,0,43,9,42,1,0,0,1,1,11,9,31,8,0.0,578.2
12697,7253daded133e97c,a8e6a69796280f17,68c6cd5287b473a7,2007-01-25,4,0,0,900,2,2,98,42,73,25,6,5,19,12,8,6,65,30,321.8,398.0
12698,539a550c0c1acd3e,6da99156486ed6c2,d8022d5526b1d937,2007-01-25,0,0,0,900,12,9,49,16,25,24,5,4,19,10,7,7,18,6,519.5,164.0
12699,539a550c0c1acd3e,d8022d5526b1d937,6da99156486ed6c2,2007-01-25,0,2,0,900,3,1,30,3,30,0,0,0,0,0,8,3,22,3,0.0,293.5
12700,221928c8441779e4,0597a4528ebd1307,06f36cf4bd97ec77,2007-01-25,0,1,0,178,0,0,5,1,5,0,0,0,0,0,4,4,1,1,0.0,32.400000000000006
12701,221928c8441779e4,06f36cf4bd97ec77,0597a4528ebd1307,2007-01-25,0,1,1,178,2,1,9,5,2,7,0,0,7,4,0,0,2,1,142.6,15.0
12702,17b2d89ceb879a29,e0ec3c3b6b611f7e,f34312c2ccfa0e00,2007-01-25,1,2,0,543,5,2,80,23,53,27,0,0,27,8,4,2,49,15,170.0,309.5
12703,17b2d89ceb879a29,f34312c2ccfa0e00,e0ec3c3b6b611f7e,2007-01-25,0,0,0,543,0,0,61,10,60,1,1,1,0,0,17,13,43,10,0.5,369.0
12704,14df6d96c5f2d1df,7215953cd5c6254d,7d21de9c6d7c98b2,2007-01-25,0,0,0,593,0,0,104,6,104,0,0,0,0,0,18,17,86,6,0.0,593.0
12705,14df6d96c5f2d1df,7d21de9c6d7c98b2,7215953cd5c6254d,2007-01-25,0,1,1,593,1,1,63,8,63,0,0,0,0,0,20,15,43,8,0.0,550.0
12706,f507b715628d7bcb,2f732dd9210d301f,a390eb8a9b2df298,2006-12-30,0,0,0,839,8,1,76,7,76,0,0,0,0,0,21,14,55,7,0.0,750.2
12707,f507b715628d7bcb,a390eb8a9b2df298,2f732dd9210d301f,2006-12-30,1,0,0,839,0,0,132,40,88,44,1,1,43,14,8,8,80,26,69.8,766.0
12708,da666b02372a465b,2b93ebd9f5417ad2,f59f1d3a2ff13edd,2006-12-30,1,0,0,264,1,0,33,15,17,16,0,0,16,10,5,4,12,5,34.7,194.0
12709,da666b02372a465b,f59f1d3a2ff13edd,2b93ebd9f5417ad2,2006-12-30,0,2,0,264,7,3,6,1,5,1,0,0,1,1,3,2,2,0,31.0,74.3
12710,cc02aaf53503d022,31ee470ef5dc8d7f,6ad9058b7c7898b0,2006-12-30,2,1,0,370,0,0,49,26,8,41,0,0,41,23,1,0,7,3,104.0,266.0
12711,cc02aaf53503d022,6ad9058b7c7898b0,31ee470ef5dc8d7f,2006-12-30,0,0,0,370,8,0,10,0,10,0,0,0,0,0,1,1,9,0,0.0,240.0
12712,bb007be9f60ab3da,b9d0fd83bb8a147a,fcffee71cff5530e,2006-12-30,1,0,0,281,0,0,63,28,55,8,0,0,8,8,8,8,47,20,7.3,270.0
12713,bb007be9f60ab3da,fcffee71cff5530e,b9d0fd83bb8a147a,2006-12-30,0,0,0,281,1,0,56,8,56,0,0,0,0,0,12,9,44,8,0.0,273.7
12714,56f77263c75392f2,4b4753d19489297f,f1b2a4365799c48b,2006-12-30,1,0,0,900,11,3,107,40,98,9,0,0,9,7,9,8,89,33,64.0,567.3
12715,56f77263c75392f2,f1b2a4365799c48b,4b4753d19489297f,2006-12-30,1,0,0,900,1,1,206,56,185,21,0,0,21,8,6,5,179,48,76.7,657.0
12716,5027a869467001d3,3738e68d2261e60f,6aa1cbc1466e9a0b,2006-12-30,1,1,0,195,0,0,11,5,6,5,0,0,5,5,2,2,4,0,83.0,112.0
12717,5027a869467001d3,6aa1cbc1466e9a0b,3738e68d2261e60f,2006-12-30,0,2,0,195,5,0,2,0,2,0,0,0,0,0,0,0,2,0,0.0,61.0
12718,3825f998c01cbeab,2be6596a9db33bf5,d43a048a880efdff,2006-12-30,0,1,1,543,5,1,27,2,27,0,0,0,0,0,13,7,14,2,0.0,232.5
12719,3825f998c01cbeab,d43a048a880efdff,2be6596a9db33bf5,2006-12-30,0,0,0,543,2,2,34,13,29,5,0,0,5,2,4,2,25,11,23.5,435.0
12720,343b016754852c36,546015aa2ad945fd,acff437707625fc7,2006-12-30,0,0,0,843,1,0,93,5,93,0,0,0,0,0,25,23,68,5,0.0,497.1
12721,343b016754852c36,acff437707625fc7,546015aa2ad945fd,2006-12-30,1,0,0,843,4,3,83,24,59,24,3,2,21,16,10,9,49,8,315.9,435.0
12722,2606c3853a8c0b62,270b89c00ef0c55c,aa03a3ca00ac6827,2006-12-30,0,3,1,202,1,1,10,4,3,7,0,0,7,3,0,0,3,1,178.0,24.0
12723,2606c3853a8c0b62,aa03a3ca00ac6827,270b89c00ef0c55c,2006-12-30,0,0,0,202,1,0,2,1,1,1,0,0,1,1,0,0,1,0,0.0,24.0
12724,e52eae4ea46c6010,275cafc9de131c83,9583662df31d943f,2006-12-13,0,2,0,284,2,0,42,2,42,0,0,0,0,0,12,6,30,2,0.0,273.0
12725,e52eae4ea46c6010,9583662df31d943f,275cafc9de131c83,2006-12-13,1,0,0,284,1,1,50,14,45,5,1,1,4,1,9,8,36,13,11.0,251.0
12726,bc0155d267fb5892,82e7929bf6c2b689,d512d9f204059f57,2006-12-13,2,0,0,105,1,0,10,5,7,3,0,0,3,3,1,1,6,2,4.0,101.0
12727,bc0155d267fb5892,d512d9f204059f57,82e7929bf6c2b689,2006-12-13,0,0,0,105,0,0,6,2,6,0,0,0,0,0,2,1,4,2,0.0,101.0
12728,abf6ea197979e634,5eedbf1e9601be35,65ddc8a9ac4e8531,2006-12-13,0,0,0,900,20,5,55,20,43,12,0,0,12,7,3,2,40,13,380.2,297.8
12729,abf6ea197979e634,65ddc8a9ac4e8531,5eedbf1e9601be35,2006-12-13,0,1,0,900,1,0,44,14,43,1,0,0,1,1,2,2,41,13,0.2,518.8
12730,a5155aef1093048b,7b6e40a73b567072,b7d524c77c27389b,2006-12-13,0,0,0,900,0,0,86,9,77,9,0,0,9,3,23,18,54,6,59.1,794.9
12731,a5155aef1093048b,b7d524c77c27389b,7b6e40a73b567072,2006-12-13,1,2,0,900,2,1,106,38,105,1,0,0,1,1,20,16,85,37,13.1,670.9
12732,8d3c5635cffe12cb,43612456979e5d5e,6776260cb0aef647,2006-12-13,0,4,0,900,5,3,35,16,6,29,1,1,28,13,1,1,5,3,487.6,235.8
12733,8d3c5635cffe12cb,6776260cb0aef647,43612456979e5d5e,2006-12-13,0,2,0,900,0,0,55,27,28,27,4,4,23,20,11,9,17,7,126.2,183.39999999999998
12734,844fc95da48937b3,349aaa3da11eb587,d814f5192e58fb2f,2006-12-13,0,0,0,900,4,3,147,55,123,24,0,0,24,13,1,1,122,42,134.1,576.1
12735,844fc95da48937b3,d814f5192e58fb2f,349aaa3da11eb587,2006-12-13,0,0,0,900,7,1,128,21,108,20,0,0,20,11,36,26,72,10,38.9,693.9
12736,77a8a6e2c3a09d19,4130a743d9d22163,f8dc544e7077d014,2006-12-13,1,2,0,765,2,1,76,11,55,21,5,5,16,5,17,13,38,6,209.2,419.0
12737,77a8a6e2c3a09d19,f8dc544e7077d014,4130a743d9d22163,2006-12-13,0,3,0,765,3,0,59,11,56,3,0,0,3,1,6,3,50,10,87.0,410.8
12738,4faa30eab9089d71,4f95f74620a6b7a4,663b76da637402c3,2006-12-13,0,0,0,900,0,0,132,24,131,1,0,0,1,1,29,20,102,23,0.4,874.6
12739,4faa30eab9089d71,663b76da637402c3,4f95f74620a6b7a4,2006-12-13,0,0,0,900,3,1,209,46,200,9,2,1,7,4,26,19,174,42,20.4,840.6
12740,0d2314d23dee3796,388abbf8832b5adf,dd37fd509af89f15,2006-12-13,0,1,0,900,0,0,54,8,54,0,0,0,0,0,11,10,43,8,0.0,344.0
12741,0d2314d23dee3796,dd37fd509af89f15,388abbf8832b5adf,2006-12-13,0,1,0,900,12,6,44,12,20,24,1,1,23,10,1,1,19,2,556.0,344.0
12742,f743abae6896c1e8,20bcc9966affb19c,821cd80aab70d5f9,2006-11-18,0,0,0,900,13,10,31,12,7,24,1,1,23,12,0,0,7,0,622.0,278.0
12743,f743abae6896c1e8,821cd80aab70d5f9,20bcc9966affb19c,2006-11-18,0,0,0,900,0,0,40,1,40,0,0,0,0,0,18,12,22,1,0.0,251.0
12744,e3d9bbea4c51dec4,79899ecf62020f6d,b14a68c533f4a4aa,2006-11-18,0,3,1,127,0,0,1,0,1,0,0,0,0,0,1,1,0,0,0.0,16.0
12745,e3d9bbea4c51dec4,b14a68c533f4a4aa,79899ecf62020f6d,2006-11-18,0,0,0,127,1,1,5,0,2,3,1,1,2,0,0,0,2,0,111.0,16.0
12746,cb17062bfd400fb2,1fd4fbdcc67de844,7f955f71fa2ce7ac,2006-11-18,1,0,0,247,1,1,57,21,42,15,5,5,10,7,5,4,37,14,21.5,214.0
12747,cb17062bfd400fb2,7f955f71fa2ce7ac,1fd4fbdcc67de844,2006-11-18,0,0,0,247,2,0,58,28,58,0,0,0,0,0,6,4,52,28,0.0,214.5
12748,ba0a3a4b80418db9,1ff9589f9065a9ed,fa315e6c77eee106,2006-11-18,0,0,0,69,1,0,7,2,7,0,0,0,0,0,0,0,7,2,0.0,41.2
12749,ba0a3a4b80418db9,fa315e6c77eee106,1ff9589f9065a9ed,2006-11-18,1,0,0,69,0,0,21,13,12,9,0,0,9,8,2,2,10,5,27.8,35.0
12750,b03109dd04b2fa60,75e5fec9f72910ef,f57a8a52ca401ed9,2006-11-18,0,1,0,447,3,0,9,0,1,8,0,0,8,0,0,0,1,0,222.0,28.0
12751,b03109dd04b2fa60,f57a8a52ca401ed9,75e5fec9f72910ef,2006-11-18,1,1,0,447,1,0,51,24,2,49,0,0,49,23,0,0,2,1,197.0,28.0
12752,719dbfab71e6c0bd,a7f4d0902bb64092,d1759b2b7be9be56,2006-11-18,1,0,0,456,0,0,34,4,30,4,1,1,3,2,19,12,11,2,3.4,348.7
12753,719dbfab71e6c0bd,d1759b2b7be9be56,a7f4d0902bb64092,2006-11-18,0,1,0,456,5,3,48,24,37,11,0,0,11,8,10,9,27,16,101.3,231.6
12754,3f7bf047b310943d,69b69c0178c4004d,e670f8cc2969a789,2006-11-18,1,0,0,195,0,0,12,5,12,0,0,0,0,0,6,5,6,5,0.0,58.30000000000001
12755,3f7bf047b310943d,e670f8cc2969a789,69b69c0178c4004d,2006-11-18,0,0,0,195,1,1,11,4,6,5,0,0,5,4,1,0,5,0,136.7,31.0
12756,2f379b530fefb7ea,2a542ee8a8b83559,cbfd1d34356a004c,2006-11-18,0,1,0,1500,0,0,175,27,151,24,21,20,3,1,2,2,149,26,344.0,847.0
12757,2f379b530fefb7ea,cbfd1d34356a004c,2a542ee8a8b83559,2006-11-18,0,2,0,1500,13,1,50,10,36,14,2,2,12,4,1,0,35,6,309.0,847.0
12758,148f5128a45e9212,621a6c59f88a44fe,6506c1d34da9c013,2006-11-18,0,0,0,385,3,0,39,6,39,0,0,0,0,0,5,4,34,6,0.0,358.3
12759,148f5128a45e9212,6506c1d34da9c013,621a6c59f88a44fe,2006-11-18,2,0,0,385,1,1,92,32,79,13,0,0,13,8,22,13,57,24,26.7,348.0
12760,f8e3b306cf3e6d95,8b69839f3555a67b,cfb65863d5099327,2006-11-11,1,0,0,900,0,0,200,74,198,2,0,0,2,2,27,27,171,72,7.1,732.9
12761,f8e3b306cf3e6d95,cfb65863d5099327,8b69839f3555a67b,2006-11-11,1,0,0,900,12,1,171,37,163,8,0,0,8,3,11,9,152,34,67.1,741.9
12762,cf1f2322c4b8bc64,da97d6c97d09c030,ea3ef6206c7907d5,2006-11-11,0,1,1,283,1,1,12,1,12,0,0,0,0,0,1,1,11,1,0.0,245.0
12763,cf1f2322c4b8bc64,ea3ef6206c7907d5,da97d6c97d09c030,2006-11-11,0,0,0,283,0,0,26,4,26,0,0,0,0,0,8,5,18,4,0.0,283.0
12764,c0e8b02fd4a5e56c,40a604761ca7d64d,7d21de9c6d7c98b2,2006-11-11,1,1,1,491,1,1,75,23,72,3,0,0,3,2,13,10,59,21,19.3,356.0
12765,c0e8b02fd4a5e56c,7d21de9c6d7c98b2,40a604761ca7d64d,2006-11-11,0,0,0,491,2,1,72,9,72,0,0,0,0,0,18,13,54,9,0.0,451.7
12766,c00a49eadfb592f0,622f015c81a9b13a,9fa3bd637edd9aa2,2006-11-11,0,1,1,138,2,1,0,0,0,0,0,0,0,0,0,0,0,0,0.0,21.0
12767,c00a49eadfb592f0,9fa3bd637edd9aa2,622f015c81a9b13a,2006-11-11,0,0,0,138,0,0,1,0,1,0,0,0,0,0,0,0,1,0,0.0,138.0
12768,b34aa3946ccfcfbb,75bbd2206a15319f,cb46dface0e28a2c,2006-11-11,0,0,0,157,0,0,25,4,25,0,0,0,0,0,3,2,22,4,0.0,136.8
12769,b34aa3946ccfcfbb,cb46dface0e28a2c,75bbd2206a15319f,2006-11-11,1,0,0,157,0,0,43,16,32,11,1,1,10,6,9,7,23,10,5.2,142.0
12770,71900a1af85710a9,86dfed7cc24a9fa7,91acd6910b802a9e,2006-11-11,0,0,0,900,16,1,39,7,36,3,1,1,2,1,17,12,19,6,61.6,392.4
12771,71900a1af85710a9,91acd6910b802a9e,86dfed7cc24a9fa7,2006-11-11,0,0,0,900,2,1,58,7,50,8,5,5,3,0,31,30,19,7,14.6,754.4
12772,4cd909fa0d3e0483,ad32471f01e7b1a5,c3ea8deeba00462b,2006-11-11,0,0,0,371,5,2,14,0,13,1,0,0,1,0,7,5,6,0,33.7,122.8
12773,4cd909fa0d3e0483,c3ea8deeba00462b,ad32471f01e7b1a5,2006-11-11,0,0,1,371,0,0,15,7,8,7,0,0,7,5,5,5,3,2,46.2,271.3
12774,36895d9bbf5abc51,0359313549d230a1,3410cf010558dc8b,2006-11-11,0,0,0,505,0,0,90,19,90,0,0,0,0,0,17,13,73,19,0.0,466.7
12775,36895d9bbf5abc51,3410cf010558dc8b,0359313549d230a1,2006-11-11,2,0,0,505,0,0,93,23,92,1,0,0,1,0,7,3,85,23,1.3,497.0
12776,e30ee434b864e4ac,029880cdbf5ca089,cb139171ed1b69fe,2006-10-14,0,1,0,1500,13,8,104,55,21,83,0,0,83,49,6,5,15,6,1107.9,279.0
12777,e30ee434b864e4ac,cb139171ed1b69fe,029880cdbf5ca089,2006-10-14,0,4,0,1500,1,0,40,12,28,12,0,0,12,11,12,11,16,1,33.0,359.0999999999999
12778,b23c7d4fb2068989,acff437707625fc7,c8136ab8aa32c974,2006-10-14,1,1,0,700,4,3,76,30,56,20,1,1,19,12,8,8,48,18,164.0,454.0
12779,b23c7d4fb2068989,c8136ab8aa32c974,acff437707625fc7,2006-10-14,0,1,0,700,4,0,36,4,36,0,0,0,0,0,19,15,17,4,0.0,413.0
12780,a2e2d0e8b94d8eba,1ea8df62b3f8fea6,c47df9303d318c67,2006-10-14,0,1,0,582,0,0,36,8,34,2,0,0,2,2,5,5,29,6,4.3,115.60000000000002
12781,a2e2d0e8b94d8eba,c47df9303d318c67,1ea8df62b3f8fea6,2006-10-14,0,2,1,582,4,2,52,23,14,38,2,2,36,21,1,1,13,2,440.4,125.7
12782,95f052cbeb1d5e65,1eacf73d6a0055dc,aa03a3ca00ac6827,2006-10-14,0,2,0,900,2,0,42,4,41,1,0,0,1,0,22,14,19,4,27.5,211.10000000000002
12783,95f052cbeb1d5e65,aa03a3ca00ac6827,1eacf73d6a0055dc,2006-10-14,0,0,0,900,10,6,31,6,2,29,10,10,19,6,1,0,1,0,523.9,330.5
12784,94c1844d487490ef,4c8d6fde2dde07c4,f34312c2ccfa0e00,2006-10-14,0,0,0,278,5,2,25,7,2,23,2,1,21,6,0,0,2,1,201.5,56.6
12785,94c1844d487490ef,f34312c2ccfa0e00,4c8d6fde2dde07c4,2006-10-14,1,0,0,278,0,0,17,12,14,3,1,1,2,2,0,0,14,10,2.4,65.5
12786,84efac79989f4d0a,1f454354805b6f75,d897897060f10a3a,2006-10-14,1,0,0,179,0,0,36,5,36,0,0,0,0,0,27,26,9,5,0.0,157.0
12787,84efac79989f4d0a,d897897060f10a3a,1f454354805b6f75,2006-10-14,0,0,0,179,0,0,23,4,23,0,0,0,0,0,7,6,16,4,0.0,179.0
12788,7455cb1ee651f774,aa1952ec0b3dd8e1,d0d7160824278840,2006-10-14,0,1,1,124,1,1,9,5,0,9,0,0,9,5,0,0,0,0,114.0,10.0
12789,7455cb1ee651f774,d0d7160824278840,aa1952ec0b3dd8e1,2006-10-14,0,0,0,124,0,0,6,1,6,0,0,0,0,0,0,0,6,1,0.0,10.0
12790,1ef09b1bf60f23cb,6f018c039b4d5d80,9d4522df6fc49a47,2006-10-14,0,0,0,900,6,5,78,36,36,42,4,3,38,25,6,5,30,11,657.4,180.0
12791,1ef09b1bf60f23cb,9d4522df6fc49a47,6f018c039b4d5d80,2006-10-14,0,2,0,900,2,0,17,2,17,0,0,0,0,0,3,2,14,2,0.0,192.60000000000002
12792,fee1d48d7bc17e56,a8e6a69796280f17,bf41b5131545da12,2006-10-10,0,2,1,374,3,2,27,7,16,11,0,0,11,6,7,6,9,1,215.0,114.0
12793,fee1d48d7bc17e56,bf41b5131545da12,a8e6a69796280f17,2006-10-10,0,0,0,374,0,0,18,3,17,1,0,0,1,0,2,1,15,3,45.0,114.0
12794,ebfdeab96ca766be,31ee470ef5dc8d7f,7a15f3694c5cbc02,2006-10-10,0,0,0,900,0,0,142,27,127,15,0,0,15,7,47,36,80,20,30.0,798.9
12795,ebfdeab96ca766be,7a15f3694c5cbc02,31ee470ef5dc8d7f,2006-10-10,0,0,0,900,10,2,82,12,81,1,0,0,1,1,3,1,78,11,25.1,619.0
12796,afda8492a55f1c5d,b7d524c77c27389b,e86bc32f5997a8f7,2006-10-10,0,1,1,298,0,0,50,17,35,15,0,0,15,8,17,16,18,9,19.2,248.0
12797,afda8492a55f1c5d,e86bc32f5997a8f7,b7d524c77c27389b,2006-10-10,0,0,0,298,0,0,18,2,18,0,0,0,0,0,4,3,14,2,0.0,257.8
12798,963631fe3261f8e1,546015aa2ad945fd,6ef58dabef8beb15,2006-10-10,0,0,0,900,1,0,123,44,122,1,0,0,1,0,6,6,116,44,3.3,695.1
12799,963631fe3261f8e1,6ef58dabef8beb15,546015aa2ad945fd,2006-10-10,1,0,0,900,6,1,101,15,81,20,1,1,19,8,13,7,68,7,128.9,722.7
12800,724dd26b47b7349e,93b9496275bbbf80,98b80a717b9bda17,2006-10-10,1,1,0,900,0,0,58,11,55,3,0,0,3,1,17,14,38,10,3.7,557.4
12801,724dd26b47b7349e,98b80a717b9bda17,93b9496275bbbf80,2006-10-10,0,0,0,900,11,7,40,11,34,6,0,0,6,3,3,3,31,8,331.6,288.3
12802,2e6c21d6bad88346,6ad9058b7c7898b0,a149d6bc670cdb60,2006-10-10,0,1,1,239,1,1,5,5,0,5,0,0,5,5,0,0,0,0,219.0,20.0
12803,2e6c21d6bad88346,a149d6bc670cdb60,6ad9058b7c7898b0,2006-10-10,0,1,0,239,0,0,4,1,4,0,0,0,0,0,0,0,4,1,0.0,20.0
12804,2e5a301f042f1fd6,0597a4528ebd1307,234f3767ff0e5701,2006-10-10,0,0,0,239,0,0,10,2,8,2,0,0,2,0,3,3,5,2,14.4,47.400000000000006
12805,2e5a301f042f1fd6,234f3767ff0e5701,0597a4528ebd1307,2006-10-10,1,1,0,239,1,1,26,12,5,21,0,0,21,11,1,1,4,1,155.6,61.6
12806,2cbba9394114edb5,2f732dd9210d301f,63b65af1c5cb02cb,2006-10-10,1,0,0,143,1,1,29,15,5,24,0,0,24,15,4,3,1,0,112.0,17.0
12807,2cbba9394114edb5,63b65af1c5cb02cb,2f732dd9210d301f,2006-10-10,0,0,0,143,0,0,0,0,0,0,0,0,0,0,0,0,0,0,0.0,31.0
12808,27cdd152218b44d4,06f36cf4bd97ec77,2be6596a9db33bf5,2006-10-10,0,0,0,163,2,1,2,0,2,0,0,0,0,0,2,2,0,0,0.0,28.0
12809,27cdd152218b44d4,2be6596a9db33bf5,06f36cf4bd97ec77,2006-10-10,0,2,1,163,1,0,7,4,4,3,0,0,3,3,2,1,2,1,57.0,106.0
12810,cd9f95344fe14e37,3bad7ef643840f67,44260175069b6276,2006-09-23,1,0,0,48,1,1,11,9,5,6,0,0,6,5,0,0,5,4,0.0,48.0
12811,cd9f95344fe14e37,44260175069b6276,3bad7ef643840f67,2006-09-23,0,0,0,48,0,0,1,0,1,0,0,0,0,0,0,0,1,0,0.0,17.0
12812,b4a2fc934d4660ff,621a6c59f88a44fe,73c7cfa551289285,2006-09-23,1,0,0,833,9,1,88,28,65,23,0,0,23,11,10,7,55,17,321.2,394.3
12813,b4a2fc934d4660ff,73c7cfa551289285,621a6c59f88a44fe,2006-09-23,0,2,0,833,1,0,37,10,35,2,1,1,1,1,8,6,27,9,19.7,393.8
12814,9a6b4829863eb9dc,1209b5134401ca53,7f0b4a75ef3039a3,2006-09-23,0,0,0,317,1,1,20,4,18,2,0,0,2,1,7,6,11,3,34.0,143.8
12815,9a6b4829863eb9dc,7f0b4a75ef3039a3,1209b5134401ca53,2006-09-23,1,0,0,317,0,0,34,8,26,8,2,2,6,4,0,0,26,4,54.2,222.0
12816,87c07416af211de1,5be86bb2f78fef2f,ee779c43a8926d52,2006-09-23,0,3,0,442,2,0,18,1,18,0,0,0,0,0,6,5,12,1,0.0,147.5
12817,87c07416af211de1,ee779c43a8926d52,5be86bb2f78fef2f,2006-09-23,1,0,0,442,8,8,44,18,13,31,8,6,23,14,1,1,12,4,263.5,119.0
12818,67a3b8dc3c0c3e45,daf1b84aebd6602b,fa8b9e6b0c2269f8,2006-09-23,0,0,0,900,9,6,174,56,106,68,8,4,60,31,14,11,92,25,526.2,245.3
12819,67a3b8dc3c0c3e45,fa8b9e6b0c2269f8,daf1b84aebd6602b,2006-09-23,0,3,0,900,0,0,80,27,75,5,1,1,4,3,15,10,60,24,4.7,358.79999999999995
12820,38231925d72d1309,04d5718ed2661e8c,15df64c02b6b0fde,2006-09-23,0,1,0,900,7,1,159,49,146,13,0,0,13,2,10,9,136,47,51.6,758.7
12821,38231925d72d1309,15df64c02b6b0fde,04d5718ed2661e8c,2006-09-23,0,0,0,900,0,0,146,49,142,4,0,0,4,3,9,7,133,46,18.3,738.4
12822,28a8c644c87ce45e,ccba80d4820ef557,ccd1299e0345e0ce,2006-09-23,0,0,0,361,12,2,23,5,18,5,0,0,5,4,3,2,15,1,64.0,172.4
12823,28a8c644c87ce45e,ccd1299e0345e0ce,ccba80d4820ef557,2006-09-23,2,0,0,361,3,3,40,15,24,16,2,1,14,8,4,4,20,7,60.6,225.0
12824,16dcd55681f990c0,20205040232ed0f3,8caca5857ce0e30b,2006-09-23,0,1,1,110,1,1,1,0,1,0,0,0,0,0,0,0,1,0,0.0,15.0
12825,16dcd55681f990c0,8caca5857ce0e30b,20205040232ed0f3,2006-09-23,0,0,0,110,0,0,2,1,2,0,0,0,0,0,0,0,2,1,0.0,110.0
12826,07c3ec83596e9798,22e47b53e4ceb27c,9fe85152f351e737,2006-09-23,0,0,0,900,1,1,68,21,62,6,0,0,6,5,21,15,41,16,34.7,708.1
12827,07c3ec83596e9798,9fe85152f351e737,22e47b53e4ceb27c,2006-09-23,0,0,0,900,7,3,93,12,90,3,0,0,3,2,27,20,63,10,29.9,656.3
12828,ec916b9f67175633,a390eb8a9b2df298,d468288756ae3982,2006-08-26,2,0,0,95,0,0,25,15,12,13,0,0,13,9,3,2,9,6,25.0,70.0
12829,ec916b9f67175633,d468288756ae3982,a390eb8a9b2df298,2006-08-26,0,0,0,95,0,0,9,0,9,0,0,0,0,0,2,1,7,0,0.0,70.0
12830,eb5fd91dd3d937db,f3388d2cf7ab3f64,f59f1d3a2ff13edd,2006-08-26,0,0,0,146,1,0,4,1,4,0,0,0,0,0,1,1,3,1,0.0,86.7
12831,eb5fd91dd3d937db,f59f1d3a2ff13edd,f3388d2cf7ab3f64,2006-08-26,0,2,1,146,0,0,10,2,8,2,0,0,2,2,6,5,2,0,59.3,57.0
12832,d40bfa821f2fe46a,a54fc2d6fc224dc3,e0ec3c3b6b611f7e,2006-08-26,0,0,0,811,15,9,106,14,40,66,3,3,63,13,2,1,38,1,411.3,350.3
12833,d40bfa821f2fe46a,e0ec3c3b6b611f7e,a54fc2d6fc224dc3,2006-08-26,0,3,1,811,2,1,46,13,38,8,0,0,8,2,9,9,29,11,30.7,330.7
12834,cd6070783f11619b,d1a1314976c50bef,f57a8a52ca401ed9,2006-08-26,0,0,0,702,2,0,62,15,62,0,0,0,0,0,10,10,52,15,0.0,622.8
12835,cd6070783f11619b,f57a8a52ca401ed9,d1a1314976c50bef,2006-08-26,0,1,1,702,5,3,199,49,194,5,0,0,5,1,35,26,159,48,9.2,581.0
12836,c151729e47d9122b,c6a33ff198aaaeeb,fcffee71cff5530e,2006-08-26,0,0,0,900,0,0,159,32,159,0,0,0,0,0,18,9,141,32,0.0,900.0
12837,c151729e47d9122b,fcffee71cff5530e,c6a33ff198aaaeeb,2006-08-26,0,0,0,900,0,0,207,50,207,0,0,0,0,0,50,33,157,50,0.0,883.0
12838,7c7177a028d55964,a85998eb79650b2c,af5b208e97f5d382,2006-08-26,0,0,0,203,0,0,17,0,17,0,0,0,0,0,11,10,6,0,0.0,132.0
12839,7c7177a028d55964,af5b208e97f5d382,a85998eb79650b2c,2006-08-26,0,1,1,203,1,1,20,5,19,1,0,0,1,1,6,4,13,4,71.0,132.0
12840,5ed402ad08d9d4f9,4130a743d9d22163,acff437707625fc7,2006-08-26,0,0,0,900,1,0,55,5,55,0,0,0,0,0,7,3,48,5,0.0,415.0
12841,5ed402ad08d9d4f9,acff437707625fc7,4130a743d9d22163,2006-08-26,0,0,0,900,9,5,47,9,38,9,1,1,8,4,2,2,36,5,385.0,515.0
12842,2de0acc04cba91d3,1eacf73d6a0055dc,f1b2a4365799c48b,2006-08-26,1,0,0,171,0,0,22,12,22,0,0,0,0,0,5,5,17,12,0.0,50.0
12843,2de0acc04cba91d3,f1b2a4365799c48b,1eacf73d6a0055dc,2006-08-26,0,1,0,171,4,1,5,0,4,1,0,0,1,0,0,0,4,0,43.0,128.0
12844,14b61d9b3f6ddd37,4f95f74620a6b7a4,83c6c3e0f8bde8ee,2006-08-26,0,3,1,152,1,1,6,3,0,6,0,0,6,3,0,0,0,0,140.0,12.0
12845,14b61d9b3f6ddd37,83c6c3e0f8bde8ee,4f95f74620a6b7a4,2006-08-26,0,0,0,152,0,0,2,1,2,0,0,0,0,0,1,1,1,1,0.0,10.0
12846,fa2be4b37de934bf,2067a177a2842fbf,e86bc32f5997a8f7,2006-08-17,0,1,0,900,7,0,44,3,44,0,0,0,0,0,6,5,38,3,0.0,603.3
12847,fa2be4b37de934bf,e86bc32f5997a8f7,2067a177a2842fbf,2006-08-17,5,0,0,900,6,6,83,27,59,24,0,0,24,14,19,18,40,13,296.7,455.0
12848,d14abced904806ca,68c6cd5287b473a7,e5c38954c006f15c,2006-08-17,0,2,0,900,17,5,51,19,41,10,1,1,9,7,6,4,35,12,183.2,552.0
12849,d14abced904806ca,e5c38954c006f15c,68c6cd5287b473a7,2006-08-17,0,0,0,900,0,0,66,19,66,0,0,0,0,0,9,7,57,19,0.0,439.8
12850,9450f80c9fab4da1,dd37fd509af89f15,fb1538b46877a695,2006-08-17,1,1,0,250,1,1,30,22,6,24,0,0,24,20,1,1,5,2,217.0,33.0
12851,9450f80c9fab4da1,fb1538b46877a695,dd37fd509af89f15,2006-08-17,0,0,0,250,1,0,2,0,2,0,0,0,0,0,1,1,1,0,0.0,33.0
12852,8e51f8648840eb38,c4b9296214f4c09c,d512d9f204059f57,2006-08-17,0,0,0,121,0,0,2,0,2,0,0,0,0,0,0,0,2,0,0.0,81.0
12853,8e51f8648840eb38,d512d9f204059f57,c4b9296214f4c09c,2006-08-17,0,1,1,121,1,1,4,1,4,0,0,0,0,0,0,0,4,1,0.0,84.0
12854,8b07bdaa0402bf2b,349aaa3da11eb587,82e7929bf6c2b689,2006-08-17,0,0,0,900,10,9,92,36,68,24,0,0,24,9,0,0,68,27,180.7,427.4
12855,8b07bdaa0402bf2b,82e7929bf6c2b689,349aaa3da11eb587,2006-08-17,0,1,0,900,3,3,108,36,67,41,9,8,32,24,22,22,45,12,201.6,424.3
12856,8304a0ea004e73f5,d43a048a880efdff,f8dc544e7077d014,2006-08-17,1,0,0,335,2,1,22,6,14,8,1,0,7,3,5,3,9,3,83.7,129.0
12857,8304a0ea004e73f5,f8dc544e7077d014,d43a048a880efdff,2006-08-17,0,0,0,335,1,1,12,5,10,2,0,0,2,1,2,1,8,4,70.0,181.3
12858,2f4baf8f94c400cd,20bcc9966affb19c,5b5b9c6f6f270369,2006-08-17,1,0,0,352,3,3,52,25,3,49,0,0,49,25,0,0,3,0,284.0,68.0
12859,2f4baf8f94c400cd,5b5b9c6f6f270369,20bcc9966affb19c,2006-08-17,0,0,0,352,0,0,10,2,10,0,0,0,0,0,0,0,10,2,0.0,68.0
12860,1c9798288310201c,8b69839f3555a67b,bf41b5131545da12,2006-08-17,0,1,1,179,1,1,26,19,8,18,0,0,18,15,0,0,8,4,135.0,29.0
12861,1c9798288310201c,bf41b5131545da12,8b69839f3555a67b,2006-08-17,0,0,0,179,0,0,9,0,9,0,0,0,0,0,2,1,7,0,0.0,44.0
12862,0c96a5a8ab740ca8,50d2f0018bcf9eef,918d9d89d4d52acc,2006-08-17,0,0,0,157,1,0,26,8,26,0,0,0,0,0,5,5,21,8,0.0,119.7
12863,0c96a5a8ab740ca8,918d9d89d4d52acc,50d2f0018bcf9eef,2006-08-17,0,1,1,157,0,0,23,10,20,3,0,0,3,3,1,1,19,7,22.3,90.0
12864,ee6000812e2b9f9d,2f732dd9210d301f,63b65af1c5cb02cb,2006-07-08,1,0,0,78,3,1,11,10,3,8,0,0,8,8,1,1,2,2,46.5,14.0
12865,ee6000812e2b9f9d,63b65af1c5cb02cb,2f732dd9210d301f,2006-07-08,0,0,0,78,0,0,3,0,3,0,0,0,0,0,0,0,3,0,0.0,27.5
12866,e3b5f66198161226,1eacf73d6a0055dc,d26934530dc5b248,2006-07-08,1,0,0,253,1,1,28,15,24,4,0,0,4,3,9,9,15,12,4.6,48.0
12867,e3b5f66198161226,d26934530dc5b248,1eacf73d6a0055dc,2006-07-08,0,0,0,253,3,2,8,5,0,8,1,1,7,5,0,0,0,0,175.0,73.4
12868,bc7a81a81840e4be,4b4753d19489297f,cbfd1d34356a004c,2006-07-08,0,0,0,162,0,0,17,3,17,0,0,0,0,0,5,5,12,3,0.0,126.8
12869,bc7a81a81840e4be,cbfd1d34356a004c,4b4753d19489297f,2006-07-08,1,0,0,162,2,0,26,14,17,9,2,2,7,6,2,2,15,8,26.2,98.0
12870,9ce2d0b880e88934,1ff9589f9065a9ed,b369533a577fa97c,2006-07-08,0,0,0,900,6,3,89,19,40,49,11,9,38,12,25,25,15,7,308.4,398.5
12871,9ce2d0b880e88934,b369533a577fa97c,1ff9589f9065a9ed,2006-07-08,0,1,0,900,0,0,85,26,79,6,3,3,3,3,23,19,56,23,29.5,399.6
12872,979318b05efd1ea4,aa1952ec0b3dd8e1,d814f5192e58fb2f,2006-07-08,0,0,0,680,9,5,47,13,30,17,7,7,10,6,7,5,23,7,264.1,221.0
12873,979318b05efd1ea4,d814f5192e58fb2f,aa1952ec0b3dd8e1,2006-07-08,0,2,1,680,1,1,35,11,27,8,0,0,8,6,7,7,20,5,24.0,379.9
12874,4000e1f32058796a,5f04e3d58d9ce982,79899ecf62020f6d,2006-07-08,1,2,0,600,0,0,52,13,46,6,0,0,6,2,6,5,40,11,34.3,236.60000000000002
12875,4000e1f32058796a,79899ecf62020f6d,5f04e3d58d9ce982,2006-07-08,1,1,0,600,6,3,57,27,18,39,0,0,39,24,2,1,16,3,323.4,225.7
12876,3c3533ba486a2006,2a542ee8a8b83559,3738e68d2261e60f,2006-07-08,0,0,0,1500,0,0,263,68,263,0,0,0,0,0,33,29,230,68,0.0,1455.0
12877,3c3533ba486a2006,3738e68d2261e60f,2a542ee8a8b83559,2006-07-08,0,0,0,1500,1,0,327,39,327,0,0,0,0,0,36,27,291,39,0.0,1500.0
12878,000da3152b7b5ab1,6da99156486ed6c2,d1a1314976c50bef,2006-07-08,1,0,0,900,7,4,88,22,78,10,2,1,8,4,14,12,64,18,106.6,400.0
12879,000da3152b7b5ab1,d1a1314976c50bef,6da99156486ed6c2,2006-07-08,0,1,0,900,3,1,39,17,30,9,0,0,9,7,3,2,27,10,95.0,603.4
12880,e7225dcc3349ae57,04d5718ed2661e8c,0a97691039c4bbfb,2006-06-28,0,0,0,900,5,0,211,14,211,0,0,0,0,0,33,22,178,14,0.0,900.0
12881,e7225dcc3349ae57,0a97691039c4bbfb,04d5718ed2661e8c,2006-06-28,0,0,0,900,0,0,158,26,158,0,0,0,0,0,23,17,135,26,0.0,888.0
12882,e22b2f50d7eeed3a,c6a33ff198aaaeeb,ee779c43a8926d52,2006-06-28,0,2,0,900,0,0,36,7,34,2,0,0,2,2,8,5,26,5,1.3,267.20000000000005
12883,e22b2f50d7eeed3a,ee779c43a8926d52,c6a33ff198aaaeeb,2006-06-28,0,0,0,900,12,7,37,12,13,24,3,3,21,10,2,2,11,2,628.8,243.7
12884,ccdd6c7577927a8c,1f454354805b6f75,d43a048a880efdff,2006-06-28,2,0,0,49,0,0,20,17,15,5,0,0,5,3,0,0,15,14,7.5,40.0
12885,ccdd6c7577927a8c,d43a048a880efdff,1f454354805b6f75,2006-06-28,0,0,0,49,0,0,8,1,8,0,0,0,0,0,0,0,8,1,0.0,41.5
12886,c4f05ff2781530f4,93ce4ac89e3d7652,fb1538b46877a695,2006-06-28,2,3,0,900,0,0,21,9,15,6,0,0,6,3,4,4,11,6,57.5,92.0
12887,c4f05ff2781530f4,fb1538b46877a695,93ce4ac89e3d7652,2006-06-28,0,0,0,900,9,6,34,14,5,29,2,2,27,14,4,2,1,0,693.0,149.5
12888,b0ba95fd1503411f,06f0ffa6446c5b6d,5be86bb2f78fef2f,2006-06-28,0,0,0,300,5,3,6,0,6,0,0,0,0,0,5,4,1,0,0.0,40.80000000000001
12889,b0ba95fd1503411f,5be86bb2f78fef2f,06f0ffa6446c5b6d,2006-06-28,1,1,0,300,0,0,59,31,9,50,9,8,41,28,5,5,4,3,160.2,111.0
12890,919c86cce0eca615,8c3f3c43c8ceb778,f8dc544e7077d014,2006-06-28,0,0,0,133,1,0,6,0,6,0,0,0,0,0,1,0,5,0,0.0,69.2
12891,919c86cce0eca615,f8dc544e7077d014,8c3f3c43c8ceb778,2006-06-28,1,0,0,133,1,1,15,8,5,10,0,0,10,5,1,1,4,3,53.8,63.0
12892,4f1a8eade87e928e,275cafc9de131c83,dd37fd509af89f15,2006-06-28,0,5,0,900,1,1,34,4,32,2,0,0,2,1,14,9,18,3,12.0,205.60000000000002
12893,4f1a8eade87e928e,dd37fd509af89f15,275cafc9de131c83,2006-06-28,0,1,0,900,7,4,68,29,19,49,15,13,34,26,3,3,16,3,664.4,210.0
12894,282d8651ca34b7f6,af49a6c491ca22a3,f3388d2cf7ab3f64,2006-06-28,0,0,0,241,3,0,6,1,6,0,0,0,0,0,3,2,3,1,0.0,73.0
12895,282d8651ca34b7f6,f3388d2cf7ab3f64,af49a6c491ca22a3,2006-06-28,0,3,1,241,4,4,17,9,4,13,1,1,12,8,0,0,4,1,168.0,73.0
12896,16de071ad45cd350,31ee470ef5dc8d7f,6f018c039b4d5d80,2006-06-28,0,3,0,577,1,1,1,0,1,0,0,0,0,0,1,1,0,0,0.0,77.39999999999998
12897,16de071ad45cd350,6f018c039b4d5d80,31ee470ef5dc8d7f,2006-06-28,1,2,0,577,4,3,72,43,10,62,5,4,57,39,4,4,6,4,472.6,51.0
12898,b48a211abe177846,2b93ebd9f5417ad2,6ef58dabef8beb15,2006-06-24,2,4,0,554,5,4,61,25,43,18,2,2,16,11,16,14,27,14,134.6,214.4
12899,b48a211abe177846,6ef58dabef8beb15,2b93ebd9f5417ad2,2006-06-24,0,0,0,554,1,0,22,5,20,2,0,0,2,0,3,3,17,5,10.6,366.4
12900,7cdb56b2f207a41b,501b07aec9b8fc2d,cb139171ed1b69fe,2006-06-24,0,0,0,106,0,0,4,0,4,0,0,0,0,0,0,0,4,0,0.0,9.0
12901,7cdb56b2f207a41b,cb139171ed1b69fe,501b07aec9b8fc2d,2006-06-24,0,1,1,106,2,1,8,5,0,8,0,0,8,5,0,0,0,0,97.0,9.0
12902,5bfba809430d178b,155bfc7ed36622df,9583662df31d943f,2006-06-24,0,0,0,255,1,1,28,5,28,0,0,0,0,0,10,6,18,5,0.0,151.1
12903,5bfba809430d178b,9583662df31d943f,155bfc7ed36622df,2006-06-24,1,0,0,255,1,1,31,7,29,2,0,0,2,2,9,4,20,5,4.9,208.0
12904,4df8efe64e83f74e,546015aa2ad945fd,7215953cd5c6254d,2006-06-24,0,1,1,44,0,0,4,1,4,0,0,0,0,0,1,1,3,1,0.0,24.0
12905,4df8efe64e83f74e,7215953cd5c6254d,546015aa2ad945fd,2006-06-24,1,0,0,44,0,0,20,4,18,2,0,0,2,0,1,0,17,4,20.0,24.0
12906,43e5f75fe9cedafd,330ec26453c44a59,a85998eb79650b2c,2006-06-24,0,1,1,190,3,3,37,12,18,19,3,2,16,11,11,8,7,1,89.8,34.0
12907,43e5f75fe9cedafd,a85998eb79650b2c,330ec26453c44a59,2006-06-24,0,0,0,190,0,0,12,3,12,0,0,0,0,0,3,1,9,3,0.0,99.2
12908,387bdcc2ca8709c1,15df64c02b6b0fde,c8136ab8aa32c974,2006-06-24,0,0,0,176,0,0,9,2,9,0,0,0,0,0,1,1,8,2,0.0,96.0
12909,387bdcc2ca8709c1,c8136ab8aa32c974,15df64c02b6b0fde,2006-06-24,0,1,1,176,2,1,29,10,10,19,5,5,14,9,7,6,3,1,80.0,75.0
12910,2b95f2982b19518a,06f36cf4bd97ec77,234f3767ff0e5701,2006-06-24,0,2,0,900,10,5,57,20,16,41,12,11,29,17,3,2,13,3,545.1,216.3
12911,2b95f2982b19518a,234f3767ff0e5701,06f36cf4bd97ec77,2006-06-24,0,6,0,900,0,0,39,12,26,13,3,2,10,7,11,11,15,5,98.7,149.89999999999998
12912,2168b2c814faada6,af5b208e97f5d382,b9d0fd83bb8a147a,2006-06-24,0,0,0,900,2,1,115,21,113,2,0,0,2,2,30,27,83,19,11.6,848.4
12913,2168b2c814faada6,b9d0fd83bb8a147a,af5b208e97f5d382,2006-06-24,0,0,0,900,1,1,205,41,192,13,2,1,11,4,28,25,164,37,22.6,855.4
12914,20e28ee267d9b5dc,947eccadb72f4f6f,98b80a717b9bda17,2006-06-24,0,0,0,287,0,0,21,4,21,0,0,0,0,0,6,5,15,4,0.0,222.8
12915,20e28ee267d9b5dc,98b80a717b9bda17,947eccadb72f4f6f,2006-06-24,1,0,0,287,1,1,48,30,37,11,0,0,11,8,3,3,34,22,64.2,112.0
12916,d490c78bd5d0145a,7a15f3694c5cbc02,82e7929bf6c2b689,2006-05-27,0,1,0,900,0,0,57,15,57,0,0,0,0,0,3,2,54,15,0.0,900.0
12917,d490c78bd5d0145a,82e7929bf6c2b689,7a15f3694c5cbc02,2006-05-27,0,0,0,900,16,1,67,8,67,0,0,0,0,0,5,1,62,8,0.0,638.0
12918,d1b8ff290d09013b,48d1f690b763934c,8d26912cd2aeb366,2006-05-27,0,0,0,377,3,3,18,5,2,16,1,1,15,4,0,0,2,1,347.0,30.0
12919,d1b8ff290d09013b,8d26912cd2aeb366,48d1f690b763934c,2006-05-27,0,4,1,377,0,0,5,3,3,2,0,0,2,2,0,0,3,1,0.0,30.0
12920,c66bd50ed1e75d2b,e091482fa6648261,fa315e6c77eee106,2006-05-27,0,0,0,159,1,1,17,1,15,2,2,2,0,0,6,6,9,1,23.3,124.0
12921,c66bd50ed1e75d2b,fa315e6c77eee106,e091482fa6648261,2006-05-27,0,1,1,159,0,0,29,3,29,0,0,0,0,0,10,5,19,3,0.0,135.7
12922,c409c3a5eda764ba,9fe85152f351e737,d512d9f204059f57,2006-05-27,0,1,1,139,0,0,12,1,12,0,0,0,0,0,5,4,7,1,0.0,129.0
12923,c409c3a5eda764ba,d512d9f204059f57,9fe85152f351e737,2006-05-27,0,0,0,139,2,0,4,0,4,0,0,0,0,0,1,1,3,0,0.0,112.0
12924,857365273ed2f353,eb29176b03dfa888,f34312c2ccfa0e00,2006-05-27,0,4,0,403,4,1,19,7,13,6,0,0,6,5,5,3,8,2,111.3,155.7
12925,857365273ed2f353,f34312c2ccfa0e00,eb29176b03dfa888,2006-05-27,1,0,0,403,0,0,39,10,28,11,3,2,8,5,16,15,12,5,43.3,173.7
12926,3df422ea531e16c6,0bc7e61d204f2137,270b89c00ef0c55c,2006-05-27,0,0,0,324,1,0,25,6,24,1,0,0,1,0,5,2,19,6,3.5,195.0
12927,3df422ea531e16c6,270b89c00ef0c55c,0bc7e61d204f2137,2006-05-27,1,0,0,324,4,3,30,11,23,7,1,1,6,3,4,4,19,8,91.0,177.5
12928,356fdab9bc109093,68c6cd5287b473a7,7f955f71fa2ce7ac,2006-05-27,0,2,1,140,1,0,2,1,2,0,0,0,0,0,0,0,2,1,0.0,140.0
12929,356fdab9bc109093,7f955f71fa2ce7ac,68c6cd5287b473a7,2006-05-27,0,0,0,140,0,0,3,1,3,0,0,0,0,0,0,0,3,1,0.0,30.0
12930,25acf5f94667e79d,2549d63da9c456cb,ccd1299e0345e0ce,2006-05-27,0,0,0,97,0,0,10,2,10,0,0,0,0,0,7,3,3,2,0.0,97.0
12931,25acf5f94667e79d,ccd1299e0345e0ce,2549d63da9c456cb,2006-05-27,1,0,0,97,0,0,28,7,28,0,0,0,0,0,4,3,24,7,0.0,95.0
12932,fef433a7cb7a2029,029880cdbf5ca089,f57a8a52ca401ed9,2006-04-15,0,0,0,900,19,2,155,30,155,0,0,0,0,0,9,9,146,30,0.0,664.7
12933,fef433a7cb7a2029,f57a8a52ca401ed9,029880cdbf5ca089,2006-04-15,0,3,0,900,1,1,136,47,134,2,0,0,2,1,11,10,123,46,8.3,817.0
12934,fdafa20b7ec8cb44,3410cf010558dc8b,4123fd4dcc1fe937,2006-04-15,0,0,0,188,0,0,6,1,3,3,1,0,2,1,2,2,1,0,83.0,57.3
12935,fdafa20b7ec8cb44,4123fd4dcc1fe937,3410cf010558dc8b,2006-04-15,0,2,1,188,4,1,14,6,7,7,0,0,7,5,5,4,2,1,47.7,30.0
12936,fb972da69450127f,6aa1cbc1466e9a0b,cbfd1d34356a004c,2006-04-15,0,0,0,900,5,0,106,14,106,0,0,0,0,0,27,26,79,14,0.0,655.3
12937,fb972da69450127f,cbfd1d34356a004c,6aa1cbc1466e9a0b,2006-04-15,0,0,0,900,2,2,110,16,100,10,4,4,6,2,13,12,87,14,175.7,531.0
12938,f747fbe721cdb042,8c3f3c43c8ceb778,8f2d9ee27f206f1f,2006-04-15,0,1,0,194,0,0,4,0,4,0,0,0,0,0,3,2,1,0,0.0,100.8
12939,f747fbe721cdb042,8f2d9ee27f206f1f,8c3f3c43c8ceb778,2006-04-15,0,2,1,194,2,1,17,6,8,9,0,0,9,6,6,4,2,0,74.2,62.0
12940,5f9b063630e52778,2f732dd9210d301f,fcffee71cff5530e,2006-04-15,0,0,0,900,12,3,125,57,77,48,1,1,47,25,3,3,74,32,301.0,599.0
12941,5f9b063630e52778,fcffee71cff5530e,2f732dd9210d301f,2006-04-15,0,0,0,900,0,0,170,52,170,0,0,0,0,0,12,6,158,52,0.0,585.0
12942,57a7767c4255e034,2a542ee8a8b83559,3738e68d2261e60f,2006-04-15,1,0,0,163,0,0,30,13,24,6,0,0,6,6,0,0,24,7,4.0,159.0
12943,57a7767c4255e034,3738e68d2261e60f,2a542ee8a8b83559,2006-04-15,1,0,0,163,0,0,24,7,24,0,0,0,0,0,6,4,18,7,0.0,152.0
12944,3fe41b95899316d5,5be86bb2f78fef2f,6a92caba39b64752,2006-04-15,1,0,0,457,2,0,39,16,24,15,4,4,11,10,11,11,13,6,75.9,233.4
12945,3fe41b95899316d5,6a92caba39b64752,5be86bb2f78fef2f,2006-04-15,0,0,0,457,4,1,26,6,21,5,3,3,2,1,6,6,15,5,56.6,166.1
12946,12231c1ca2e09011,21321cdfba797c52,31ee470ef5dc8d7f,2006-04-15,0,0,0,174,0,0,45,10,45,0,0,0,0,0,11,8,34,10,0.0,132.0
12947,12231c1ca2e09011,31ee470ef5dc8d7f,21321cdfba797c52,2006-04-15,1,0,0,174,0,0,27,5,25,2,0,0,2,2,10,6,15,3,3.0,162.0
12948,0a083ab881ef3a5f,349aaa3da11eb587,7d3caf0f96f1b33d,2006-04-15,1,0,0,284,3,2,30,16,2,28,2,2,26,15,0,0,2,1,243.0,37.0
12949,0a083ab881ef3a5f,7d3caf0f96f1b33d,349aaa3da11eb587,2006-04-15,0,0,0,284,1,1,7,1,5,2,0,0,2,0,1,1,4,1,4.0,31.0
12950,fb1f1b0c9ef454dc,4908c5ee68a50ee5,b369533a577fa97c,2006-04-06,0,0,0,817,2,2,157,48,133,24,0,0,24,11,14,10,119,37,87.2,588.5
12951,fb1f1b0c9ef454dc,b369533a577fa97c,4908c5ee68a50ee5,2006-04-06,0,1,1,817,0,0,148,39,145,3,0,0,3,1,38,34,107,38,10.5,621.8
12952,fa193b3d07c0ed9b,48d1f690b763934c,f5ff7bcdcfeba3ad,2006-04-06,0,0,0,900,17,7,59,17,20,39,7,3,32,14,5,5,15,3,537.9,196.0
12953,fa193b3d07c0ed9b,f5ff7bcdcfeba3ad,48d1f690b763934c,2006-04-06,0,2,0,900,2,0,22,5,19,3,0,0,3,1,2,2,17,4,42.0,292.1
12954,eeb77732d7c3389a,6da99156486ed6c2,6f018c039b4d5d80,2006-04-06,0,1,0,597,3,1,35,3,35,0,0,0,0,0,18,17,17,3,0.0,267.0
12955,eeb77732d7c3389a,6f018c039b4d5d80,6da99156486ed6c2,2006-04-06,1,1,1,597,4,3,50,18,32,18,2,1,16,8,7,6,25,10,156.0,285.0
12956,d39ce3ecd3fbdadf,b9d0fd83bb8a147a,c6a33ff198aaaeeb,2006-04-06,0,0,0,900,1,0,118,34,118,0,0,0,0,0,37,30,81,34,0.0,872.0
12957,d39ce3ecd3fbdadf,c6a33ff198aaaeeb,b9d0fd83bb8a147a,2006-04-06,1,1,0,900,6,1,93,20,93,0,0,0,0,0,16,13,77,20,0.0,666.0
12958,d066287b31c871a6,79899ecf62020f6d,d1a1314976c50bef,2006-04-06,0,3,0,900,2,2,56,17,40,16,0,0,16,8,19,14,21,9,119.3,280.7
12959,d066287b31c871a6,d1a1314976c50bef,79899ecf62020f6d,2006-04-06,1,0,0,900,0,0,126,46,60,66,0,0,66,33,0,0,60,13,455.3,304.7
12960,99eb03e6c7dc4be2,84a067c46306a737,ee779c43a8926d52,2006-04-06,0,2,0,900,1,0,72,8,72,0,0,0,0,0,18,10,54,8,0.0,736.1
12961,99eb03e6c7dc4be2,ee779c43a8926d52,84a067c46306a737,2006-04-06,0,0,0,900,11,9,72,19,68,4,1,0,3,1,4,4,64,18,160.9,337.0
12962,622cada31f247f9a,7342fcc41a4817fa,dd37fd509af89f15,2006-04-06,0,1,0,209,0,0,4,2,4,0,0,0,0,0,0,0,4,2,0.0,36.0
12963,622cada31f247f9a,dd37fd509af89f15,7342fcc41a4817fa,2006-04-06,0,1,1,209,2,2,11,2,8,3,0,0,3,2,2,0,6,0,165.0,44.0
12964,44a79a250fdd61cd,9583662df31d943f,d43a048a880efdff,2006-04-06,0,0,0,900,5,0,39,9,39,0,0,0,0,0,12,11,27,9,0.0,606.3
12965,44a79a250fdd61cd,d43a048a880efdff,9583662df31d943f,2006-04-06,0,0,0,900,7,5,90,26,68,22,0,0,22,12,22,10,46,14,172.7,327.0
12966,3adae93bbf06287a,93ce4ac89e3d7652,c4b9296214f4c09c,2006-04-06,0,3,0,900,4,3,108,18,94,14,0,0,14,8,35,25,59,10,87.9,619.7
12967,3adae93bbf06287a,c4b9296214f4c09c,93ce4ac89e3d7652,2006-04-06,0,1,0,900,9,2,57,9,55,2,0,0,2,0,11,8,44,9,35.3,565.1
12968,f989a1acbda0e16a,6888e31ce88f5b17,9fe85152f351e737,2006-03-04,0,0,0,129,1,0,13,1,13,0,0,0,0,0,6,5,7,1,0.0,116.0
12969,f989a1acbda0e16a,9fe85152f351e737,6888e31ce88f5b17,2006-03-04,0,1,1,129,0,0,22,4,22,0,0,0,0,0,10,9,12,4,0.0,80.0
12970,82a5e1bba6b843be,49efbdc6c9f650c4,62918a2118de08b2,2006-03-04,0,0,0,719,0,0,13,1,13,0,0,0,0,0,2,1,11,1,0.0,318.4
12971,82a5e1bba6b843be,62918a2118de08b2,49efbdc6c9f650c4,2006-03-04,1,2,0,719,7,6,42,30,11,31,0,0,31,26,0,0,11,4,400.6,228.0
12972,817c3b44517daa91,6506c1d34da9c013,73c7cfa551289285,2006-03-04,0,0,0,900,5,4,135,38,126,9,0,0,9,6,33,21,93,32,148.3,455.0
12973,817c3b44517daa91,73c7cfa551289285,6506c1d34da9c013,2006-03-04,0,1,0,900,1,1,85,28,85,0,0,0,0,0,9,9,76,28,0.0,733.7
12974,7ca8095148c23b71,5be86bb2f78fef2f,f3388d2cf7ab3f64,2006-03-04,1,1,1,114,2,1,16,5,14,2,0,0,2,1,2,2,12,4,13.3,54.0
12975,7ca8095148c23b71,f3388d2cf7ab3f64,5be86bb2f78fef2f,2006-03-04,0,0,0,114,0,0,9,3,9,0,0,0,0,0,0,0,9,3,0.0,80.7
12976,7ba640f8b70bc685,501b07aec9b8fc2d,f34312c2ccfa0e00,2006-03-04,0,0,0,900,0,0,183,38,177,6,0,0,6,3,31,24,146,35,10.3,726.7
12977,7ba640f8b70bc685,f34312c2ccfa0e00,501b07aec9b8fc2d,2006-03-04,0,3,0,900,9,4,148,31,134,14,2,2,12,3,30,20,104,28,113.3,630.7
12978,0cc225bf45697271,0a97691039c4bbfb,5f04e3d58d9ce982,2006-03-04,0,1,1,412,0,0,58,13,58,0,0,0,0,0,9,9,49,13,0.0,390.0
12979,0cc225bf45697271,5f04e3d58d9ce982,0a97691039c4bbfb,2006-03-04,0,0,0,412,2,1,74,10,74,0,0,0,0,0,11,10,63,10,0.0,342.0
12980,00dc5354794818a7,a8e6a69796280f17,dbaaf42313af90fa,2006-03-04,0,2,0,900,5,5,103,36,94,9,0,0,9,7,23,20,71,29,173.6,430.7
12981,00dc5354794818a7,dbaaf42313af90fa,a8e6a69796280f17,2006-03-04,1,0,0,900,8,2,80,19,73,7,1,0,6,3,9,7,64,16,64.3,625.4
12982,002cb1bb411c5f60,22e47b53e4ceb27c,d897897060f10a3a,2006-03-04,1,0,0,1500,1,1,72,11,72,0,0,0,0,0,15,10,57,11,0.0,1298.3
12983,002cb1bb411c5f60,d897897060f10a3a,22e47b53e4ceb27c,2006-03-04,2,0,0,1500,6,5,244,82,218,26,9,9,17,12,45,36,173,70,186.7,983.0
12984,d9499d55f9f53112,d512d9f204059f57,f57a8a52ca401ed9,2006-02-04,0,0,0,900,8,3,116,42,110,6,0,0,6,2,11,9,99,40,16.3,753.7
12985,d9499d55f9f53112,f57a8a52ca401ed9,d512d9f204059f57,2006-02-04,1,1,0,900,7,0,106,23,102,4,1,1,3,1,23,14,79,22,21.3,681.7
12986,d49bc8e4e5613614,06f0ffa6446c5b6d,cbfd1d34356a004c,2006-02-04,0,1,0,275,0,0,8,3,5,3,2,2,1,1,0,0,5,2,43.8,86.8
12987,d49bc8e4e5613614,cbfd1d34356a004c,06f0ffa6446c5b6d,2006-02-04,0,1,1,275,3,1,11,3,4,7,6,6,1,1,1,1,3,2,115.2,50.2
12988,bb5ceaf835c0bb18,d26934530dc5b248,f0abbb6f3444dae7,2006-02-04,0,0,0,447,2,0,54,19,50,4,0,0,4,3,11,9,39,16,10.8,325.2
12989,bb5ceaf835c0bb18,f0abbb6f3444dae7,d26934530dc5b248,2006-02-04,1,1,0,447,2,1,71,33,65,6,1,1,5,5,17,15,48,28,13.8,319.2
12990,a63ed5d48f00ad18,22d1e00e1aabb7c9,b9d0fd83bb8a147a,2006-02-04,0,0,0,900,12,5,73,15,70,3,2,2,1,0,13,10,57,15,114.9,517.0
12991,a63ed5d48f00ad18,b9d0fd83bb8a147a,22d1e00e1aabb7c9,2006-02-04,0,0,0,900,0,0,131,35,131,0,0,0,0,0,11,9,120,35,0.0,785.1
12992,44592a74cda71275,1ff9589f9065a9ed,6aa1cbc1466e9a0b,2006-02-04,0,0,0,250,1,1,6,0,5,1,1,1,0,0,2,2,3,0,5.0,18.0
12993,44592a74cda71275,6aa1cbc1466e9a0b,1ff9589f9065a9ed,2006-02-04,1,0,0,250,2,1,44,22,6,38,8,8,30,22,1,1,5,0,217.0,28.0
12994,357f438c15e1326f,2ee09ec2a0695eb9,d468288756ae3982,2006-02-04,0,0,0,141,1,0,4,1,4,0,0,0,0,0,0,0,4,1,0.0,105.7
12995,357f438c15e1326f,d468288756ae3982,2ee09ec2a0695eb9,2006-02-04,0,1,1,141,1,0,12,1,10,2,0,0,2,1,9,8,1,0,21.3,45.0
12996,235e4c69d5d945e8,27fc9218a3653e3c,fa315e6c77eee106,2006-02-04,0,0,0,85,0,0,7,0,7,0,0,0,0,0,4,4,3,0,0.0,46.3
12997,235e4c69d5d945e8,fa315e6c77eee106,27fc9218a3653e3c,2006-02-04,1,0,0,85,0,0,10,3,9,1,0,0,1,1,6,4,3,2,3.7,74.0
12998,14850f48b2bede47,7f955f71fa2ce7ac,817e0bdf08efce2e,2006-02-04,0,0,0,900,9,9,146,61,44,102,5,4,97,43,5,5,39,18,726.8,159.0
12999,14850f48b2bede47,817e0bdf08efce2e,7f955f71fa2ce7ac,2006-02-04,0,0,0,900,0,0,37,3,37,0,0,0,0,0,12,10,25,3,0.0,161.20000000000005
13000,0e94e0a8c2130cea,0aa92558424ced9e,a390eb8a9b2df298,2006-02-04,0,0,0,388,3,1,24,6,24,0,0,0,0,0,1,1,23,6,0.0,332.0
13001,0e94e0a8c2130cea,a390eb8a9b2df298,0aa92558424ced9e,2006-02-04,1,0,0,388,0,0,51,18,47,4,0,0,4,4,2,1,45,14,0.0,388.0
13002,fbd75b08f377d149,6da99156486ed6c2,d814f5192e58fb2f,2006-01-16,0,1,1,67,0,0,9,1,9,0,0,0,0,0,6,6,3,1,0.0,40.0
13003,fbd75b08f377d149,d814f5192e58fb2f,6da99156486ed6c2,2006-01-16,0,0,0,67,0,0,8,1,8,0,0,0,0,0,3,1,5,1,0.0,60.0
13004,e55b69543aa74907,ccd1299e0345e0ce,d1a1314976c50bef,2006-01-16,0,0,0,260,2,2,51,5,35,16,5,1,11,3,5,5,30,2,86.7,106.0
13005,e55b69543aa74907,d1a1314976c50bef,ccd1299e0345e0ce,2006-01-16,0,2,1,260,1,1,9,2,7,2,0,0,2,1,1,1,6,1,51.0,122.3
13006,d0fcabb07a3e9500,c4b9296214f4c09c,e361e5c858af6ff1,2006-01-16,0,2,1,677,2,0,68,18,68,0,0,0,0,0,17,10,51,18,0.0,465.2
13007,d0fcabb07a3e9500,e361e5c858af6ff1,c4b9296214f4c09c,2006-01-16,0,3,0,677,5,1,60,14,58,2,0,0,2,2,6,4,52,12,12.8,543.0
13008,bd5afec6940c5d32,a7f4d0902bb64092,c6a33ff198aaaeeb,2006-01-16,0,0,0,270,0,0,6,1,6,0,0,0,0,0,4,4,2,1,0.0,27.0
13009,bd5afec6940c5d32,c6a33ff198aaaeeb,a7f4d0902bb64092,2006-01-16,0,2,1,270,3,2,5,2,3,2,0,0,2,2,0,0,3,0,243.0,27.0
13010,537012aa6fb20f00,2a542ee8a8b83559,e091482fa6648261,2006-01-16,0,0,0,900,0,0,224,51,222,2,2,2,0,0,37,32,185,51,17.9,703.0
13011,537012aa6fb20f00,e091482fa6648261,2a542ee8a8b83559,2006-01-16,0,0,0,900,5,0,79,9,79,0,0,0,0,0,40,27,39,9,0.0,814.1
13012,52125c3e41a1bd1e,f2c8ebbeafd45f2b,f34312c2ccfa0e00,2006-01-16,0,0,0,300,4,2,23,2,22,1,0,0,1,1,8,7,14,1,8.9,211.0
13013,52125c3e41a1bd1e,f34312c2ccfa0e00,f2c8ebbeafd45f2b,2006-01-16,1,0,0,300,0,0,65,13,65,0,0,0,0,0,14,12,51,13,0.0,291.1
13014,392089df68b1a721,84ac950d4c1722dd,fb1538b46877a695,2006-01-16,1,0,0,6,0,0,1,1,1,0,0,0,0,0,0,0,1,1,0.0,5.0
13015,392089df68b1a721,fb1538b46877a695,84ac950d4c1722dd,2006-01-16,0,0,0,6,0,0,1,0,1,0,0,0,0,0,0,0,1,0,0.0,6.0
13016,0582b78dc635301b,cb46dface0e28a2c,d43a048a880efdff,2006-01-16,0,0,0,104,0,0,10,3,10,0,0,0,0,0,2,2,8,3,0.0,59.1
13017,0582b78dc635301b,d43a048a880efdff,cb46dface0e28a2c,2006-01-16,1,0,0,104,1,1,17,6,12,5,0,0,5,5,6,4,6,1,17.9,61.0
13018,84c510ab7e764598,84a067c46306a737,94609dd91731d428,2005-11-19,0,2,1,425,3,3,21,10,2,19,0,0,19,10,0,0,2,0,284.0,141.0
13019,84c510ab7e764598,94609dd91731d428,84a067c46306a737,2005-11-19,0,4,0,425,0,0,10,2,10,0,0,0,0,0,1,0,9,2,0.0,132.0
13020,8062a7852a8b1560,621a6c59f88a44fe,d512d9f204059f57,2005-11-19,0,2,1,208,1,1,13,1,7,6,4,4,2,1,3,3,4,0,105.4,85.0
13021,8062a7852a8b1560,d512d9f204059f57,621a6c59f88a44fe,2005-11-19,0,0,0,208,0,0,5,0,5,0,0,0,0,0,1,1,4,0,0.0,102.6
13022,678af75cb4c155a9,31ee470ef5dc8d7f,7342fcc41a4817fa,2005-11-19,1,0,0,145,1,1,11,5,4,7,0,0,7,4,3,3,1,1,47.4,62.0
13023,678af75cb4c155a9,7342fcc41a4817fa,31ee470ef5dc8d7f,2005-11-19,0,2,0,145,2,0,2,1,1,1,0,0,1,1,1,1,0,0,22.0,53.6
13024,670db5afcb26df7c,02e52b3a595f0786,270b89c00ef0c55c,2005-11-19,0,0,0,879,0,0,53,15,53,0,0,0,0,0,4,3,49,15,0.0,622.7
13025,670db5afcb26df7c,270b89c00ef0c55c,02e52b3a595f0786,2005-11-19,1,2,0,879,9,2,56,13,37,19,0,0,19,11,12,10,25,2,251.3,588.0
13026,5f9d5ebe5ec28753,8d26912cd2aeb366,f5ff7bcdcfeba3ad,2005-11-19,0,1,0,900,3,0,71,19,69,2,0,0,2,1,22,19,47,18,5.7,616.1
13027,5f9d5ebe5ec28753,f5ff7bcdcfeba3ad,8d26912cd2aeb366,2005-11-19,0,0,0,900,10,7,78,17,66,12,3,2,9,4,19,19,47,13,174.9,340.3
13028,57b5e8bda9447b77,7d3caf0f96f1b33d,cd12227edd3f134b,2005-11-19,0,3,0,900,1,1,107,31,70,37,9,8,28,21,9,9,61,10,305.2,376.4
13029,57b5e8bda9447b77,cd12227edd3f134b,7d3caf0f96f1b33d,2005-11-19,0,0,0,900,5,3,40,9,35,5,1,1,4,3,4,4,31,6,94.6,348.8
13030,388df822e50b04f8,029880cdbf5ca089,6506c1d34da9c013,2005-11-19,0,0,0,473,3,0,55,5,53,2,0,0,2,0,18,15,35,5,0.0,320.4
13031,388df822e50b04f8,6506c1d34da9c013,029880cdbf5ca089,2005-11-19,1,0,0,473,4,3,111,45,79,32,1,1,31,16,12,12,67,29,152.6,287.0
13032,2dfda46cbc17bc99,52cae54377b433b7,d897897060f10a3a,2005-11-19,0,0,0,154,0,0,20,3,20,0,0,0,0,0,3,1,17,3,0.0,150.0
13033,2dfda46cbc17bc99,d897897060f10a3a,52cae54377b433b7,2005-11-19,2,0,0,154,0,0,34,10,32,2,1,1,1,1,3,2,29,9,4.0,144.0
13034,f846fd001397db45,b7d524c77c27389b,ccd1299e0345e0ce,2005-11-05,0,0,0,475,1,0,16,3,13,3,0,0,3,2,2,0,11,1,139.0,141.0
13035,f846fd001397db45,ccd1299e0345e0ce,b7d524c77c27389b,2005-11-05,1,1,0,475,3,3,39,16,15,24,1,1,23,13,4,2,11,3,195.0,141.0
13036,e364cd5772cfd27c,79899ecf62020f6d,93ce4ac89e3d7652,2005-11-05,0,2,0,900,9,5,33,15,10,23,4,3,19,13,2,2,8,2,536.4,220.7
13037,e364cd5772cfd27c,93ce4ac89e3d7652,79899ecf62020f6d,2005-11-05,0,1,0,900,1,1,39,17,24,15,0,0,15,9,4,3,20,8,96.3,241.60000000000002
13038,e050c299ffa1f2d3,2067a177a2842fbf,6da99156486ed6c2,2005-11-05,0,0,0,21,0,0,2,0,2,0,0,0,0,0,1,1,1,0,0.0,18.0
13039,e050c299ffa1f2d3,6da99156486ed6c2,2067a177a2842fbf,2005-11-05,1,0,0,21,1,1,5,3,2,3,0,0,3,3,1,1,1,0,3.0,18.0
13040,c22f4a7540cffdda,4908c5ee68a50ee5,ee779c43a8926d52,2005-11-05,0,1,0,900,3,2,164,34,160,4,0,0,4,3,15,8,145,31,9.5,751.7
13041,c22f4a7540cffdda,ee779c43a8926d52,4908c5ee68a50ee5,2005-11-05,2,0,0,900,0,0,96,46,86,10,0,0,10,5,2,2,84,41,53.3,762.5
13042,39c4f4a1aff68189,030f08370fd1c2bb,b9d0fd83bb8a147a,2005-11-05,0,0,0,508,0,0,68,7,68,0,0,0,0,0,2,1,66,7,0.0,508.0
13043,39c4f4a1aff68189,b9d0fd83bb8a147a,030f08370fd1c2bb,2005-11-05,1,0,0,508,0,0,111,19,111,0,0,0,0,0,24,22,87,19,0.0,508.0
13044,2eb9b36c09c00d69,82e7929bf6c2b689,f57a8a52ca401ed9,2005-11-05,0,1,0,900,11,5,95,29,14,81,9,8,72,27,4,4,10,2,588.7,221.9
13045,2eb9b36c09c00d69,f57a8a52ca401ed9,82e7929bf6c2b689,2005-11-05,0,1,0,900,5,2,34,13,29,5,0,0,5,2,0,0,29,11,53.1,173.29999999999995
13046,19646a0c8baee966,cb139171ed1b69fe,ce47f49e5c386a9c,2005-11-05,0,2,1,337,8,3,20,6,8,12,0,0,12,6,8,4,0,0,194.2,73.5
13047,19646a0c8baee966,ce47f49e5c386a9c,cb139171ed1b69fe,2005-11-05,0,0,0,337,0,0,15,6,12,3,0,0,3,2,2,2,10,4,4.5,127.80000000000001
13048,fea1931b041cc5ff,6aa1cbc1466e9a0b,782a2a17d3e38fdf,2005-10-07,0,1,1,362,2,0,28,2,28,0,0,0,0,0,10,10,18,2,0.0,140.0
13049,fea1931b041cc5ff,782a2a17d3e38fdf,6aa1cbc1466e9a0b,2005-10-07,0,1,0,362,5,2,10,1,8,2,0,0,2,1,2,0,6,0,195.0,167.0
13050,f8a90f8a7beaa330,06f0ffa6446c5b6d,6d7886b094b471ac,2005-10-07,1,3,0,254,2,1,38,20,2,36,5,5,31,20,2,2,0,0,216.9,25.0
13051,f8a90f8a7beaa330,6d7886b094b471ac,06f0ffa6446c5b6d,2005-10-07,0,0,0,254,0,0,3,0,2,1,0,0,1,0,0,0,2,0,0.0,37.099999999999994
13052,f15be91b30b11e0c,91acd6910b802a9e,d512d9f204059f57,2005-10-07,0,0,0,420,2,1,8,3,4,4,0,0,4,2,0,0,4,1,184.0,67.69999999999999
13053,f15be91b30b11e0c,d512d9f204059f57,91acd6910b802a9e,2005-10-07,1,1,0,420,1,1,25,15,3,22,0,0,22,13,1,0,2,2,168.3,60.0
13054,e917559aedf85a98,817e0bdf08efce2e,fcffee71cff5530e,2005-10-07,0,0,0,210,0,0,47,9,47,0,0,0,0,0,11,9,36,9,0.0,209.5
13055,e917559aedf85a98,fcffee71cff5530e,817e0bdf08efce2e,2005-10-07,1,0,0,210,0,0,82,22,81,1,0,0,1,1,13,8,68,21,0.5,204.0
13056,75926dd5b984aa06,48d1f690b763934c,d468288756ae3982,2005-10-07,0,0,0,380,3,0,24,10,9,15,0,0,15,8,4,2,5,2,151.7,143.7
13057,75926dd5b984aa06,d468288756ae3982,48d1f690b763934c,2005-10-07,0,3,1,380,6,4,17,6,13,4,0,0,4,2,5,5,8,4,54.3,65.30000000000001
13058,2aa175f3ebffcdf2,453ee00c3e1ae9dd,7f955f71fa2ce7ac,2005-10-07,0,0,0,310,0,0,5,0,5,0,0,0,0,0,3,2,2,0,0.0,77.9
13059,2aa175f3ebffcdf2,7f955f71fa2ce7ac,453ee00c3e1ae9dd,2005-10-07,1,0,0,310,0,0,80,44,24,56,3,2,53,31,0,0,24,13,232.1,53.0
13060,1c45d0feab67364f,3738e68d2261e60f,f0abbb6f3444dae7,2005-10-07,1,0,0,15,0,0,6,2,6,0,0,0,0,0,0,0,6,2,0.0,12.0
13061,1c45d0feab67364f,f0abbb6f3444dae7,3738e68d2261e60f,2005-10-07,0,0,0,15,0,0,3,1,3,0,0,0,0,0,0,0,3,1,0.0,15.0
13062,06a75406d3dd5cfd,8a8a84b743ae7699,cb46dface0e28a2c,2005-10-07,0,2,0,900,6,1,29,7,29,0,0,0,0,0,7,5,22,7,0.0,496.3
13063,06a75406d3dd5cfd,cb46dface0e28a2c,8a8a84b743ae7699,2005-10-07,0,0,0,900,0,0,92,31,59,33,11,8,22,11,16,12,43,20,234.7,459.0
13064,f5cb6cbb09ee8a16,d814f5192e58fb2f,dd37fd509af89f15,2005-10-03,1,3,1,868,0,0,17,3,17,0,0,0,0,0,4,2,13,3,0.0,98.0
13065,f5cb6cbb09ee8a16,dd37fd509af89f15,d814f5192e58fb2f,2005-10-03,0,0,0,868,6,6,16,8,6,10,0,0,10,6,0,0,6,2,754.0,114.0
13066,c25a97523bf56e49,5bb0a618ad03ac64,fb1538b46877a695,2005-10-03,0,3,0,665,12,9,26,5,17,9,2,2,7,2,3,3,14,3,360.0,219.0
13067,c25a97523bf56e49,fb1538b46877a695,5bb0a618ad03ac64,2005-10-03,1,1,0,665,0,0,42,7,40,2,0,0,2,0,9,7,31,7,6.0,266.0
13068,926091425f88d038,31ee470ef5dc8d7f,f34312c2ccfa0e00,2005-10-03,0,0,0,583,3,3,53,12,25,28,0,0,28,9,9,7,16,3,293.6,186.7
13069,926091425f88d038,f34312c2ccfa0e00,31ee470ef5dc8d7f,2005-10-03,0,3,1,583,2,1,36,9,35,1,0,0,1,1,8,4,27,8,8.3,214.39999999999998
13070,6ddabf12abd6fe25,0bc7e61d204f2137,fa315e6c77eee106,2005-10-03,0,0,0,502,2,1,32,7,27,5,0,0,5,4,8,3,19,3,55.0,403.6
13071,6ddabf12abd6fe25,fa315e6c77eee106,0bc7e61d204f2137,2005-10-03,2,0,0,502,1,0,41,4,39,2,0,0,2,1,29,24,10,3,21.4,244.0
13072,5f2240d94375f907,5eedbf1e9601be35,6f018c039b4d5d80,2005-10-03,0,3,0,900,4,1,20,1,20,0,0,0,0,0,14,13,6,1,0.0,233.39999999999998
13073,5f2240d94375f907,6f018c039b4d5d80,5eedbf1e9601be35,2005-10-03,0,2,0,900,7,5,49,19,20,29,2,1,27,15,5,5,15,4,490.6,291.0
13074,5521b9bb8f220993,22e47b53e4ceb27c,8f2d9ee27f206f1f,2005-10-03,1,0,0,555,0,0,34,13,22,12,0,0,12,11,0,0,22,2,44.3,202.39999999999998
13075,5521b9bb8f220993,8f2d9ee27f206f1f,22e47b53e4ceb27c,2005-10-03,0,2,0,555,4,3,24,3,13,11,6,6,5,2,7,6,6,1,304.6,150.7
13076,0731a4519d64df6d,75bbd2206a15319f,d43a048a880efdff,2005-10-03,0,2,0,206,1,1,7,1,7,0,0,0,0,0,5,4,2,1,0.0,64.3
13077,0731a4519d64df6d,d43a048a880efdff,75bbd2206a15319f,2005-10-03,0,1,1,206,0,0,7,3,3,4,1,1,3,2,1,1,2,1,74.7,94.0
13078,ee69302c232e0909,622f015c81a9b13a,f5ff7bcdcfeba3ad,2005-08-20,0,0,0,900,7,0,19,4,19,0,0,0,0,0,6,5,13,4,0.0,589.8
13079,ee69302c232e0909,f5ff7bcdcfeba3ad,622f015c81a9b13a,2005-08-20,0,0,0,900,6,5,70,21,52,18,4,3,14,9,30,30,22,12,209.2,249.0
13080,d250a9d1c602e266,82e7929bf6c2b689,e4770d5ed44a3970,2005-08-20,1,1,0,416,6,3,64,35,6,58,0,0,58,34,0,0,6,1,317.0,99.0
13081,d250a9d1c602e266,e4770d5ed44a3970,82e7929bf6c2b689,2005-08-20,0,0,0,416,0,0,6,1,6,0,0,0,0,0,2,2,4,1,0.0,76.0
13082,beaa6ae419b8c8c6,6506c1d34da9c013,d2d37e8eeb3abc8d,2005-08-20,0,2,1,249,1,1,32,25,6,26,0,0,26,21,0,0,6,4,217.0,32.0
13083,beaa6ae419b8c8c6,d2d37e8eeb3abc8d,6506c1d34da9c013,2005-08-20,0,0,0,249,1,0,3,1,3,0,0,0,0,0,1,0,2,1,0.0,32.0
13084,adc0b9c6afe76c23,0e041d43a47d2e4b,dbaaf42313af90fa,2005-08-20,0,4,0,900,4,4,43,14,12,31,4,4,27,9,1,1,11,5,680.1,176.0
13085,adc0b9c6afe76c23,dbaaf42313af90fa,0e041d43a47d2e4b,2005-08-20,0,1,0,900,5,2,15,4,15,0,0,0,0,0,4,4,11,4,0.0,137.89999999999998
13086,8a380b11aaf82c49,1dab0d1d81dd06db,2a542ee8a8b83559,2005-08-20,0,0,0,299,0,0,40,9,40,0,0,0,0,0,4,4,36,9,0.0,299.0
13087,8a380b11aaf82c49,2a542ee8a8b83559,1dab0d1d81dd06db,2005-08-20,1,0,0,299,0,0,69,22,69,0,0,0,0,0,10,9,59,22,0.0,298.0
13088,5a3fcd3d3a1e1c38,8d26912cd2aeb366,a390eb8a9b2df298,2005-08-20,0,0,0,1066,8,0,87,19,87,0,0,0,0,0,14,12,73,19,0.0,986.0
13089,5a3fcd3d3a1e1c38,a390eb8a9b2df298,8d26912cd2aeb366,2005-08-20,2,0,0,1066,0,0,191,58,163,28,1,1,27,10,5,5,158,48,77.0,989.0
13090,42957e04417af1d8,6a92caba39b64752,a7f4d0902bb64092,2005-08-20,0,0,0,309,4,2,13,8,3,10,2,2,8,7,2,2,1,1,220.8,22.0
13091,42957e04417af1d8,a7f4d0902bb64092,6a92caba39b64752,2005-08-20,1,0,0,309,0,0,7,3,7,0,0,0,0,0,3,3,4,3,0.0,84.19999999999999
13092,093ef5ab2081cf65,0aa92558424ced9e,2ee09ec2a0695eb9,2005-08-20,0,3,1,652,6,4,46,10,21,25,14,14,11,5,3,3,18,5,344.4,225.0
13093,093ef5ab2081cf65,2ee09ec2a0695eb9,0aa92558424ced9e,2005-08-20,0,0,0,652,9,1,40,7,40,0,0,0,0,0,1,1,39,7,0.0,238.60000000000002
13094,fd2f0f36b1eb5f83,394f55ebca199124,a8e6a69796280f17,2005-08-06,0,0,0,900,3,0,66,2,65,1,0,0,1,0,32,21,33,2,3.0,654.5
13095,fd2f0f36b1eb5f83,a8e6a69796280f17,394f55ebca199124,2005-08-06,0,2,0,900,2,2,63,7,52,11,6,3,5,2,14,11,38,5,236.5,596.0
13096,c2c000a37a89b82f,cb139171ed1b69fe,e361e5c858af6ff1,2005-08-06,1,0,0,472,2,1,68,18,68,0,0,0,0,0,25,20,43,18,0.0,428.1
13097,c2c000a37a89b82f,e361e5c858af6ff1,cb139171ed1b69fe,2005-08-06,0,0,0,472,0,0,66,15,64,2,0,0,2,1,5,3,59,14,3.9,407.0
13098,bf1525f9761a116e,0359313549d230a1,52cae54377b433b7,2005-08-06,0,0,0,42,0,0,12,1,12,0,0,0,0,0,2,1,10,1,0.0,41.0
13099,bf1525f9761a116e,52cae54377b433b7,0359313549d230a1,2005-08-06,1,0,0,42,0,0,8,2,7,1,0,0,1,1,1,1,6,1,1.0,41.0
13100,b2f604f2332cd8af,9fe85152f351e737,ea3ef6206c7907d5,2005-08-06,1,0,0,22,0,0,10,6,6,4,0,0,4,3,1,1,5,3,3.0,19.0
13101,b2f604f2332cd8af,ea3ef6206c7907d5,9fe85152f351e737,2005-08-06,0,0,0,22,0,0,3,0,3,0,0,0,0,0,1,1,2,0,0.0,19.0
13102,994739f676c2105f,84a067c46306a737,c6a33ff198aaaeeb,2005-08-06,0,2,0,900,1,1,29,9,25,4,0,0,4,2,3,2,22,7,46.2,337.7
13103,994739f676c2105f,c6a33ff198aaaeeb,84a067c46306a737,2005-08-06,0,1,0,900,7,3,91,39,40,51,2,1,49,25,3,3,37,14,435.3,264.8
13104,7acca0910edd7023,d1a1314976c50bef,d814f5192e58fb2f,2005-08-06,0,0,0,95,1,0,0,0,0,0,0,0,0,0,0,0,0,0,0.0,60.0
13105,7acca0910edd7023,d814f5192e58fb2f,d1a1314976c50bef,2005-08-06,0,1,1,95,3,2,3,0,2,1,0,0,1,0,1,1,1,0,35.0,25.0
13106,44e4a1caae180261,c3ea8deeba00462b,dd37fd509af89f15,2005-08-06,0,0,0,113,0,0,2,0,2,0,0,0,0,0,0,0,2,0,0.0,113.0
13107,44e4a1caae180261,dd37fd509af89f15,c3ea8deeba00462b,2005-08-06,0,1,1,113,3,1,2,0,2,0,0,0,0,0,1,0,1,0,0.0,23.0
13108,389b7ca84b333c4c,9fa3bd637edd9aa2,d43a048a880efdff,2005-08-06,0,0,0,900,2,1,63,18,57,6,0,0,6,3,12,8,45,15,20.7,610.7
13109,389b7ca84b333c4c,d43a048a880efdff,9fa3bd637edd9aa2,2005-08-06,0,0,0,900,5,1,63,17,51,12,0,0,12,5,12,9,39,12,168.3,332.3
13110,fb252c420e9830cd,02e52b3a595f0786,f0abbb6f3444dae7,2005-06-04,0,0,0,240,1,0,33,6,33,0,0,0,0,0,16,12,17,6,0.0,146.3
13111,fb252c420e9830cd,f0abbb6f3444dae7,02e52b3a595f0786,2005-06-04,1,1,1,240,0,0,43,12,36,7,0,0,7,2,8,8,28,10,11.7,200.0
13112,ea8b1a909155b0c2,ae58685caf8e4a0d,fcffee71cff5530e,2005-06-04,0,0,0,138,0,0,1,0,1,0,0,0,0,0,1,1,0,0,0.0,14.0
13113,ea8b1a909155b0c2,fcffee71cff5530e,ae58685caf8e4a0d,2005-06-04,0,1,1,138,1,1,4,3,2,2,0,0,2,2,0,0,2,1,124.0,14.0
13114,e5261884b0a0ed39,22e47b53e4ceb27c,da97d6c97d09c030,2005-06-04,1,0,0,430,0,0,40,15,14,26,3,2,23,12,3,3,11,3,166.6,257.0
13115,e5261884b0a0ed39,da97d6c97d09c030,22e47b53e4ceb27c,2005-06-04,0,1,0,430,3,1,1,0,1,0,0,0,0,0,0,0,1,0,0.0,98.4
13116,d80b07269dd36aad,349aaa3da11eb587,86dfed7cc24a9fa7,2005-06-04,0,2,0,900,10,8,127,51,63,64,1,1,63,34,7,4,56,17,321.8,502.0
13117,d80b07269dd36aad,86dfed7cc24a9fa7,349aaa3da11eb587,2005-06-04,1,0,0,900,2,1,65,16,56,9,0,0,9,8,12,10,44,8,36.0,522.2
13118,ca3230227ee700b7,52cae54377b433b7,7b6e40a73b567072,2005-06-04,2,0,0,157,0,0,30,15,23,7,0,0,7,6,7,4,16,9,14.0,121.0
13119,ca3230227ee700b7,7b6e40a73b567072,52cae54377b433b7,2005-06-04,0,0,0,157,0,0,19,2,19,0,0,0,0,0,9,4,10,2,0.0,101.0
13120,a507bfa374885a25,27fc9218a3653e3c,3738e68d2261e60f,2005-06-04,0,0,0,250,1,0,21,4,21,0,0,0,0,0,1,1,20,4,0.0,247.4
13121,a507bfa374885a25,3738e68d2261e60f,27fc9218a3653e3c,2005-06-04,1,0,0,250,0,0,56,22,53,3,0,0,3,3,13,11,40,19,2.6,243.0
13122,98cc8f5dd64895c4,8f2d9ee27f206f1f,d897897060f10a3a,2005-06-04,1,1,0,1105,5,1,95,15,95,0,0,0,0,0,24,10,71,15,0.0,1044.9
13123,98cc8f5dd64895c4,d897897060f10a3a,8f2d9ee27f206f1f,2005-06-04,1,1,0,1105,0,0,272,79,267,5,0,0,5,0,27,18,240,79,12.1,1030.0
13124,07886c772e37d5de,01daf32100ed7517,f57a8a52ca401ed9,2005-06-04,0,0,0,84,0,0,22,2,22,0,0,0,0,0,0,0,22,2,0.0,82.5
13125,07886c772e37d5de,f57a8a52ca401ed9,01daf32100ed7517,2005-06-04,1,0,0,84,0,0,44,20,39,5,0,0,5,4,5,5,34,16,1.5,81.0
13126,f4e6f8223d0816fe,6506c1d34da9c013,b2f88c04c4dd43ce,2005-04-16,0,4,0,900,5,5,94,41,33,61,18,17,43,28,6,6,27,13,523.0,232.1
13127,f4e6f8223d0816fe,b2f88c04c4dd43ce,6506c1d34da9c013,2005-04-16,0,0,0,900,6,1,41,6,35,6,2,1,4,3,13,9,22,3,84.9,278.0
13128,cb8e91f8b9f0e24f,7f9f528cb72a6ed1,d468288756ae3982,2005-04-16,0,0,0,324,2,2,5,2,4,1,0,0,1,1,1,1,3,1,23.7,110.9
13129,cb8e91f8b9f0e24f,d468288756ae3982,7f9f528cb72a6ed1,2005-04-16,0,2,1,324,3,2,27,11,12,15,0,0,15,7,5,4,7,4,142.1,101.3
13130,b1b66441acc5e8df,621a6c59f88a44fe,d2d37e8eeb3abc8d,2005-04-16,0,1,1,245,2,1,19,10,6,13,0,0,13,10,3,3,3,0,79.7,86.4
13131,b1b66441acc5e8df,d2d37e8eeb3abc8d,621a6c59f88a44fe,2005-04-16,1,1,0,245,0,0,21,9,10,11,0,0,11,7,4,4,6,2,66.6,56.3
13132,5e1b0e52d2bb1b5c,2ee09ec2a0695eb9,b6b12014698cc345,2005-04-16,0,0,0,900,4,1,60,14,23,37,19,19,18,12,2,1,21,2,423.1,397.6
13133,5e1b0e52d2bb1b5c,b6b12014698cc345,2ee09ec2a0695eb9,2005-04-16,1,1,0,900,1,1,35,8,28,7,0,0,7,4,12,10,16,4,56.4,315.9
13134,5d72fa4562b13f7b,394f55ebca199124,d512d9f204059f57,2005-04-16,0,1,1,162,1,0,7,2,7,0,0,0,0,0,2,0,5,2,0.0,101.2
13135,5d72fa4562b13f7b,d512d9f204059f57,394f55ebca199124,2005-04-16,0,0,0,162,1,1,11,4,5,6,0,0,6,3,2,2,3,1,60.8,81.0
13136,36dbc3cee586e53d,0e041d43a47d2e4b,622f015c81a9b13a,2005-04-16,0,1,1,493,4,2,25,6,20,5,0,0,5,1,8,5,12,5,78.1,165.0
13137,36dbc3cee586e53d,622f015c81a9b13a,0e041d43a47d2e4b,2005-04-16,0,0,0,493,1,1,4,0,4,0,0,0,0,0,0,0,4,0,0.0,301.9
13138,2ae8623ef4156105,0aa92558424ced9e,a390eb8a9b2df298,2005-04-16,0,0,0,126,0,0,24,8,24,0,0,0,0,0,2,1,22,8,0.0,122.7
13139,2ae8623ef4156105,a390eb8a9b2df298,0aa92558424ced9e,2005-04-16,1,0,0,126,0,0,26,12,24,2,0,0,2,2,1,1,23,10,1.3,124.0
13140,026e64f70e319e00,9fa3bd637edd9aa2,dbaaf42313af90fa,2005-04-16,2,0,0,755,0,0,54,28,27,27,4,4,23,14,6,5,21,14,216.8,256.0
13141,026e64f70e319e00,dbaaf42313af90fa,9fa3bd637edd9aa2,2005-04-16,0,4,1,755,6,4,24,3,16,8,4,2,4,2,4,4,12,1,218.0,211.2
13142,f434775e97920d95,265589bdd93e7ce5,52cae54377b433b7,2005-04-09,0,0,0,197,0,0,34,3,34,0,0,0,0,0,8,7,26,3,0.0,197.0
13143,f434775e97920d95,52cae54377b433b7,265589bdd93e7ce5,2005-04-09,1,0,0,197,0,0,82,26,82,0,0,0,0,0,11,10,71,26,0.0,197.0
13144,ddb950831580a5fe,84a067c46306a737,aee8eecfc4bfb1e7,2005-04-09,1,0,0,900,1,0,119,12,111,8,0,0,8,0,24,10,87,12,115.6,687.0
13145,ddb950831580a5fe,aee8eecfc4bfb1e7,84a067c46306a737,2005-04-09,0,0,0,900,2,1,84,6,82,2,0,0,2,1,18,15,64,5,54.0,703.4
13146,d172d88fbeb8c6a8,82e7929bf6c2b689,cb139171ed1b69fe,2005-04-09,1,0,0,169,2,1,21,13,4,17,0,0,17,12,1,1,3,1,82.3,77.0
13147,d172d88fbeb8c6a8,cb139171ed1b69fe,82e7929bf6c2b689,2005-04-09,0,0,0,169,0,0,4,1,2,2,0,0,2,1,1,1,1,0,0.0,86.7
13148,c50a3025d1519fc8,63b65af1c5cb02cb,d897897060f10a3a,2005-04-09,0,2,0,162,1,1,4,0,4,0,0,0,0,0,0,0,4,0,0.0,121.5
13149,c50a3025d1519fc8,d897897060f10a3a,63b65af1c5cb02cb,2005-04-09,1,0,0,162,0,0,36,20,16,20,0,0,20,17,3,3,13,3,15.5,145.0
13150,a3b268798d3ab216,d43a048a880efdff,f0264252e191da22,2005-04-09,1,0,0,95,1,1,40,21,3,37,5,5,32,21,1,1,2,0,81.6,9.0
13151,a3b268798d3ab216,f0264252e191da22,d43a048a880efdff,2005-04-09,0,0,0,95,0,0,3,1,3,0,0,0,0,0,0,0,3,1,0.0,13.400000000000006
13152,74f757bacb86a71c,9fe85152f351e737,fdfef29ba17ee525,2005-04-09,1,0,0,20,0,0,13,6,13,0,0,0,0,0,1,1,12,6,0.0,20.0
13153,74f757bacb86a71c,fdfef29ba17ee525,9fe85152f351e737,2005-04-09,0,0,0,20,0,0,4,0,4,0,0,0,0,0,2,1,2,0,0.0,20.0
13154,61733e5f00f4e194,29f935654825331b,dd37fd509af89f15,2005-04-09,0,1,0,261,0,0,2,0,2,0,0,0,0,0,1,1,1,0,0.0,72.0
13155,61733e5f00f4e194,dd37fd509af89f15,29f935654825331b,2005-04-09,1,0,0,261,2,2,17,13,3,14,0,0,14,12,1,1,2,1,189.0,72.0
13156,4705a4db0bf1edcd,c6a33ff198aaaeeb,fcffee71cff5530e,2005-04-09,0,0,0,900,0,0,150,55,150,0,0,0,0,0,4,2,146,55,0.0,867.2
13157,4705a4db0bf1edcd,fcffee71cff5530e,c6a33ff198aaaeeb,2005-04-09,0,1,0,900,9,2,184,62,179,5,1,1,4,3,34,25,145,59,13.8,746.0
13158,17affee2c796c225,e361e5c858af6ff1,ff2c606c8bc365e3,2005-04-09,1,0,0,100,0,0,12,6,4,8,0,0,8,6,0,0,4,0,63.0,37.0
13159,17affee2c796c225,ff2c606c8bc365e3,e361e5c858af6ff1,2005-04-09,0,1,0,100,1,0,3,0,3,0,0,0,0,0,2,1,1,0,0.0,37.0
13160,e8196de20c4a969a,d814f5192e58fb2f,f57a8a52ca401ed9,2005-02-05,0,2,0,280,0,0,8,2,6,2,1,1,1,1,1,0,5,1,50.5,57.3
13161,e8196de20c4a969a,f57a8a52ca401ed9,d814f5192e58fb2f,2005-02-05,1,1,0,280,1,0,28,10,8,20,0,0,20,8,4,3,4,2,121.7,83.5
13162,e30780438191654f,22e47b53e4ceb27c,ea3ef6206c7907d5,2005-02-05,2,1,0,300,0,0,34,16,14,20,0,0,20,12,3,1,11,4,138.3,136.0
13163,e30780438191654f,ea3ef6206c7907d5,22e47b53e4ceb27c,2005-02-05,0,0,0,300,1,1,23,2,22,1,0,0,1,1,11,9,11,1,5.0,126.69999999999999
13164,dae856cb00cf5163,2a542ee8a8b83559,3738e68d2261e60f,2005-02-05,0,0,0,47,0,0,4,1,4,0,0,0,0,0,1,1,3,1,0.0,39.0
13165,dae856cb00cf5163,3738e68d2261e60f,2a542ee8a8b83559,2005-02-05,1,2,1,47,0,0,10,1,6,4,0,0,4,0,4,4,2,1,8.0,39.0
13166,c91ef06766009965,27fc9218a3653e3c,f0abbb6f3444dae7,2005-02-05,0,0,0,214,0,0,28,3,28,0,0,0,0,0,9,4,19,3,0.0,135.4
13167,c91ef06766009965,f0abbb6f3444dae7,27fc9218a3653e3c,2005-02-05,1,0,0,214,0,0,50,12,49,1,0,0,1,1,12,10,37,11,0.6,211.0
13168,987b6b4f7825e40e,0359313549d230a1,1652f3213655b935,2005-02-05,0,1,1,859,4,1,49,10,39,10,0,0,10,4,6,6,33,6,174.7,315.0
13169,987b6b4f7825e40e,1652f3213655b935,0359313549d230a1,2005-02-05,0,0,0,859,6,4,40,15,31,9,0,0,9,7,3,2,28,8,282.0,308.3
13170,7cfc8649d07b704c,4123fd4dcc1fe937,8f2d9ee27f206f1f,2005-02-05,0,1,0,275,2,2,9,3,9,0,0,0,0,0,2,1,7,3,0.0,71.80000000000001
13171,7cfc8649d07b704c,8f2d9ee27f206f1f,4123fd4dcc1fe937,2005-02-05,1,0,0,275,0,0,28,18,1,27,0,0,27,18,1,1,0,0,182.2,86.0
13172,4fb2c181e8fd5910,0ee783aa00e468f0,2f732dd9210d301f,2005-02-05,0,1,0,900,0,0,38,16,21,17,0,0,17,10,3,3,18,6,95.8,288.3
13173,4fb2c181e8fd5910,2f732dd9210d301f,0ee783aa00e468f0,2005-02-05,0,0,0,900,11,4,47,20,16,31,3,2,28,16,6,5,10,4,425.7,241.2
13174,48189cad0c11ff63,56b8b24f65f9f057,a7f4d0902bb64092,2005-02-05,1,0,0,115,1,1,15,7,11,4,0,0,4,3,3,3,8,4,47.4,32.0
13175,48189cad0c11ff63,a7f4d0902bb64092,56b8b24f65f9f057,2005-02-05,0,0,0,115,0,0,6,1,6,0,0,0,0,0,2,2,4,1,0.0,61.6
13176,45a52e065b73ecba,349aaa3da11eb587,91acd6910b802a9e,2005-02-05,0,2,0,900,9,7,66,29,6,60,0,0,60,28,0,0,6,1,760.3,122.3
13177,45a52e065b73ecba,91acd6910b802a9e,349aaa3da11eb587,2005-02-05,0,2,0,900,0,0,16,4,15,1,1,1,0,0,2,2,13,4,4.7,106.70000000000005
13178,dc9b52352dca15ef,05866d8c3a321856,622f015c81a9b13a,2004-10-22,0,0,0,333,0,0,45,3,45,0,0,0,0,0,8,7,37,3,0.0,333.0
13179,dc9b52352dca15ef,622f015c81a9b13a,05866d8c3a321856,2004-10-22,1,0,0,333,1,0,11,1,11,0,0,0,0,0,0,0,11,1,0.0,331.0
13180,b76a722dd429612e,cb46dface0e28a2c,d897897060f10a3a,2004-10-22,0,0,0,868,1,0,41,9,41,0,0,0,0,0,17,13,24,9,0.0,681.6
13181,b76a722dd429612e,d897897060f10a3a,cb46dface0e28a2c,2004-10-22,1,1,1,868,3,3,73,27,59,14,0,0,14,9,22,14,37,18,136.4,293.0
13182,9422b3caf780a995,2f732dd9210d301f,9fa3bd637edd9aa2,2004-10-22,0,0,0,900,3,2,75,42,5,70,3,3,67,41,0,0,5,1,761.0,139.0
13183,9422b3caf780a995,9fa3bd637edd9aa2,2f732dd9210d301f,2004-10-22,0,0,0,900,1,0,27,11,24,3,0,0,3,2,0,0,24,9,0.0,139.0
13184,929fb67b49eaa405,8f2d9ee27f206f1f,f2925e6db404bf1d,2004-10-22,0,1,1,142,0,0,17,2,17,0,0,0,0,0,5,4,12,2,0.0,120.0
13185,929fb67b49eaa405,f2925e6db404bf1d,8f2d9ee27f206f1f,2004-10-22,0,0,0,142,1,1,14,2,12,2,0,0,2,1,1,1,11,1,22.0,109.0
13186,6f21a27075f0695c,621a6c59f88a44fe,6506c1d34da9c013,2004-10-22,0,2,1,299,7,2,14,3,12,2,0,0,2,0,1,1,11,3,93.3,159.0
13187,6f21a27075f0695c,6506c1d34da9c013,621a6c59f88a44fe,2004-10-22,0,0,0,299,1,1,17,4,17,0,0,0,0,0,2,2,15,4,0.0,188.7
13188,1a471a1bff47a960,c24b1db4b809d41b,d2d37e8eeb3abc8d,2004-10-22,0,2,0,431,8,0,21,2,21,0,0,0,0,0,3,2,18,2,0.0,189.0
13189,1a471a1bff47a960,d2d37e8eeb3abc8d,c24b1db4b809d41b,2004-10-22,1,0,0,431,1,1,59,26,32,27,1,1,26,18,10,6,22,8,189.0,130.0
13190,0d15b14d1215c853,253de74457bd6374,394f55ebca199124,2004-10-22,0,0,0,96,1,0,6,1,6,0,0,0,0,0,4,3,2,1,0.0,79.0
13191,0d15b14d1215c853,394f55ebca199124,253de74457bd6374,2004-10-22,1,1,1,96,2,0,15,6,12,3,0,0,3,3,4,3,8,3,15.0,36.0
13192,ebd51f898209c4c8,12458872d6afae1b,a390eb8a9b2df298,2004-08-21,0,0,0,245,1,0,37,9,33,4,0,0,4,1,5,4,28,8,0.0,177.8
13193,ebd51f898209c4c8,a390eb8a9b2df298,12458872d6afae1b,2004-08-21,2,0,0,245,1,1,68,27,37,31,1,1,30,16,3,3,34,11,67.2,154.0
13194,c9c5b2507c6be9e3,5f04e3d58d9ce982,a566371ba2ad7152,2004-08-21,1,0,0,272,1,0,21,10,14,7,0,0,7,7,6,6,8,3,15.6,221.2
13195,c9c5b2507c6be9e3,a566371ba2ad7152,5f04e3d58d9ce982,2004-08-21,0,0,0,272,3,2,22,2,21,1,0,0,1,0,15,11,6,2,10.8,159.4
13196,c74eef9b337602c6,27fc9218a3653e3c,56b8b24f65f9f057,2004-08-21,1,0,0,74,1,0,9,4,8,1,0,0,1,1,1,0,7,3,0.3,73.0
13197,c74eef9b337602c6,56b8b24f65f9f057,27fc9218a3653e3c,2004-08-21,0,0,0,74,0,0,16,1,16,0,0,0,0,0,6,6,10,1,0.0,73.7
13198,977e56ada4acc596,0aa92558424ced9e,0ee783aa00e468f0,2004-08-21,1,0,0,900,4,2,71,40,29,42,0,0,42,33,15,10,14,7,530.3,53.7
13199,977e56ada4acc596,0ee783aa00e468f0,0aa92558424ced9e,2004-08-21,0,2,0,900,0,0,6,1,5,1,0,0,1,1,2,2,3,0,0.3,368.70000000000005
13200,719f21fdb310fcfb,d512d9f204059f57,dbaaf42313af90fa,2004-08-21,1,0,0,519,3,2,55,24,10,45,4,3,41,22,2,2,8,2,341.2,155.0
13201,719f21fdb310fcfb,dbaaf42313af90fa,d512d9f204059f57,2004-08-21,0,0,0,519,7,2,7,2,7,0,0,0,0,0,4,4,3,2,0.0,133.8
13202,6e2254b4fd39ce40,0e041d43a47d2e4b,4123fd4dcc1fe937,2004-08-21,0,0,0,24,0,0,1,0,1,0,0,0,0,0,0,0,1,0,0.0,16.0
13203,6e2254b4fd39ce40,4123fd4dcc1fe937,0e041d43a47d2e4b,2004-08-21,1,0,0,24,0,0,7,5,2,5,0,0,5,4,0,0,2,1,8.0,16.0
13204,6996eb7755709945,349aaa3da11eb587,f57a8a52ca401ed9,2004-08-21,0,0,0,900,15,9,79,23,54,25,0,0,25,8,4,4,50,15,252.4,474.3
13205,6996eb7755709945,f57a8a52ca401ed9,349aaa3da11eb587,2004-08-21,0,2,0,900,2,1,102,26,99,3,0,0,3,1,19,11,80,25,11.7,569.6
13206,5db23cc876db1619,91acd6910b802a9e,b9e871af730f826c,2004-08-21,1,2,1,377,1,0,25,8,16,9,0,0,9,5,5,4,11,3,212.7,117.0
13207,5db23cc876db1619,b9e871af730f826c,91acd6910b802a9e,2004-08-21,0,0,0,377,1,1,16,1,16,0,0,0,0,0,11,7,5,1,0.0,141.3
13208,dffef4343e822399,1ff9589f9065a9ed,2a542ee8a8b83559,2004-06-19,0,1,1,50,0,0,3,0,3,0,0,0,0,0,3,3,0,0,0.0,50.0
13209,dffef4343e822399,2a542ee8a8b83559,1ff9589f9065a9ed,2004-06-19,0,0,0,50,1,1,5,1,5,0,0,0,0,0,1,1,4,1,0.0,21.0
13210,a40e421630b67e5c,5bb0a618ad03ac64,6506c1d34da9c013,2004-06-19,0,0,0,102,3,0,9,1,9,0,0,0,0,0,4,4,5,1,0.0,78.7
13211,a40e421630b67e5c,6506c1d34da9c013,5bb0a618ad03ac64,2004-06-19,2,0,0,102,1,0,33,22,19,14,0,0,14,9,2,2,17,13,17.3,81.0
13212,7014356795515aea,1652f3213655b935,8f2d9ee27f206f1f,2004-06-19,0,0,0,900,1,0,67,16,67,0,0,0,0,0,7,7,60,16,0.0,728.5
13213,7014356795515aea,8f2d9ee27f206f1f,1652f3213655b935,2004-06-19,0,0,0,900,12,5,102,55,84,18,2,2,16,13,18,16,66,42,168.5,535.0
13214,66eaf9f4a2cd67d8,08ae5cd9aef7ddd3,63b65af1c5cb02cb,2004-06-19,0,0,0,86,0,0,5,2,5,0,0,0,0,0,2,2,3,2,0.0,79.4
13215,66eaf9f4a2cd67d8,63b65af1c5cb02cb,08ae5cd9aef7ddd3,2004-06-19,1,0,0,86,0,0,15,3,14,1,0,0,1,1,9,9,5,2,0.6,77.0
13216,5cbd93c68225a845,e09dbbd5fe3f0fe2,f5ff7bcdcfeba3ad,2004-06-19,0,0,0,365,0,0,7,0,5,2,1,1,1,0,4,4,1,0,4.0,52.0
13217,5cbd93c68225a845,f5ff7bcdcfeba3ad,e09dbbd5fe3f0fe2,2004-06-19,0,2,1,365,4,2,18,2,1,17,10,10,7,2,0,0,1,0,309.0,52.0
13218,5261874c58322b46,621a6c59f88a44fe,c24b1db4b809d41b,2004-06-19,0,1,0,900,6,3,23,6,6,17,1,1,16,6,5,4,1,0,687.6,83.5
13219,5261874c58322b46,c24b1db4b809d41b,621a6c59f88a44fe,2004-06-19,0,4,0,900,0,0,13,5,8,5,0,0,5,4,3,2,5,1,7.5,200.39999999999998
13220,41222c4fab03d6f8,5755960ebd0b16f6,86dfed7cc24a9fa7,2004-06-19,0,2,0,900,2,0,16,3,14,2,0,0,2,2,6,5,8,1,1.8,161.5
13221,41222c4fab03d6f8,86dfed7cc24a9fa7,5755960ebd0b16f6,2004-06-19,0,0,0,900,7,6,40,9,7,33,1,1,32,9,6,4,1,0,731.5,100.2
13222,1201d192092baacf,8a8a84b743ae7699,d2d37e8eeb3abc8d,2004-06-19,0,2,0,255,1,0,6,0,6,0,0,0,0,0,2,1,4,0,0.0,55.0
13223,1201d192092baacf,d2d37e8eeb3abc8d,8a8a84b743ae7699,2004-06-19,1,0,0,255,0,0,41,20,11,30,0,0,30,19,1,0,10,1,200.0,55.0
13224,eecbc6c850e62d97,91acd6910b802a9e,cb6783c39c01d896,2004-04-02,0,1,1,415,3,2,80,22,80,0,0,0,0,0,18,12,62,22,0.0,366.0
13225,eecbc6c850e62d97,cb6783c39c01d896,91acd6910b802a9e,2004-04-02,0,0,0,415,0,0,49,9,49,0,0,0,0,0,25,18,24,9,0.0,388.0
13226,ba5e8c30d41559fd,60884f31ead1609c,a9a314cc77d90b6e,2004-04-02,1,0,0,280,4,1,10,10,2,8,0,0,8,8,0,0,2,2,88.8,166.4
13227,ba5e8c30d41559fd,a9a314cc77d90b6e,60884f31ead1609c,2004-04-02,0,0,0,280,0,0,23,11,22,1,0,0,1,1,9,9,13,10,2.6,147.2
13228,3b8bfe14b0c297b2,56b8b24f65f9f057,e0f7c4f3f67bc808,2004-04-02,1,1,0,299,1,0,15,8,10,5,0,0,5,4,5,5,5,4,100.0,59.0
13229,3b8bfe14b0c297b2,e0f7c4f3f67bc808,56b8b24f65f9f057,2004-04-02,0,3,0,299,1,0,2,0,2,0,0,0,0,0,1,0,1,0,0.0,187.0
13230,2dbd0bc3e61ca00b,2f732dd9210d301f,a390eb8a9b2df298,2004-04-02,0,0,0,338,2,0,32,7,32,0,0,0,0,0,7,6,25,7,0.0,338.0
13231,2dbd0bc3e61ca00b,a390eb8a9b2df298,2f732dd9210d301f,2004-04-02,1,0,0,338,0,0,65,22,65,0,0,0,0,0,2,1,63,22,0.0,337.0
13232,268f0fcc45e1a6fe,5f04e3d58d9ce982,e0ec3c3b6b611f7e,2004-04-02,0,1,0,900,0,0,43,9,25,18,5,4,13,4,9,8,16,5,261.9,533.3
13233,268f0fcc45e1a6fe,e0ec3c3b6b611f7e,5f04e3d58d9ce982,2004-04-02,0,2,0,900,10,4,44,6,42,2,0,0,2,1,5,2,37,5,75.7,411.1
13234,1d9d91f78334129d,99dd0147dc4ef80c,e0b74df14f52cd15,2004-04-02,0,4,1,211,1,1,8,0,8,0,0,0,0,0,6,6,2,0,0.0,116.4
13235,1d9d91f78334129d,e0b74df14f52cd15,99dd0147dc4ef80c,2004-04-02,0,0,0,211,2,1,15,7,9,6,0,0,6,5,6,6,3,2,82.6,32.0
13236,0f23c5569204a69b,3738e68d2261e60f,4e9fb05d7e5e61b8,2004-04-02,1,0,0,375,0,0,83,41,83,0,0,0,0,0,15,10,68,41,0.0,369.0
13237,0f23c5569204a69b,4e9fb05d7e5e61b8,3738e68d2261e60f,2004-04-02,0,0,0,375,0,0,29,2,29,0,0,0,0,0,4,2,25,2,0.0,375.0
13238,0374646197b8e0fa,f2925e6db404bf1d,f57a8a52ca401ed9,2004-04-02,0,0,0,391,0,0,64,13,64,0,0,0,0,0,4,3,60,13,0.0,391.0
13239,0374646197b8e0fa,f57a8a52ca401ed9,f2925e6db404bf1d,2004-04-02,1,0,0,391,1,0,75,14,75,0,0,0,0,0,12,8,63,14,0.0,342.0
13240,fab7e4790b11de3c,a566371ba2ad7152,e0ec3c3b6b611f7e,2004-01-31,0,0,0,900,3,2,68,16,60,8,3,2,5,4,27,22,33,12,115.3,397.3
13241,fab7e4790b11de3c,e0ec3c3b6b611f7e,a566371ba2ad7152,2004-01-31,1,1,0,900,3,2,46,19,25,21,0,0,21,12,6,3,19,7,257.7,465.7
13242,bee02eaf332eb7f1,32016899d0a222a3,cb46dface0e28a2c,2004-01-31,0,2,1,105,0,0,1,0,1,0,0,0,0,0,0,0,1,0,0.0,47.0
13243,bee02eaf332eb7f1,cb46dface0e28a2c,32016899d0a222a3,2004-01-31,0,0,0,105,2,1,4,1,2,2,0,0,2,1,1,1,1,0,58.0,18.0
13244,9cd343b9d5d87528,0aa92558424ced9e,0ee783aa00e468f0,2004-01-31,0,0,0,49,0,0,2,0,2,0,0,0,0,0,1,1,1,0,0.0,49.0
13245,9cd343b9d5d87528,0ee783aa00e468f0,0aa92558424ced9e,2004-01-31,1,0,0,49,0,0,1,1,1,0,0,0,0,0,0,0,1,1,0.0,22.0
13246,829146a45b3b236b,952f6fa06f25a0ec,c24b1db4b809d41b,2004-01-31,0,0,0,900,5,2,9,1,9,0,0,0,0,0,4,3,5,1,0.0,169.20000000000005
13247,829146a45b3b236b,c24b1db4b809d41b,952f6fa06f25a0ec,2004-01-31,0,1,0,900,4,3,36,20,14,22,0,0,22,14,2,2,12,6,519.8,333.0
13248,5bdaa71a5daebcb5,86dfed7cc24a9fa7,a8ea84cbe1655f0a,2004-01-31,0,0,0,900,10,6,80,26,22,58,8,8,50,24,11,11,11,2,664.1,103.3
13249,5bdaa71a5daebcb5,a8ea84cbe1655f0a,86dfed7cc24a9fa7,2004-01-31,0,1,0,900,2,0,15,5,13,2,0,0,2,2,4,4,9,3,6.7,215.89999999999998
13250,476548ca3d8cf0ee,1ff9589f9065a9ed,e0f7c4f3f67bc808,2004-01-31,1,2,0,561,7,4,44,18,12,32,5,3,27,17,7,7,5,1,405.3,78.2
13251,476548ca3d8cf0ee,e0f7c4f3f67bc808,1ff9589f9065a9ed,2004-01-31,0,0,0,561,0,0,25,1,14,11,10,10,1,1,7,7,7,0,26.8,116.69999999999999
13252,4076a87092da5bfa,621a6c59f88a44fe,73c7cfa551289285,2004-01-31,0,0,0,279,1,0,8,3,4,4,0,0,4,3,1,1,3,0,0.0,55.30000000000001
13253,4076a87092da5bfa,73c7cfa551289285,621a6c59f88a44fe,2004-01-31,0,1,1,279,0,0,23,15,6,17,0,0,17,12,2,2,4,3,223.7,29.0
13254,1bc4996fa543a91a,349aaa3da11eb587,6506c1d34da9c013,2004-01-31,0,4,0,900,2,0,7,1,6,1,0,0,1,1,1,0,5,0,19.0,154.0
13255,1bc4996fa543a91a,6506c1d34da9c013,349aaa3da11eb587,2004-01-31,0,0,0,900,8,6,80,29,15,65,14,13,51,26,5,4,10,3,727.0,154.0
13256,d1d33be012417f75,4e9fb05d7e5e61b8,b361180739bed4b0,2003-11-21,1,0,0,134,0,0,24,13,23,1,0,0,1,1,1,0,22,12,0.4,127.0
13257,d1d33be012417f75,b361180739bed4b0,4e9fb05d7e5e61b8,2003-11-21,0,0,0,134,0,0,26,11,26,0,0,0,0,0,0,0,26,11,0.0,49.6
13258,b35adb9d047f5cd8,1652f3213655b935,8f2d9ee27f206f1f,2003-11-21,2,0,0,282,0,0,32,14,30,2,0,0,2,0,4,3,26,14,1.6,175.4
13259,b35adb9d047f5cd8,8f2d9ee27f206f1f,1652f3213655b935,2003-11-21,1,0,0,282,4,1,34,16,17,17,0,0,17,13,14,12,3,3,92.6,133.4
13260,9f108233c7c787d9,0e041d43a47d2e4b,445a98acb8985970,2003-11-21,1,1,0,863,3,1,62,19,40,22,2,2,20,13,16,14,24,6,243.0,167.0
13261,9f108233c7c787d9,445a98acb8985970,0e041d43a47d2e4b,2003-11-21,0,0,0,863,1,0,18,0,16,2,2,1,0,0,3,2,13,0,199.0,421.0
13262,906d6f62fb7f9b19,50cc91ce2982785d,b44f39a5c6596953,2003-11-21,0,0,0,900,12,0,33,13,33,0,0,0,0,0,5,2,28,13,0.0,548.0
13263,906d6f62fb7f9b19,b44f39a5c6596953,50cc91ce2982785d,2003-11-21,0,0,0,900,0,0,93,9,56,37,18,13,19,6,8,8,48,3,352.0,548.0
13264,823d7037552a8907,5f04e3d58d9ce982,ebc5af72ad5a28cb,2003-11-21,1,0,0,434,0,0,57,14,42,15,0,0,15,11,25,19,17,3,9.7,423.0
13265,823d7037552a8907,ebc5af72ad5a28cb,5f04e3d58d9ce982,2003-11-21,0,0,0,434,2,0,43,2,43,0,0,0,0,0,7,3,36,2,0.0,357.3
13266,7d2d327fd7580364,91acd6910b802a9e,f2925e6db404bf1d,2003-11-21,0,1,0,900,1,1,97,18,97,0,0,0,0,0,28,19,69,18,0.0,648.7
13267,7d2d327fd7580364,f2925e6db404bf1d,91acd6910b802a9e,2003-11-21,1,0,0,900,4,3,72,23,47,25,1,1,24,11,7,6,40,12,227.3,609.0
13268,61a211b4a7f942cd,0e31bfd26cc8c503,c75b99887c8c3f5a,2003-11-21,0,0,0,209,0,0,3,0,3,0,0,0,0,0,1,1,2,0,0.0,17.0
13269,61a211b4a7f942cd,c75b99887c8c3f5a,0e31bfd26cc8c503,2003-11-21,0,1,1,209,2,1,5,5,0,5,0,0,5,5,0,0,0,0,184.0,25.0
13270,2cfde31b41b2220d,621a6c59f88a44fe,d2d37e8eeb3abc8d,2003-11-21,0,2,1,234,1,1,0,0,0,0,0,0,0,0,0,0,0,0,0.0,12.0
13271,2cfde31b41b2220d,d2d37e8eeb3abc8d,621a6c59f88a44fe,2003-11-21,0,1,0,234,1,1,3,0,0,3,0,0,3,0,0,0,0,0,119.0,115.0
13272,fdb4ea9783c4452a,3738e68d2261e60f,ccdd90bd1fc7dab6,2003-09-26,2,0,0,119,0,0,20,8,13,7,1,1,6,3,0,0,13,5,24.5,83.5
13273,fdb4ea9783c4452a,ccdd90bd1fc7dab6,3738e68d2261e60f,2003-09-26,0,0,0,119,6,0,17,4,16,1,0,0,1,1,2,1,14,3,0.5,91.5
13274,e5b2782426c8109c,349aaa3da11eb587,980b4e712489098e,2003-09-26,0,1,1,232,4,3,22,8,15,7,0,0,7,3,5,5,10,5,76.1,69.0
13275,e5b2782426c8109c,980b4e712489098e,349aaa3da11eb587,2003-09-26,0,0,0,232,1,0,11,1,11,0,0,0,0,0,2,1,9,1,0.0,141.9
13276,ac6fd4c78f0e3198,22e47b53e4ceb27c,cb46dface0e28a2c,2003-09-26,0,0,0,900,3,0,78,25,78,0,0,0,0,0,14,10,64,25,0.0,858.9
13277,ac6fd4c78f0e3198,cb46dface0e28a2c,22e47b53e4ceb27c,2003-09-26,1,0,0,900,0,0,136,39,133,3,0,0,3,3,48,41,85,36,12.1,572.0
13278,6e7eb1720bec2bca,2a542ee8a8b83559,d90b630e0561818b,2003-09-26,1,0,0,114,0,0,34,10,29,5,0,0,5,4,0,0,29,6,4.0,110.0
13279,6e7eb1720bec2bca,d90b630e0561818b,2a542ee8a8b83559,2003-09-26,0,0,0,114,0,0,25,5,25,0,0,0,0,0,2,2,23,5,0.0,110.0
13280,6cd107e2f5886b25,0aa92558424ced9e,2f732dd9210d301f,2003-09-26,0,0,0,1500,12,8,136,65,23,113,8,8,105,63,15,15,8,2,1098.1,220.2
13281,6cd107e2f5886b25,2f732dd9210d301f,0aa92558424ced9e,2003-09-26,0,0,0,1500,6,2,30,3,29,1,0,0,1,1,14,13,15,2,6.8,272.9000000000001
13282,5ac9cf4ffc15ccca,ad32471f01e7b1a5,f57a8a52ca401ed9,2003-09-26,0,0,0,724,0,0,37,9,12,25,0,0,25,8,0,0,12,1,173.3,113.0
13283,5ac9cf4ffc15ccca,f57a8a52ca401ed9,ad32471f01e7b1a5,2003-09-26,0,2,1,724,13,6,24,14,3,21,3,3,18,13,1,0,2,1,403.0,147.7
13284,3cdcaa0a59dfb8ea,04f9fe830cf13482,a566371ba2ad7152,2003-09-26,0,3,0,165,0,0,0,0,0,0,0,0,0,0,0,0,0,0,0.0,18.0
13285,3cdcaa0a59dfb8ea,a566371ba2ad7152,04f9fe830cf13482,2003-09-26,1,0,0,165,1,1,18,10,2,16,0,0,16,10,1,1,1,0,147.0,18.0
13286,180128adae7897db,75bbd2206a15319f,d897897060f10a3a,2003-09-26,0,1,0,215,1,1,6,1,6,0,0,0,0,0,4,3,2,1,0.0,130.0
13287,180128adae7897db,d897897060f10a3a,75bbd2206a15319f,2003-09-26,1,0,0,215,0,0,46,21,28,18,6,6,12,7,10,10,18,14,51.0,96.0
13288,10976fbb37d41c43,e0ec3c3b6b611f7e,eb1723480fa2f96c,2003-09-26,1,1,0,466,2,2,22,12,16,6,0,0,6,4,1,1,15,8,31.5,175.9
13289,10976fbb37d41c43,eb1723480fa2f96c,e0ec3c3b6b611f7e,2003-09-26,0,0,0,466,4,1,49,8,16,33,13,11,20,7,13,13,3,1,206.1,153.5
13290,ffe629a5232a878b,08ae5cd9aef7ddd3,b361180739bed4b0,2003-06-06,0,1,1,119,1,1,1,0,1,0,0,0,0,0,1,1,0,0,0.0,7.0
13291,ffe629a5232a878b,b361180739bed4b0,08ae5cd9aef7ddd3,2003-06-06,0,0,0,119,0,0,0,0,0,0,0,0,0,0,0,0,0,0,0.0,118.0
13292,ed503d1c8963d894,12458872d6afae1b,b4bc2e3353a770b5,2003-06-06,0,0,0,900,5,1,82,22,53,29,2,2,27,15,29,21,24,7,140.7,427.2
13293,ed503d1c8963d894,b4bc2e3353a770b5,12458872d6afae1b,2003-06-06,0,1,0,900,5,2,54,16,39,15,0,0,15,5,3,2,36,11,176.8,370.3
13294,c83cba9573cca196,0aa92558424ced9e,a390eb8a9b2df298,2003-06-06,1,1,0,759,5,4,87,39,72,15,0,0,15,8,8,7,64,31,108.2,557.0
13295,c83cba9573cca196,a390eb8a9b2df298,0aa92558424ced9e,2003-06-06,0,0,0,759,1,0,59,11,59,0,0,0,0,0,12,11,47,11,0.0,526.8
13296,be0507682d0ce713,5f04e3d58d9ce982,7b9aa973e5c04624,2003-06-06,1,3,0,900,0,0,40,10,31,9,3,1,6,3,11,10,20,7,145.0,386.0
13297,be0507682d0ce713,7b9aa973e5c04624,5f04e3d58d9ce982,2003-06-06,0,0,0,900,16,2,12,0,11,1,0,0,1,0,6,3,5,0,95.0,470.0
13298,b5854feb57f40bb4,1ff9589f9065a9ed,e0f7c4f3f67bc808,2003-06-06,0,4,0,175,1,1,7,4,0,7,0,0,7,4,0,0,0,0,158.0,6.0
13299,b5854feb57f40bb4,e0f7c4f3f67bc808,1ff9589f9065a9ed,2003-06-06,0,0,0,175,0,0,1,1,0,1,0,0,1,1,0,0,0,0,11.0,6.0
13300,9fb822537c12d726,1dab0d1d81dd06db,b44f39a5c6596953,2003-06-06,1,0,0,564,0,0,67,19,66,1,1,1,0,0,17,14,49,19,1.9,419.5
13301,9fb822537c12d726,b44f39a5c6596953,1dab0d1d81dd06db,2003-06-06,1,0,0,564,3,1,91,24,75,16,0,0,16,10,24,16,51,14,121.5,357.1
13302,4f5ce22f8384d151,0e041d43a47d2e4b,445a98acb8985970,2003-06-06,0,0,0,116,3,0,9,0,9,0,0,0,0,0,3,2,6,0,0.0,52.0
13303,4f5ce22f8384d151,445a98acb8985970,0e041d43a47d2e4b,2003-06-06,1,0,0,116,1,0,7,1,6,1,0,0,1,1,2,1,4,0,9.0,89.0
13304,400aa8a24e1d8997,05866d8c3a321856,0ee783aa00e468f0,2003-06-06,0,0,0,67,0,0,5,0,5,0,0,0,0,0,3,1,2,0,0.0,64.6
13305,400aa8a24e1d8997,0ee783aa00e468f0,05866d8c3a321856,2003-06-06,1,0,0,67,0,0,12,8,4,8,0,0,8,6,1,1,3,2,2.4,64.0
13306,af59e32a5b3f6065,8f2d9ee27f206f1f,d897897060f10a3a,2003-04-25,0,0,0,160,0,0,14,0,14,0,0,0,0,0,9,6,5,0,0.0,160.0
13307,af59e32a5b3f6065,d897897060f10a3a,8f2d9ee27f206f1f,2003-04-25,1,0,0,160,0,0,38,13,38,0,0,0,0,0,4,3,34,13,0.0,158.0
13308,9f5f9173666ce1b7,73ef22f25d0f70e2,980b4e712489098e,2003-04-25,1,0,0,900,4,2,70,21,64,6,0,0,6,3,3,3,61,18,55.1,461.9
13309,9f5f9173666ce1b7,980b4e712489098e,73ef22f25d0f70e2,2003-04-25,0,0,0,900,2,1,125,46,90,35,4,4,31,20,16,10,74,26,144.1,560.9
13310,863319fd2e711ffc,22e47b53e4ceb27c,9ccdd2ce45903f34,2003-04-25,1,0,0,235,2,1,20,15,1,19,0,0,19,15,1,1,0,0,212.0,23.0
13311,863319fd2e711ffc,9ccdd2ce45903f34,22e47b53e4ceb27c,2003-04-25,0,0,0,235,0,0,2,0,2,0,0,0,0,0,2,2,0,0,0.0,23.0
13312,808245ba66df5f1c,c3ea8deeba00462b,f2925e6db404bf1d,2003-04-25,0,0,1,448,1,1,27,6,26,1,0,0,1,0,14,13,12,6,6.6,321.6
13313,808245ba66df5f1c,f2925e6db404bf1d,c3ea8deeba00462b,2003-04-25,0,0,0,448,2,2,25,3,21,4,0,0,4,2,14,12,7,1,27.4,304.4
13314,5a9657d4faeea2c5,84ac950d4c1722dd,99dd0147dc4ef80c,2003-04-25,0,0,0,900,0,0,57,13,35,22,8,7,14,9,20,18,15,4,164.7,244.0
13315,5a9657d4faeea2c5,99dd0147dc4ef80c,84ac950d4c1722dd,2003-04-25,0,0,0,900,6,3,63,13,25,38,0,0,38,13,19,11,6,0,409.0,326.3
13316,4e75ed154de637e2,4e9fb05d7e5e61b8,e741536153227386,2003-04-25,1,0,0,406,0,0,42,21,42,0,0,0,0,0,1,1,41,21,0.0,393.0
13317,4e75ed154de637e2,e741536153227386,4e9fb05d7e5e61b8,2003-04-25,0,0,0,406,9,0,16,1,16,0,0,0,0,0,8,5,8,1,0.0,209.0
13318,363efd241750c23d,22ee260735da0d58,e0ec3c3b6b611f7e,2003-04-25,0,0,0,900,7,4,89,22,67,22,4,2,18,10,7,5,60,12,346.5,455.1
13319,363efd241750c23d,e0ec3c3b6b611f7e,22ee260735da0d58,2003-04-25,1,9,0,900,11,2,54,20,53,1,0,0,1,0,7,7,46,20,3.9,510.5
13320,00a5e033391bf8df,029880cdbf5ca089,621a6c59f88a44fe,2003-04-25,0,1,0,1500,5,3,39,19,19,20,0,0,20,14,0,0,19,5,277.6,254.0
13321,00a5e033391bf8df,621a6c59f88a44fe,029880cdbf5ca089,2003-04-25,0,1,0,1500,7,5,88,42,36,52,1,1,51,34,1,1,35,8,899.0,323.4
13322,a85a0831580696ff,1ff9589f9065a9ed,b361180739bed4b0,2003-02-28,0,2,1,46,2,0,1,0,1,0,0,0,0,0,0,0,1,0,0.0,8.0
13323,a85a0831580696ff,b361180739bed4b0,1ff9589f9065a9ed,2003-02-28,0,0,0,46,0,0,5,1,4,1,0,0,1,1,0,0,4,0,38.0,8.0
13324,795c682c30d66c19,0e041d43a47d2e4b,1652f3213655b935,2003-02-28,0,2,0,900,13,4,76,31,46,30,7,7,23,17,2,2,44,14,374.7,270.8
13325,795c682c30d66c19,1652f3213655b935,0e041d43a47d2e4b,2003-02-28,0,0,0,900,2,1,73,15,54,19,9,9,10,8,20,20,34,7,17.2,477.3
13326,6a0c5b9079a4128e,40a604761ca7d64d,86dfed7cc24a9fa7,2003-02-28,0,0,0,900,0,0,61,18,61,0,0,0,0,0,12,11,49,18,0.0,795.0
13327,6a0c5b9079a4128e,86dfed7cc24a9fa7,40a604761ca7d64d,2003-02-28,0,0,0,900,28,1,81,5,81,0,0,0,0,0,21,21,60,5,0.0,814.0
13328,63ff2ed92c800ef8,73c7cfa551289285,eb1723480fa2f96c,2003-02-28,0,0,0,1500,8,5,93,44,62,31,11,11,20,15,13,12,49,29,266.6,804.2
13329,63ff2ed92c800ef8,eb1723480fa2f96c,73c7cfa551289285,2003-02-28,0,1,0,1500,7,6,97,19,75,22,8,6,14,10,46,39,29,9,265.8,786.4
13330,62ed2b178310306e,8dc46e9a7895ce1a,d90b630e0561818b,2003-02-28,0,1,0,289,7,0,4,0,4,0,0,0,0,0,1,1,3,0,0.0,90.0
13331,62ed2b178310306e,d90b630e0561818b,8dc46e9a7895ce1a,2003-02-28,1,0,0,289,0,0,23,9,10,13,0,0,13,8,0,0,10,1,83.0,206.0
13332,558ef0822c8fa5b9,b44f39a5c6596953,ccdd90bd1fc7dab6,2003-02-28,0,0,0,900,3,0,37,6,37,0,0,0,0,0,6,6,31,6,0.0,487.2
13333,558ef0822c8fa5b9,ccdd90bd1fc7dab6,b44f39a5c6596953,2003-02-28,0,0,0,900,19,5,38,17,28,10,0,0,10,10,9,7,19,7,333.8,466.0
13334,334cd8572d9842cb,2a542ee8a8b83559,50cc91ce2982785d,2003-02-28,1,0,0,189,0,0,25,10,18,7,0,0,7,5,2,2,16,5,78.0,111.0
13335,334cd8572d9842cb,50cc91ce2982785d,2a542ee8a8b83559,2003-02-28,0,1,0,189,2,0,10,4,10,0,0,0,0,0,3,3,7,4,0.0,111.0
13336,0dade757305afebd,5f04e3d58d9ce982,7d21de9c6d7c98b2,2003-02-28,1,1,1,847,0,0,96,29,83,13,0,0,13,6,23,22,60,23,74.5,558.7
13337,0dade757305afebd,7d21de9c6d7c98b2,5f04e3d58d9ce982,2003-02-28,0,0,0,847,8,2,64,17,57,7,1,1,6,4,15,13,42,13,76.3,565.5
13338,e66eebeff23ceb1e,18aecaf50f52e4c3,9ccdd2ce45903f34,2002-11-22,0,1,1,590,2,2,21,6,0,21,4,4,17,6,0,0,0,0,393.0,34.0
13339,e66eebeff23ceb1e,9ccdd2ce45903f34,18aecaf50f52e4c3,2002-11-22,1,3,0,590,0,0,31,19,6,25,0,0,25,16,0,0,6,3,163.0,34.0
13340,b0bb09e4ca8343af,31ceaf0e670c1578,621a6c59f88a44fe,2002-11-22,0,0,0,300,0,0,2,1,2,0,0,0,0,0,0,0,2,1,0.0,56.0
13341,b0bb09e4ca8343af,621a6c59f88a44fe,31ceaf0e670c1578,2002-11-22,1,0,0,300,1,1,32,14,8,24,7,7,17,11,1,1,7,3,244.0,56.0
13342,9e6f956caa7b549b,2f732dd9210d301f,63b65af1c5cb02cb,2002-11-22,1,1,0,900,5,3,126,64,85,41,2,2,39,24,8,8,77,40,338.2,273.0
13343,9e6f956caa7b549b,63b65af1c5cb02cb,2f732dd9210d301f,2002-11-22,0,0,0,900,1,0,44,8,44,0,0,0,0,0,5,4,39,8,0.0,560.8
13344,9d9c2c8802d21887,3738e68d2261e60f,b4bc2e3353a770b5,2002-11-22,1,0,0,78,0,0,26,7,26,0,0,0,0,0,7,7,19,7,0.0,75.0
13345,9d9c2c8802d21887,b4bc2e3353a770b5,3738e68d2261e60f,2002-11-22,0,0,0,78,0,0,11,0,11,0,0,0,0,0,1,1,10,0,0.0,78.0
13346,9a0865000a3d642e,a390eb8a9b2df298,d468288756ae3982,2002-11-22,1,0,0,175,0,0,35,12,34,1,0,0,1,1,2,1,32,11,3.0,172.0
13347,9a0865000a3d642e,d468288756ae3982,a390eb8a9b2df298,2002-11-22,0,0,0,175,2,0,18,2,18,0,0,0,0,0,9,8,9,2,0.0,172.0
13348,754882d95491d287,7f9f528cb72a6ed1,ccdd90bd1fc7dab6,2002-11-22,0,1,0,250,3,0,0,0,0,0,0,0,0,0,0,0,0,0,0.0,116.30000000000001
13349,754882d95491d287,ccdd90bd1fc7dab6,7f9f528cb72a6ed1,2002-11-22,1,0,0,250,3,2,32,19,12,20,2,2,18,14,4,3,8,5,130.7,54.0
13350,68b141785f76575b,cb6783c39c01d896,f2925e6db404bf1d,2002-11-22,0,0,0,89,0,0,14,0,14,0,0,0,0,0,10,7,4,0,0.0,87.0
13351,68b141785f76575b,f2925e6db404bf1d,cb6783c39c01d896,2002-11-22,1,0,0,89,0,0,11,5,9,2,0,0,2,1,0,0,9,4,2.0,87.0
13352,497a87188392e057,952f6fa06f25a0ec,c3ea8deeba00462b,2002-11-22,0,1,1,105,1,1,0,0,0,0,0,0,0,0,0,0,0,0,0.0,27.0
13353,497a87188392e057,c3ea8deeba00462b,952f6fa06f25a0ec,2002-11-22,0,0,0,105,0,0,2,0,2,0,0,0,0,0,1,1,1,0,0.0,103.0
13354,ffe4379d6bd1e82b,2a542ee8a8b83559,4e9fb05d7e5e61b8,2002-09-27,1,0,0,403,0,0,214,115,214,0,0,0,0,0,28,23,186,115,0.0,400.0
13355,ffe4379d6bd1e82b,4e9fb05d7e5e61b8,2a542ee8a8b83559,2002-09-27,0,0,0,403,1,0,65,21,65,0,0,0,0,0,5,5,60,21,0.0,403.0
13356,e7183e758f6b8bda,0e041d43a47d2e4b,394f55ebca199124,2002-09-27,0,0,0,900,9,6,63,14,51,12,0,0,12,6,5,2,46,8,286.8,422.0
13357,e7183e758f6b8bda,394f55ebca199124,0e041d43a47d2e4b,2002-09-27,0,0,0,900,2,0,70,4,70,0,0,0,0,0,33,28,37,4,0.0,577.2
13358,e06ff3d3f1c0ab69,0aa92558424ced9e,50cc91ce2982785d,2002-09-27,0,0,0,1384,5,5,78,32,34,44,3,3,41,22,5,4,29,10,448.5,238.29999999999995
13359,e06ff3d3f1c0ab69,50cc91ce2982785d,0aa92558424ced9e,2002-09-27,1,1,0,1384,5,4,80,34,30,50,3,2,47,28,5,3,25,6,615.7,270.5
13360,b0ed7f6450ad33c5,73c7cfa551289285,86dfed7cc24a9fa7,2002-09-27,0,0,0,900,1,1,52,12,47,5,1,1,4,2,20,19,27,10,9.8,845.0
13361,b0ed7f6450ad33c5,86dfed7cc24a9fa7,73c7cfa551289285,2002-09-27,0,1,0,900,17,1,49,4,49,0,0,0,0,0,7,4,42,4,0.0,632.2
13362,9e62f31318d21a32,01b39decaf0abf6a,029880cdbf5ca089,2002-09-27,0,0,0,256,0,0,18,6,18,0,0,0,0,0,4,1,14,6,0.0,61.0
13363,9e62f31318d21a32,029880cdbf5ca089,01b39decaf0abf6a,2002-09-27,1,0,0,256,5,1,8,6,1,7,0,0,7,6,0,0,1,0,188.0,68.0
13364,826b03504b9bad4e,40a604761ca7d64d,eb1723480fa2f96c,2002-09-27,0,4,0,900,6,3,24,11,17,7,0,0,7,4,3,0,14,7,91.9,245.2
13365,826b03504b9bad4e,eb1723480fa2f96c,40a604761ca7d64d,2002-09-27,0,0,0,900,0,0,56,25,19,37,4,3,33,20,7,7,12,5,444.8,255.1
13366,56ba0c15cf501669,b44f39a5c6596953,d90b630e0561818b,2002-09-27,0,0,0,300,0,0,28,4,28,0,0,0,0,0,10,10,18,4,0.0,300.0
13367,56ba0c15cf501669,d90b630e0561818b,b44f39a5c6596953,2002-09-27,1,0,0,300,3,0,58,13,58,0,0,0,0,0,5,4,53,13,0.0,289.0
13368,20a6710c50698166,1652f3213655b935,275cafc9de131c83,2002-09-27,1,0,0,18,0,0,13,8,13,0,0,0,0,0,0,0,13,8,0.0,18.0
13369,20a6710c50698166,275cafc9de131c83,1652f3213655b935,2002-09-27,0,0,0,18,0,0,7,0,7,0,0,0,0,0,1,1,6,0,0.0,18.0
13370,fb93d1cafcc6b455,918db42c3637916f,99dd0147dc4ef80c,2002-07-13,0,0,0,398,0,0,12,1,12,0,0,0,0,0,5,4,7,1,0.0,140.4
13371,fb93d1cafcc6b455,99dd0147dc4ef80c,918db42c3637916f,2002-07-13,0,3,1,398,3,2,29,8,20,9,0,0,9,6,8,1,12,2,172.6,187.0
13372,b5c4fbd6e1d94594,5bd533d50c8e7b8a,8f2d9ee27f206f1f,2002-07-13,0,2,0,900,0,0,20,3,16,4,2,2,2,2,10,9,6,1,5.1,178.10000000000002
13373,b5c4fbd6e1d94594,8f2d9ee27f206f1f,5bd533d50c8e7b8a,2002-07-13,0,0,0,900,5,3,98,47,22,76,15,14,61,39,12,9,10,8,707.9,65.9
13374,90b36806779330b9,18aecaf50f52e4c3,4b4fc3ddc307bc73,2002-07-13,0,0,0,900,22,4,53,24,25,28,1,1,27,14,7,5,18,10,418.6,223.9
13375,90b36806779330b9,4b4fc3ddc307bc73,18aecaf50f52e4c3,2002-07-13,0,1,0,900,1,0,66,20,43,23,0,0,23,10,10,9,33,10,93.1,315.4
13376,38d8b19a1ef5942a,9ccdd2ce45903f34,ce783bf73b5131f9,2002-07-13,1,0,0,10,0,0,6,4,2,4,0,0,4,3,0,0,2,1,1.0,9.0
13377,38d8b19a1ef5942a,ce783bf73b5131f9,9ccdd2ce45903f34,2002-07-13,0,0,0,10,0,0,1,0,1,0,0,0,0,0,0,0,1,0,0.0,9.0
13378,2a2f50039ac636d0,1ff9589f9065a9ed,b4bc2e3353a770b5,2002-07-13,0,3,0,275,5,1,10,1,10,0,0,0,0,0,6,5,4,1,0.0,134.2
13379,2a2f50039ac636d0,b4bc2e3353a770b5,1ff9589f9065a9ed,2002-07-13,1,0,0,275,0,0,44,28,17,27,1,1,26,19,5,5,12,9,125.8,98.0
13380,1531cb3152157ada,817e0bdf08efce2e,d468288756ae3982,2002-07-13,0,0,0,900,1,0,20,3,18,2,0,0,2,1,5,4,13,2,3.0,119.0
13381,1531cb3152157ada,d468288756ae3982,817e0bdf08efce2e,2002-07-13,0,0,0,900,4,4,90,36,18,72,1,1,71,32,6,5,12,4,778.0,119.0
13382,0f6dd5d9a96ceb9d,621a6c59f88a44fe,952f6fa06f25a0ec,2002-07-13,1,1,0,1117,6,4,77,47,6,71,11,11,60,46,1,0,5,1,963.4,105.3
13383,0f6dd5d9a96ceb9d,952f6fa06f25a0ec,621a6c59f88a44fe,2002-07-13,0,1,0,1117,1,0,9,3,7,2,0,0,2,2,0,0,7,1,34.7,101.60000000000002
13384,5637c7b3e4131941,5f04e3d58d9ce982,9a967e8e43dcef63,2002-06-22,1,0,0,79,0,0,9,3,6,3,0,0,3,1,3,3,3,2,9.0,70.0
13385,5637c7b3e4131941,9a967e8e43dcef63,5f04e3d58d9ce982,2002-06-22,0,0,0,79,0,0,7,1,7,0,0,0,0,0,0,0,7,1,0.0,70.0
13386,3c27780140809908,5d7c18191b8aa432,c3ea8deeba00462b,2002-06-22,0,0,0,145,1,1,5,2,1,4,0,0,4,1,0,0,1,1,123.0,22.0
13387,3c27780140809908,c3ea8deeba00462b,5d7c18191b8aa432,2002-06-22,0,1,1,145,0,0,5,1,5,0,0,0,0,0,2,2,3,1,0.0,19.0
13388,37ae54e5a84fd646,21b1132949f2a9b0,f2925e6db404bf1d,2002-06-22,0,0,0,327,3,1,37,2,37,0,0,0,0,0,11,9,26,2,0.0,254.8
13389,37ae54e5a84fd646,f2925e6db404bf1d,21b1132949f2a9b0,2002-06-22,1,0,0,327,1,1,51,16,37,14,0,0,14,8,12,12,25,8,46.2,205.0
13390,2d1c4027b8e50a0d,0ee783aa00e468f0,a390eb8a9b2df298,2002-06-22,0,0,0,900,4,3,42,12,37,5,0,0,5,3,10,8,27,9,78.8,714.1
13391,2d1c4027b8e50a0d,a390eb8a9b2df298,0ee783aa00e468f0,2002-06-22,1,0,0,900,0,0,78,7,71,7,5,4,2,2,35,32,36,5,59.9,607.2
13392,255da7afa89eb0e5,01b39decaf0abf6a,1975c2272ba40e71,2002-06-22,1,0,0,900,0,0,46,24,11,35,2,1,33,20,1,1,10,4,580.8,286.0
13393,255da7afa89eb0e5,1975c2272ba40e71,01b39decaf0abf6a,2002-06-22,0,2,0,900,10,1,8,0,8,0,0,0,0,0,0,0,8,0,0.0,215.20000000000005
13394,0e30b22cd0987640,253de74457bd6374,94070f6544c4b2a5,2002-06-22,1,1,0,514,0,0,102,52,24,78,5,4,73,45,4,4,20,7,380.8,99.0
13395,0e30b22cd0987640,94070f6544c4b2a5,253de74457bd6374,2002-06-22,0,0,0,514,0,0,31,5,31,0,0,0,0,0,6,6,25,5,0.0,129.2
13396,fe60fd0ee67902dc,01b39decaf0abf6a,21b1132949f2a9b0,2002-05-10,1,0,0,27,0,0,12,10,1,11,0,0,11,9,0,0,1,1,13.0,14.0
13397,fe60fd0ee67902dc,21b1132949f2a9b0,01b39decaf0abf6a,2002-05-10,0,0,0,27,0,0,2,0,2,0,0,0,0,0,0,0,2,0,0.0,14.0
13398,b82abffcf66db401,394f55ebca199124,5f2f0da6fd6a84fd,2002-05-10,1,8,0,747,2,2,72,20,52,20,2,1,18,12,31,22,21,8,263.0,339.5
13399,b82abffcf66db401,5f2f0da6fd6a84fd,394f55ebca199124,2002-05-10,0,1,0,747,2,1,46,3,45,1,0,0,1,0,6,2,39,3,52.5,379.0
13400,92de601366ced6dc,73c7cfa551289285,ed73c85164a5f5a4,2002-05-10,1,0,0,503,0,0,56,17,28,28,8,6,20,11,16,16,12,6,118.9,273.8
13401,92de601366ced6dc,ed73c85164a5f5a4,73c7cfa551289285,2002-05-10,0,0,0,503,8,3,8,2,7,1,0,0,1,1,4,4,3,1,21.2,278.1
13402,56812137775844c8,1652f3213655b935,7aa88401f93ce836,2002-05-10,1,0,0,179,2,0,23,10,14,9,0,0,9,7,4,1,10,3,51.0,125.0
13403,56812137775844c8,7aa88401f93ce836,1652f3213655b935,2002-05-10,0,1,0,179,1,1,15,7,13,2,0,0,2,2,2,2,11,5,3.0,125.0
13404,5550e3d9ff8b965c,f2925e6db404bf1d,f2c8ebbeafd45f2b,2002-05-10,1,0,0,900,8,6,153,52,135,18,0,0,18,9,16,12,119,43,82.1,631.0
13405,5550e3d9ff8b965c,f2c8ebbeafd45f2b,f2925e6db404bf1d,2002-05-10,0,1,0,900,3,0,130,18,130,0,0,0,0,0,47,37,83,18,0.0,731.9
13406,188537d906b30a7c,0e041d43a47d2e4b,85d905f7c4f5a1af,2002-05-10,0,1,0,693,3,0,66,6,61,5,1,0,4,3,30,29,31,3,39.1,240.4
13407,188537d906b30a7c,85d905f7c4f5a1af,0e041d43a47d2e4b,2002-05-10,1,2,1,693,2,2,40,15,18,22,0,0,22,8,2,2,16,7,155.6,462.9
13408,18273af728dda0c8,50cc91ce2982785d,b76ed59283d3559c,2002-05-10,1,1,0,505,5,3,33,18,4,29,1,1,28,17,2,0,2,1,415.7,67.7
13409,18273af728dda0c8,b76ed59283d3559c,50cc91ce2982785d,2002-05-10,0,0,0,505,1,1,11,3,9,2,0,0,2,2,3,3,6,1,7.3,56.30000000000001
13410,1228c4297882e8ba,5f04e3d58d9ce982,eb1723480fa2f96c,2002-05-10,0,1,0,900,1,1,23,5,21,2,0,0,2,1,9,8,12,4,35.4,433.8
13411,1228c4297882e8ba,eb1723480fa2f96c,5f04e3d58d9ce982,2002-05-10,0,1,0,900,6,3,32,8,21,11,2,1,9,6,11,10,10,2,236.2,456.6
13412,efc865fce64b5848,3738e68d2261e60f,b44f39a5c6596953,2002-03-22,0,0,0,705,0,0,95,10,95,0,0,0,0,0,47,28,48,10,0.0,705.0
13413,efc865fce64b5848,b44f39a5c6596953,3738e68d2261e60f,2002-03-22,1,0,0,705,0,0,80,10,80,0,0,0,0,0,25,17,55,10,0.0,705.0
13414,ef83377d584ec055,1a225f04aa6e0739,86dfed7cc24a9fa7,2002-03-22,0,0,0,178,0,0,1,0,1,0,0,0,0,0,0,0,1,0,0.0,25.0
13415,ef83377d584ec055,86dfed7cc24a9fa7,1a225f04aa6e0739,2002-03-22,0,3,1,178,3,1,8,2,2,6,0,0,6,2,0,0,2,0,142.0,36.0
13416,e7833d5728f3ebef,621a6c59f88a44fe,85e26e2468b4e82f,2002-03-22,1,0,0,1081,11,9,58,34,13,45,0,0,45,27,2,2,11,7,931.3,129.0
13417,e7833d5728f3ebef,85e26e2468b4e82f,621a6c59f88a44fe,2002-03-22,1,0,0,1081,0,0,12,4,12,0,0,0,0,0,1,1,11,4,0.0,149.70000000000005
13418,87f39e0d82349c3b,029880cdbf5ca089,95eb112a85601a0a,2002-03-22,0,0,0,900,14,7,30,16,12,18,1,1,17,13,4,4,8,3,547.5,170.0
13419,87f39e0d82349c3b,95eb112a85601a0a,029880cdbf5ca089,2002-03-22,0,0,0,900,0,0,20,1,20,0,0,0,0,0,7,3,13,1,0.0,350.5
13420,7468f870b08aaccc,1ff9589f9065a9ed,6291ac0a3726732f,2002-03-22,0,1,1,46,0,0,6,1,6,0,0,0,0,0,3,3,3,1,0.0,44.0
13421,7468f870b08aaccc,6291ac0a3726732f,1ff9589f9065a9ed,2002-03-22,0,0,0,46,1,1,1,0,1,0,0,0,0,0,0,0,1,0,0.0,27.0
13422,3c2ac653409cf5f2,0e041d43a47d2e4b,cedfdf8d423d500c,2002-03-22,1,0,0,189,1,1,40,19,2,38,1,1,37,19,0,0,2,0,170.0,19.0
13423,3c2ac653409cf5f2,cedfdf8d423d500c,0e041d43a47d2e4b,2002-03-22,0,0,0,189,0,0,2,0,2,0,0,0,0,0,1,1,1,0,0.0,19.0
13424,38dbb6f2e1456acd,0aa92558424ced9e,ad3f53c454cbbead,2002-03-22,0,0,0,575,3,1,21,13,9,12,0,0,12,10,6,5,3,3,262.8,45.599999999999994
13425,38dbb6f2e1456acd,ad3f53c454cbbead,0aa92558424ced9e,2002-03-22,1,1,0,575,0,0,75,31,17,58,2,2,56,29,13,11,4,2,91.4,197.2
13426,1c0f5152b0bbef05,817e0bdf08efce2e,8f2d9ee27f206f1f,2002-03-22,0,0,0,126,0,0,8,0,8,0,0,0,0,0,4,4,4,0,0.0,57.3
13427,1c0f5152b0bbef05,8f2d9ee27f206f1f,817e0bdf08efce2e,2002-03-22,1,0,0,126,0,0,13,5,7,6,0,0,6,5,3,2,4,0,68.7,23.0
13428,f67fa758cc79cd65,6859f67468ba8489,d468288756ae3982,2002-01-11,0,0,0,900,1,1,39,18,0,39,0,0,39,18,0,0,0,0,767.0,133.0
13429,f67fa758cc79cd65,d468288756ae3982,6859f67468ba8489,2002-01-11,0,5,0,900,0,0,3,1,2,1,0,0,1,1,1,1,1,0,0.0,133.0
13430,e1bc211f43378ee7,44260175069b6276,73c7cfa551289285,2002-01-11,0,0,0,1500,1,1,98,28,73,25,2,2,23,11,8,8,65,17,447.3,717.4
13431,e1bc211f43378ee7,73c7cfa551289285,44260175069b6276,2002-01-11,0,2,0,1500,10,7,93,35,82,11,0,0,11,7,17,14,65,28,281.6,668.7
13432,cfa9bc77c803956e,275cafc9de131c83,85d905f7c4f5a1af,2002-01-11,0,0,0,344,0,0,33,3,33,0,0,0,0,0,13,11,20,3,0.0,237.1
13433,cfa9bc77c803956e,85d905f7c4f5a1af,275cafc9de131c83,2002-01-11,1,0,0,344,7,2,12,8,8,4,0,0,4,4,1,1,7,4,106.9,157.0
13434,8762b96aaefb03af,31ceaf0e670c1578,b19fc66613dc75b9,2002-01-11,0,0,0,900,3,3,33,16,7,26,1,1,25,11,0,0,7,5,782.0,116.7
13435,8762b96aaefb03af,b19fc66613dc75b9,31ceaf0e670c1578,2002-01-11,0,1,0,900,2,0,23,2,22,1,0,0,1,1,9,6,13,1,1.3,110.0
13436,1f299942446461e9,c75b99887c8c3f5a,ce783bf73b5131f9,2002-01-11,0,2,0,374,2,2,10,4,2,8,1,1,7,3,1,1,1,1,331.0,43.0
13437,1f299942446461e9,ce783bf73b5131f9,c75b99887c8c3f5a,2002-01-11,0,1,1,374,1,0,3,1,3,0,0,0,0,0,0,0,3,1,0.0,39.0
13438,17ba2950b7f6d64a,5f2f0da6fd6a84fd,91186547a7f3f758,2002-01-11,1,0,0,421,0,0,29,5,24,5,0,0,5,1,0,0,24,4,105.0,274.0
13439,17ba2950b7f6d64a,91186547a7f3f758,5f2f0da6fd6a84fd,2002-01-11,0,5,0,421,4,1,35,6,35,0,0,0,0,0,6,6,29,6,0.0,271.0
13440,0ff019f37961b954,50cc91ce2982785d,cbfd1d34356a004c,2002-01-11,1,1,0,780,4,3,65,26,43,22,3,2,19,15,15,14,28,11,191.3,380.0
13441,0ff019f37961b954,cbfd1d34356a004c,50cc91ce2982785d,2002-01-11,0,0,0,780,6,2,20,2,20,0,0,0,0,0,7,5,13,2,0.0,352.7
13442,0fe4e788b16c03cd,7aa88401f93ce836,a390eb8a9b2df298,2002-01-11,0,0,0,900,0,0,69,14,69,0,0,0,0,0,16,12,53,14,0.0,900.0
13443,0fe4e788b16c03cd,a390eb8a9b2df298,7aa88401f93ce836,2002-01-11,0,0,0,900,0,0,144,17,144,0,0,0,0,0,37,29,107,17,0.0,900.0
13444,f20bd0b549e1a97d,73c7cfa551289285,eb1723480fa2f96c,2001-11-02,1,0,0,11,1,1,6,5,2,4,0,0,4,4,0,0,2,1,2.0,9.0
13445,f20bd0b549e1a97d,eb1723480fa2f96c,73c7cfa551289285,2001-11-02,0,0,0,11,0,0,1,0,1,0,0,0,0,0,0,0,1,0,0.0,9.0
13446,e4628e64a2ef7100,0e041d43a47d2e4b,1652f3213655b935,2001-11-02,0,0,0,900,9,4,94,49,52,42,9,8,33,25,16,14,36,24,353.6,226.5
13447,e4628e64a2ef7100,1652f3213655b935,0e041d43a47d2e4b,2001-11-02,1,2,0,900,1,0,54,25,40,14,1,1,13,8,6,6,34,17,50.5,398.4
13448,c3b2a72cc291db4e,ad3f53c454cbbead,afaad7d6a581e307,2001-11-02,1,1,0,565,2,2,20,12,6,14,1,1,13,11,4,4,2,1,255.1,85.5
13449,c3b2a72cc291db4e,afaad7d6a581e307,ad3f53c454cbbead,2001-11-02,0,1,0,565,2,1,14,3,5,9,0,0,9,3,4,3,1,0,151.5,107.9
13450,bce4808806f88c99,0aa92558424ced9e,b44f39a5c6596953,2001-11-02,1,0,0,802,5,3,52,27,30,22,0,0,22,19,14,14,16,8,294.5,454.0
13451,bce4808806f88c99,b44f39a5c6596953,0aa92558424ced9e,2001-11-02,0,0,0,802,1,1,34,8,34,0,0,0,0,0,6,5,28,8,0.0,504.5
13452,7ea81958dfb80d70,8f2d9ee27f206f1f,e56df3c1d8b4b1cc,2001-11-02,0,4,1,355,0,0,4,2,4,0,0,0,0,0,2,2,2,2,0.0,82.0
13453,7ea81958dfb80d70,e56df3c1d8b4b1cc,8f2d9ee27f206f1f,2001-11-02,0,0,0,355,3,2,8,4,3,5,0,0,5,2,0,0,3,2,273.0,82.0
13454,7c76b3c48a5583df,50cc91ce2982785d,6291ac0a3726732f,2001-11-02,1,1,0,542,6,5,43,24,5,38,1,1,37,23,1,1,4,1,424.8,60.0
13455,7c76b3c48a5583df,6291ac0a3726732f,50cc91ce2982785d,2001-11-02,0,1,0,542,0,0,6,1,3,3,2,2,1,1,1,1,2,0,46.0,71.19999999999999
13456,586635087cdfbbcc,1ff9589f9065a9ed,20ec0061400178ca,2001-11-02,0,1,1,65,0,0,7,1,7,0,0,0,0,0,2,2,5,1,0.0,28.0
13457,586635087cdfbbcc,20ec0061400178ca,1ff9589f9065a9ed,2001-11-02,0,0,0,65,0,0,2,1,2,0,0,0,0,0,0,0,2,1,0.0,65.0
13458,57f4aac17f067c11,621a6c59f88a44fe,952f6fa06f25a0ec,2001-11-02,1,1,0,387,4,4,14,7,3,11,1,1,10,5,0,0,3,2,206.5,143.0
13459,57f4aac17f067c11,952f6fa06f25a0ec,621a6c59f88a44fe,2001-11-02,0,1,0,387,0,0,7,0,7,0,0,0,0,0,2,2,5,0,0.0,87.5
13460,fb1fe28a5d97db51,91186547a7f3f758,ce783bf73b5131f9,2001-09-28,0,1,1,246,1,1,4,0,4,0,0,0,0,0,4,4,0,0,0.0,21.0
13461,fb1fe28a5d97db51,ce783bf73b5131f9,91186547a7f3f758,2001-09-28,0,2,0,246,2,2,4,1,3,1,0,0,1,0,0,0,3,1,38.0,208.0
13462,ea64af61ed03453f,2f732dd9210d301f,ccdd90bd1fc7dab6,2001-09-28,0,0,0,1500,9,5,84,17,64,20,5,5,15,7,42,42,22,10,375.1,206.0
13463,ea64af61ed03453f,ccdd90bd1fc7dab6,2f732dd9210d301f,2001-09-28,0,0,0,1500,6,1,49,9,49,0,0,0,0,0,11,10,38,9,0.0,1054.9
13464,a6a4be467d12ea5c,85d905f7c4f5a1af,a390eb8a9b2df298,2001-09-28,0,0,0,900,20,2,30,13,27,3,0,0,3,1,2,2,25,12,26.5,755.6
13465,a6a4be467d12ea5c,a390eb8a9b2df298,85d905f7c4f5a1af,2001-09-28,1,0,0,900,0,0,78,15,67,11,2,2,9,7,13,10,54,8,91.4,765.5
13466,9cd5a54a285653c2,263ebd4a669e1e98,40a604761ca7d64d,2001-09-28,0,2,0,900,7,2,45,12,38,7,2,2,5,2,7,5,31,10,96.0,475.0
13467,9cd5a54a285653c2,40a604761ca7d64d,263ebd4a669e1e98,2001-09-28,0,0,0,900,1,1,69,41,59,10,0,0,10,7,1,1,58,34,82.0,435.0
13468,970c2beda72908c6,44260175069b6276,8a8a84b743ae7699,2001-09-28,0,1,0,1500,0,0,60,18,38,22,9,8,13,7,2,1,36,11,845.7,483.0
13469,970c2beda72908c6,8a8a84b743ae7699,44260175069b6276,2001-09-28,0,3,0,1500,12,2,48,4,45,3,0,0,3,2,14,11,31,2,56.0,542.3
13470,3b63f4fb24694d74,5f04e3d58d9ce982,86dfed7cc24a9fa7,2001-09-28,0,0,0,900,0,0,14,4,13,1,0,0,1,1,5,5,8,3,17.6,268.0
13471,3b63f4fb24694d74,86dfed7cc24a9fa7,5f04e3d58d9ce982,2001-09-28,0,3,0,900,12,3,17,3,7,10,4,4,6,2,3,2,4,1,509.0,373.4
13472,37cb7ce0f0b70640,275cafc9de131c83,31ceaf0e670c1578,2001-09-28,0,4,0,1500,1,1,125,38,101,24,4,3,20,13,35,29,66,25,172.7,1025.0
13473,37cb7ce0f0b70640,31ceaf0e670c1578,275cafc9de131c83,2001-09-28,0,0,0,1500,19,7,25,5,25,0,0,0,0,0,5,4,20,5,0.0,631.3
13474,2e2b70a5294012bd,6ad9058b7c7898b0,95eb112a85601a0a,2001-09-28,0,0,0,315,0,0,5,0,5,0,0,0,0,0,2,1,3,0,0.0,63.0
13475,2e2b70a5294012bd,95eb112a85601a0a,6ad9058b7c7898b0,2001-09-28,1,0,0,315,1,0,8,3,6,2,0,0,2,2,5,5,1,1,252.0,63.0
13476,c9d2abc25651a1a7,3738e68d2261e60f,50cc91ce2982785d,2001-06-29,0,0,0,683,1,0,26,10,26,0,0,0,0,0,1,1,25,10,0.0,263.1
13477,c9d2abc25651a1a7,50cc91ce2982785d,3738e68d2261e60f,2001-06-29,1,1,0,683,8,2,50,23,22,28,2,2,26,18,5,5,17,5,401.9,238.0
13478,b7419e18d9461277,7b6e40a73b567072,cedfdf8d423d500c,2001-06-29,0,0,0,462,0,0,42,1,42,0,0,0,0,0,16,13,26,1,0.0,462.0
13479,b7419e18d9461277,cedfdf8d423d500c,7b6e40a73b567072,2001-06-29,1,0,0,462,1,1,16,7,16,0,0,0,0,0,3,3,13,7,0.0,223.0
13480,6afdefcb6728467e,1fe7adb23b3eedfb,ccdd90bd1fc7dab6,2001-06-29,0,0,0,900,2,0,3,0,3,0,0,0,0,0,3,1,0,0,0.0,78.79999999999995
13481,6afdefcb6728467e,ccdd90bd1fc7dab6,1fe7adb23b3eedfb,2001-06-29,0,0,0,900,3,3,28,12,3,25,3,3,22,12,3,2,0,0,821.2,46.0
13482,6314e63003745e80,263ebd4a669e1e98,eb1723480fa2f96c,2001-06-29,0,1,0,108,0,0,13,4,13,0,0,0,0,0,2,2,11,4,0.0,58.9
13483,6314e63003745e80,eb1723480fa2f96c,263ebd4a669e1e98,2001-06-29,1,0,0,108,4,2,17,7,7,10,0,0,10,6,1,1,6,1,49.1,54.0
13484,5e80048e6a5681b8,40a604761ca7d64d,73c7cfa551289285,2001-06-29,0,0,0,162,1,1,5,1,2,3,0,0,3,1,0,0,2,0,125.0,34.3
13485,5e80048e6a5681b8,73c7cfa551289285,40a604761ca7d64d,2001-06-29,1,0,0,162,1,0,8,3,6,2,0,0,2,2,3,3,3,1,2.7,29.0
13486,40dbe22895f98978,2f732dd9210d301f,817e0bdf08efce2e,2001-06-29,1,0,0,212,1,1,59,32,12,47,1,1,46,30,3,2,9,2,161.7,40.0
13487,40dbe22895f98978,817e0bdf08efce2e,2f732dd9210d301f,2001-06-29,0,0,0,212,0,0,8,2,8,0,0,0,0,0,5,1,3,2,0.0,50.30000000000001
13488,09da511e611b4eb1,ad3f53c454cbbead,d5ed14b2153c6ed2,2001-06-29,0,1,1,261,1,1,17,10,1,16,0,0,16,10,0,0,1,0,215.0,46.0
13489,09da511e611b4eb1,d5ed14b2153c6ed2,ad3f53c454cbbead,2001-06-29,0,0,0,261,0,0,1,0,1,0,0,0,0,0,1,1,0,0,0.0,14.0
13490,085d6ea4d12917a2,26eddcda9d6b2ffe,6ad9058b7c7898b0,2001-06-29,0,0,0,65,1,0,2,0,2,0,0,0,0,0,2,2,0,0,0.0,65.0
13491,085d6ea4d12917a2,6ad9058b7c7898b0,26eddcda9d6b2ffe,2001-06-29,0,2,1,65,0,0,3,1,3,0,0,0,0,0,0,0,3,1,0.0,33.0
13492,ef99fb08c6b06963,0e041d43a47d2e4b,91186547a7f3f758,2001-05-04,0,0,0,861,5,5,49,15,23,26,5,1,21,11,8,6,15,4,515.8,127.0
13493,ef99fb08c6b06963,91186547a7f3f758,0e041d43a47d2e4b,2001-05-04,0,0,0,861,1,0,18,6,15,3,0,0,3,3,5,3,10,3,0.0,345.20000000000005
13494,c0be83e56601e7ce,6859f67468ba8489,a390eb8a9b2df298,2001-05-04,0,0,0,78,2,0,0,0,0,0,0,0,0,0,0,0,0,0,0.0,38.0
13495,c0be83e56601e7ce,a390eb8a9b2df298,6859f67468ba8489,2001-05-04,1,0,0,78,0,0,5,2,5,0,0,0,0,0,1,1,4,2,0.0,76.0
13496,97a4b37cee48ea0b,6bb1d2b714d4b3bc,73c7cfa551289285,2001-05-04,0,0,0,297,1,0,7,0,7,0,0,0,0,0,3,3,4,0,0.0,54.80000000000001
13497,97a4b37cee48ea0b,73c7cfa551289285,6bb1d2b714d4b3bc,2001-05-04,1,0,0,297,2,2,32,18,11,21,1,1,20,15,3,3,8,3,236.2,27.0
13498,7a018ddd9239e45f,6291ac0a3726732f,d5ed14b2153c6ed2,2001-05-04,0,0,0,388,4,1,9,6,3,6,0,0,6,5,1,0,2,1,287.0,93.7
13499,7a018ddd9239e45f,d5ed14b2153c6ed2,6291ac0a3726732f,2001-05-04,2,0,0,388,0,0,26,5,24,2,0,0,2,2,12,10,12,3,7.3,79.0
13500,6f62436ae042009b,0aa92558424ced9e,b44f39a5c6596953,2001-05-04,0,0,0,1500,15,3,118,51,83,35,0,0,35,21,22,18,61,30,274.3,921.8
13501,6f62436ae042009b,b44f39a5c6596953,0aa92558424ced9e,2001-05-04,1,0,0,1500,0,0,108,27,99,9,1,1,8,5,17,14,82,22,100.2,969.7
13502,49693a06fc1d8906,21b1132949f2a9b0,6ad9058b7c7898b0,2001-05-04,0,3,0,900,0,0,18,2,18,0,0,0,0,0,0,0,18,2,0.0,276.79999999999995
13503,49693a06fc1d8906,6ad9058b7c7898b0,21b1132949f2a9b0,2001-05-04,0,0,0,900,5,5,48,27,9,39,1,1,38,24,0,0,9,3,556.2,301.0
13504,34ab72077963ee74,952f6fa06f25a0ec,cedfdf8d423d500c,2001-05-04,0,1,1,770,6,4,52,7,46,6,0,0,6,1,7,7,39,6,135.5,488.0
13505,34ab72077963ee74,cedfdf8d423d500c,952f6fa06f25a0ec,2001-05-04,0,0,0,770,0,0,76,16,74,2,0,0,2,1,12,12,62,15,11.0,590.5
13506,0434a68809885ea1,7b6e40a73b567072,86dfed7cc24a9fa7,2001-05-04,2,0,0,891,3,2,33,6,22,11,0,0,11,2,16,12,6,4,234.9,437.7
13507,0434a68809885ea1,86dfed7cc24a9fa7,7b6e40a73b567072,2001-05-04,0,3,0,891,13,2,25,5,23,2,0,0,2,2,7,5,16,3,90.3,385.1
13508,f8820294bbe01486,2f732dd9210d301f,8f2d9ee27f206f1f,2001-02-23,1,0,0,32,1,1,7,4,5,2,0,0,2,2,3,3,2,2,0.3,31.0
13509,f8820294bbe01486,8f2d9ee27f206f1f,2f732dd9210d301f,2001-02-23,0,0,0,32,0,0,1,0,1,0,0,0,0,0,1,0,0,0,0.0,30.7
13510,bfb468c3427faa50,029880cdbf5ca089,cb6783c39c01d896,2001-02-23,0,0,1,587,5,4,16,11,4,12,0,0,12,10,1,1,3,1,512.3,32.0
13511,bfb468c3427faa50,cb6783c39c01d896,029880cdbf5ca089,2001-02-23,0,0,0,587,0,0,7,0,7,0,0,0,0,0,2,1,5,0,0.0,74.70000000000005
13512,a949b05c64e43131,1652f3213655b935,e09dbbd5fe3f0fe2,2001-02-23,0,0,0,600,2,2,54,13,2,52,25,25,27,13,1,1,1,0,584.0,16.0
13513,a949b05c64e43131,e09dbbd5fe3f0fe2,1652f3213655b935,2001-02-23,0,0,0,600,0,0,3,0,3,0,0,0,0,0,3,2,0,0,0.0,16.0
13514,a38ec65ac140fcf8,44260175069b6276,eb1723480fa2f96c,2001-02-23,0,0,0,1500,0,0,131,38,126,5,0,0,5,1,13,12,113,37,31.4,1261.0
13515,a38ec65ac140fcf8,eb1723480fa2f96c,44260175069b6276,2001-02-23,0,0,0,1500,25,3,101,29,99,2,0,0,2,2,31,21,68,27,19.0,1354.6
13516,75a401066ad784f6,ad3f53c454cbbead,b44f39a5c6596953,2001-02-23,0,0,0,561,0,0,101,17,101,0,0,0,0,0,27,22,74,17,0.0,561.0
13517,75a401066ad784f6,b44f39a5c6596953,ad3f53c454cbbead,2001-02-23,1,0,0,561,0,0,86,18,86,0,0,0,0,0,19,13,67,18,0.0,560.0
13518,74d0da1f9df17b9e,263ebd4a669e1e98,a8fa0c4e95512806,2001-02-23,0,1,1,100,2,1,6,0,6,0,0,0,0,0,3,3,3,0,0.0,49.0
13519,74d0da1f9df17b9e,a8fa0c4e95512806,263ebd4a669e1e98,2001-02-23,0,0,0,100,1,0,3,0,3,0,0,0,0,0,3,2,0,0,0.0,84.0
13520,651da45cc83ce011,4604ab1de9058474,afaad7d6a581e307,2001-02-23,0,0,0,207,0,0,1,0,1,0,0,0,0,0,0,0,1,0,0.0,22.0
13521,651da45cc83ce011,afaad7d6a581e307,4604ab1de9058474,2001-02-23,1,0,0,207,0,0,23,4,23,0,0,0,0,0,17,16,6,4,0.0,206.0
13522,4a1f37200bc69376,817e0bdf08efce2e,8d26912cd2aeb366,2001-02-23,0,2,1,172,0,0,5,0,5,0,0,0,0,0,2,2,3,0,0.0,22.0
13523,4a1f37200bc69376,8d26912cd2aeb366,817e0bdf08efce2e,2001-02-23,0,0,0,172,0,0,10,3,8,2,0,0,2,2,2,1,6,1,150.0,22.0
13524,c39728802a8409ee,0e041d43a47d2e4b,e06fd1260ac865a7,2000-12-16,1,0,0,178,0,0,26,17,3,23,0,0,23,16,0,0,3,1,120.8,52.0
13525,c39728802a8409ee,e06fd1260ac865a7,0e041d43a47d2e4b,2000-12-16,0,0,0,178,1,0,1,0,1,0,0,0,0,0,0,0,1,0,0.0,45.2
13526,9ea4087371f7a892,a390eb8a9b2df298,cbfd1d34356a004c,2000-12-16,0,0,0,900,0,0,77,18,71,6,2,2,4,4,27,22,44,14,39.6,801.0
13527,9ea4087371f7a892,cbfd1d34356a004c,a390eb8a9b2df298,2000-12-16,0,0,0,900,17,1,20,5,20,0,0,0,0,0,1,1,19,5,0.0,797.4
13528,5a4f6ff454b1eeb8,263ebd4a669e1e98,4f74c8be51db8a37,2000-12-16,1,0,0,144,1,1,12,8,0,12,0,0,12,8,0,0,0,0,116.0,28.0
13529,5a4f6ff454b1eeb8,4f74c8be51db8a37,263ebd4a669e1e98,2000-12-16,0,0,0,144,0,0,2,0,2,0,0,0,0,0,0,0,2,0,0.0,28.0
13530,53a736ebc356cc4a,9f488f520ed25bbf,cedfdf8d423d500c,2000-12-16,0,0,0,418,4,0,7,0,7,0,0,0,0,0,4,3,3,0,0.0,173.3
13531,53a736ebc356cc4a,cedfdf8d423d500c,9f488f520ed25bbf,2000-12-16,0,2,1,418,3,3,28,15,16,12,0,0,12,10,3,1,13,5,243.7,154.0
13532,3c49bf20e4442a81,621a6c59f88a44fe,8a8a84b743ae7699,2000-12-16,0,0,0,20,1,1,1,0,0,1,1,1,0,0,0,0,0,0,11.0,9.0
13533,3c49bf20e4442a81,8a8a84b743ae7699,621a6c59f88a44fe,2000-12-16,0,1,1,20,0,0,0,0,0,0,0,0,0,0,0,0,0,0,0.0,9.0
13534,2783ccf179321171,1fe7adb23b3eedfb,2f732dd9210d301f,2000-12-16,1,0,0,112,0,0,4,1,4,0,0,0,0,0,2,1,2,1,0.0,16.0
13535,2783ccf179321171,2f732dd9210d301f,1fe7adb23b3eedfb,2000-12-16,0,2,1,112,2,2,22,16,1,21,0,0,21,16,0,0,1,0,95.0,17.0
13536,019eca4a900ed793,63eedfcc73071d41,8f2d9ee27f206f1f,2000-12-16,0,0,0,298,0,0,8,6,6,2,0,0,2,1,0,0,6,5,0.0,93.19999999999999
13537,019eca4a900ed793,8f2d9ee27f206f1f,63eedfcc73071d41,2000-12-16,1,0,0,298,1,1,40,19,9,31,7,7,24,18,7,6,2,1,204.8,47.0
13538,be8e34d585be9dc7,44260175069b6276,4a01dc8376736ef5,2000-11-17,1,0,0,15,0,0,3,1,3,0,0,0,0,0,0,0,3,1,0.0,15.0
13539,be8e34d585be9dc7,4a01dc8376736ef5,44260175069b6276,2000-11-17,0,0,0,15,0,0,1,0,1,0,0,0,0,0,0,0,1,0,0.0,15.0
13540,b85ce7371fb18305,d62bb4d84a7267ba,df5a77121ba84a5d,2000-11-17,0,3,0,600,4,2,19,7,2,17,1,1,16,7,1,1,1,0,532.7,36.0
13541,b85ce7371fb18305,df5a77121ba84a5d,d62bb4d84a7267ba,2000-11-17,0,1,0,600,0,0,7,3,4,3,0,0,3,3,2,1,2,0,0.0,67.29999999999995
13542,91cef206019c119e,3738e68d2261e60f,cf1a88371c8cb690,2000-11-17,0,2,1,55,1,1,4,1,4,0,0,0,0,0,1,1,3,1,0.0,42.0
13543,91cef206019c119e,cf1a88371c8cb690,3738e68d2261e60f,2000-11-17,0,0,0,55,1,0,5,0,5,0,0,0,0,0,0,0,5,0,0.0,51.0
13544,4aef975838bc19ec,91acd6910b802a9e,ee457ef1e1c326c1,2000-11-17,0,1,0,600,0,0,3,0,3,0,0,0,0,0,2,2,1,0,0.0,13.0
13545,4aef975838bc19ec,ee457ef1e1c326c1,91acd6910b802a9e,2000-11-17,0,0,0,600,2,2,9,5,1,8,0,0,8,4,0,0,1,1,587.0,13.0
13546,40d31c37e00d6d0b,33e33d51f289d2a1,d468288756ae3982,2000-11-17,0,0,0,900,0,0,12,0,12,0,0,0,0,0,5,5,7,0,0.0,192.0
13547,40d31c37e00d6d0b,d468288756ae3982,33e33d51f289d2a1,2000-11-17,0,2,0,900,5,4,17,4,12,5,1,1,4,2,3,2,9,2,708.0,192.0
13548,10cca6f437922b6c,0aa92558424ced9e,6859f67468ba8489,2000-11-17,1,1,0,853,1,1,41,17,21,20,0,0,20,14,12,11,9,3,98.3,410.5
13549,10cca6f437922b6c,6859f67468ba8489,0aa92558424ced9e,2000-11-17,0,1,0,853,2,2,19,8,13,6,3,3,3,3,4,4,9,5,265.5,223.7
13550,c5bec85a32462995,33e33d51f289d2a1,afaad7d6a581e307,2000-09-22,0,0,0,900,0,0,55,19,55,0,0,0,0,0,25,24,30,19,0.0,272.5
13551,c5bec85a32462995,afaad7d6a581e307,33e33d51f289d2a1,2000-09-22,0,0,0,900,4,4,44,8,25,19,0,0,19,6,3,2,22,2,301.5,408.0
13552,c078544a32e18ba3,4d74641fac830182,979f7edbb6980b0d,2000-09-22,0,0,0,600,2,0,33,13,29,4,0,0,4,4,10,5,19,9,3.7,383.6
13553,c078544a32e18ba3,979f7edbb6980b0d,4d74641fac830182,2000-09-22,0,0,0,600,1,1,55,9,36,19,1,1,18,4,21,18,15,5,193.4,87.3
13554,ae54f944d1ba378f,b4bc2e3353a770b5,b63e800c18e011b5,2000-09-22,0,0,0,900,0,0,61,29,13,48,0,0,48,25,1,1,12,4,322.4,124.80000000000001
13555,ae54f944d1ba378f,b63e800c18e011b5,b4bc2e3353a770b5,2000-09-22,0,0,0,900,10,1,29,9,4,25,16,15,9,7,1,1,3,2,419.2,141.60000000000002
13556,8a9a37d68cc428d6,1fe7adb23b3eedfb,8dc46e9a7895ce1a,2000-09-22,1,0,0,748,0,0,54,28,23,31,2,1,29,18,6,4,17,10,216.2,103.0
13557,8a9a37d68cc428d6,8dc46e9a7895ce1a,1fe7adb23b3eedfb,2000-09-22,0,0,0,748,8,2,43,14,5,38,0,0,38,13,1,0,4,1,387.0,144.8
13558,794ec0a93eca0492,b44f39a5c6596953,c670aa48827d6be6,2000-09-22,1,0,0,93,0,0,7,0,6,1,0,0,1,0,2,2,4,0,11.0,82.0
13559,794ec0a93eca0492,c670aa48827d6be6,b44f39a5c6596953,2000-09-22,0,0,0,93,1,0,3,0,3,0,0,0,0,0,0,0,3,0,0.0,82.0
13560,3ef7c2b26af8cf22,8d26912cd2aeb366,ce783bf73b5131f9,2000-09-22,0,1,1,272,2,1,6,0,3,3,3,2,0,0,2,0,1,0,215.0,57.0
13561,3ef7c2b26af8cf22,ce783bf73b5131f9,8d26912cd2aeb366,2000-09-22,0,0,0,272,0,0,9,1,8,1,0,0,1,1,2,1,6,0,0.0,57.0
13562,0bec32c32da199ed,1c2f2571b18791b6,263ebd4a669e1e98,2000-09-22,0,0,0,70,0,0,2,1,2,0,0,0,0,0,0,0,2,1,0.0,46.0
13563,0bec32c32da199ed,263ebd4a669e1e98,1c2f2571b18791b6,2000-09-22,0,2,1,70,1,1,3,0,3,0,0,0,0,0,3,1,0,0,0.0,63.0
13564,075dee476361e83e,c7e9d15cfce52f1d,cbfd1d34356a004c,2000-09-22,0,0,0,600,1,0,14,5,7,7,0,0,7,4,0,0,7,1,84.9,123.0
13565,075dee476361e83e,cbfd1d34356a004c,c7e9d15cfce52f1d,2000-09-22,0,0,0,600,4,1,62,20,9,53,8,8,45,20,5,3,4,0,380.0,92.1
13566,f0b2020d11a0cf94,7a15f3694c5cbc02,cedfdf8d423d500c,2000-06-09,0,2,0,403,0,0,2,0,2,0,0,0,0,0,1,1,1,0,0.0,150.5
13567,f0b2020d11a0cf94,cedfdf8d423d500c,7a15f3694c5cbc02,2000-06-09,0,1,1,403,2,2,18,9,13,5,0,0,5,4,1,0,12,5,252.5,100.0
13568,d84f88ac792e8c53,44aa652b181bcf68,621a6c59f88a44fe,2000-06-09,0,0,0,274,0,0,2,2,0,2,0,0,2,2,0,0,0,0,0.0,26.0
13569,d84f88ac792e8c53,621a6c59f88a44fe,44aa652b181bcf68,2000-06-09,1,0,0,274,3,2,31,14,2,29,4,4,25,14,0,0,2,0,248.0,26.0
13570,cef1b43c77e02635,6859f67468ba8489,b44f39a5c6596953,2000-06-09,0,2,0,1500,4,2,52,17,43,9,0,0,9,4,0,0,43,13,148.2,1286.0
13571,cef1b43c77e02635,b44f39a5c6596953,6859f67468ba8489,2000-06-09,0,0,0,1500,0,0,57,3,56,1,0,0,1,0,11,9,45,3,0.0,1351.8
13572,a0dfc397caef4afe,1562b12763cc8d67,7a359ef685a304a7,2000-06-09,1,0,0,343,1,0,27,8,27,0,0,0,0,0,4,4,23,8,0.0,251.0
13573,a0dfc397caef4afe,7a359ef685a304a7,1562b12763cc8d67,2000-06-09,0,0,0,343,0,0,10,4,10,0,0,0,0,0,2,2,8,4,0.0,329.0
13574,85f28a8276a141b6,7b6e40a73b567072,e7ec11096eac0282,2000-06-09,0,0,0,600,6,3,55,15,49,6,0,0,6,2,14,11,35,13,65.5,480.0
13575,85f28a8276a141b6,e7ec11096eac0282,7b6e40a73b567072,2000-06-09,0,0,0,600,2,0,23,2,23,0,0,0,0,0,7,4,16,2,0.0,347.5
13576,8452f6d5a1450cfb,0f6528b461e47462,44260175069b6276,2000-06-09,0,0,0,900,18,1,59,2,58,1,0,0,1,0,16,3,42,2,8.0,770.0
13577,8452f6d5a1450cfb,44260175069b6276,0f6528b461e47462,2000-06-09,0,0,0,900,0,0,84,4,78,6,0,0,6,0,0,0,78,4,114.0,759.0
13578,7edac7a0a2f72f28,040426baba8a45e8,b4bc2e3353a770b5,2000-06-09,0,0,0,433,6,1,18,0,16,2,0,0,2,0,16,9,0,0,60.0,157.3
13579,7edac7a0a2f72f28,b4bc2e3353a770b5,040426baba8a45e8,2000-06-09,1,0,0,433,1,1,26,13,14,12,0,0,12,10,5,3,9,3,65.7,269.0
13580,60e5b2c1bdaa203e,c2a7623f398d9bd7,d1e6a6536ee62517,2000-06-09,0,0,0,900,2,0,31,5,28,3,0,0,3,2,6,5,22,3,0.7,859.7
13581,60e5b2c1bdaa203e,d1e6a6536ee62517,c2a7623f398d9bd7,2000-06-09,0,0,0,900,1,1,60,11,58,2,0,0,2,0,7,5,51,11,38.3,612.3
13582,f6066d192a16f5ff,d2b1c1317a39f6c6,efaf544314bb5c2e,2000-04-14,0,1,0,900,0,0,13,2,9,4,0,0,4,2,9,4,0,0,0.0,266.6
13583,f6066d192a16f5ff,efaf544314bb5c2e,d2b1c1317a39f6c6,2000-04-14,0,1,0,900,5,3,62,40,9,53,8,7,45,38,5,4,4,2,633.4,183.0
13584,cf8fe599f0b44fd5,01daf32100ed7517,1c2f2571b18791b6,2000-04-14,0,0,0,900,11,3,4,1,2,2,0,0,2,1,1,0,1,0,305.0,437.5
13585,cf8fe599f0b44fd5,1c2f2571b18791b6,01daf32100ed7517,2000-04-14,0,0,0,900,0,0,45,4,39,6,5,5,1,1,6,4,33,3,157.5,280.0
13586,ba8b1ed5b05a719a,ce783bf73b5131f9,e4bde462b043d3e1,2000-04-14,0,1,0,278,0,0,5,4,5,0,0,0,0,0,0,0,5,4,0.0,61.0
13587,ba8b1ed5b05a719a,e4bde462b043d3e1,ce783bf73b5131f9,2000-04-14,0,2,1,278,2,2,16,7,1,15,1,1,14,6,0,0,1,1,217.0,61.0
13588,b675fb8f413b59e4,85d905f7c4f5a1af,e06fd1260ac865a7,2000-04-14,0,1,1,331,4,4,21,10,3,18,0,0,18,9,1,1,2,1,261.0,29.0
13589,b675fb8f413b59e4,e06fd1260ac865a7,85d905f7c4f5a1af,2000-04-14,0,0,0,331,0,0,6,0,5,1,0,0,1,0,1,0,4,0,12.0,58.0
13590,9397493152c0669a,80e6d71e14c1d356,ce6065baef021cf3,2000-04-14,0,4,0,714,0,0,16,6,10,6,1,1,5,3,1,1,9,3,101.2,355.5
13591,9397493152c0669a,ce6065baef021cf3,80e6d71e14c1d356,2000-04-14,1,0,0,714,8,3,19,3,18,1,0,0,1,1,0,0,18,2,223.5,165.8
13592,0adfdf8f563be462,2f732dd9210d301f,a1f6999fe57236e0,2000-04-14,1,0,0,1500,6,4,43,18,4,39,1,1,38,17,1,1,3,1,1124.2,347.0
13593,0adfdf8f563be462,a1f6999fe57236e0,2f732dd9210d301f,2000-04-14,0,0,0,1500,1,0,27,6,27,0,0,0,0,0,7,4,20,6,0.0,368.79999999999995
13594,cf85523b0d442d35,09c44b317c98bf96,44260175069b6276,2000-03-10,0,0,0,461,0,0,37,7,34,3,2,2,1,0,15,11,19,7,0.0,223.2
13595,cf85523b0d442d35,44260175069b6276,09c44b317c98bf96,2000-03-10,1,2,0,461,3,3,107,42,28,79,6,6,73,30,7,6,21,12,237.8,148.0
13596,aca2f98ee112d137,263ebd4a669e1e98,275cafc9de131c83,2000-03-10,0,0,0,900,12,1,22,4,22,0,0,0,0,0,6,4,16,4,0.0,609.0
13597,aca2f98ee112d137,275cafc9de131c83,263ebd4a669e1e98,2000-03-10,0,1,0,900,0,0,99,26,76,23,2,1,21,11,12,10,64,15,253.0,317.0
13598,9f2b94c46b70c6fb,6ece1d2ab1bed31d,b63e800c18e011b5,2000-03-10,0,0,0,203,1,0,27,11,27,0,0,0,0,0,3,3,24,11,0.0,185.0
13599,9f2b94c46b70c6fb,b63e800c18e011b5,6ece1d2ab1bed31d,2000-03-10,1,0,0,203,0,0,19,5,19,0,0,0,0,0,6,4,13,5,0.0,161.0
13600,81b0c08f7503e79a,2620f3eb21c79614,b4bc2e3353a770b5,2000-03-10,0,4,1,189,1,1,0,0,0,0,0,0,0,0,0,0,0,0,0.0,112.0
13601,81b0c08f7503e79a,b4bc2e3353a770b5,2620f3eb21c79614,2000-03-10,0,1,0,189,0,0,0,0,0,0,0,0,0,0,0,0,0,0,0.0,172.0
13602,77f9b97f62f373b0,4d74641fac830182,7b6e40a73b567072,2000-03-10,0,1,0,600,2,0,35,9,34,1,0,0,1,0,5,3,29,9,15.0,238.5
13603,77f9b97f62f373b0,7b6e40a73b567072,4d74641fac830182,2000-03-10,0,0,0,600,6,5,40,11,27,13,1,1,12,8,14,10,13,3,331.5,177.0
13604,22911cbd32370f6c,1c061eb6e29eaa0a,cb6783c39c01d896,2000-03-10,0,2,1,389,5,1,47,12,46,1,0,0,1,0,17,10,29,12,5.2,321.0
13605,22911cbd32370f6c,cb6783c39c01d896,1c061eb6e29eaa0a,2000-03-10,0,0,0,389,0,0,63,12,63,0,0,0,0,0,18,12,45,12,0.0,256.8
13606,17be6e24dafd31e0,63eedfcc73071d41,9bad58fa651d6196,2000-03-10,1,1,0,815,4,2,53,15,37,16,0,0,16,11,22,18,15,4,256.4,154.1
13607,17be6e24dafd31e0,9bad58fa651d6196,63eedfcc73071d41,2000-03-10,1,0,0,815,0,0,47,13,40,7,0,0,7,3,18,14,22,10,3.9,542.6
13608,c22545a5881459ac,b44f39a5c6596953,b76ed59283d3559c,1999-11-19,1,0,0,677,0,0,47,8,46,1,0,0,1,1,7,6,39,7,4.0,669.0
13609,c22545a5881459ac,b76ed59283d3559c,b44f39a5c6596953,1999-11-19,0,0,0,677,3,0,33,0,33,0,0,0,0,0,24,14,9,0,0.0,673.0
13610,36c929fb1569d4b9,6014d25e73b669c9,ce783bf73b5131f9,1999-11-19,0,0,0,792,0,0,58,11,58,0,0,0,0,0,3,3,55,11,0.0,741.0
13611,36c929fb1569d4b9,ce783bf73b5131f9,6014d25e73b669c9,1999-11-19,1,0,0,792,1,0,105,19,105,0,0,0,0,0,4,3,101,19,0.0,636.0
13612,2cd6330ef18210b9,6ceff86fae4f6b3b,80e6d71e14c1d356,1999-11-19,0,0,0,88,0,0,1,1,1,0,0,0,0,0,0,0,1,1,0.0,46.0
13613,2cd6330ef18210b9,80e6d71e14c1d356,6ceff86fae4f6b3b,1999-11-19,1,0,0,88,2,1,2,1,0,2,1,1,1,1,0,0,0,0,33.0,55.0
13614,2ab41c5519d0b1b9,6291ac0a3726732f,6859f67468ba8489,1999-11-19,1,1,0,1500,0,0,21,5,15,6,0,0,6,3,5,3,10,2,38.2,476.0
13615,2ab41c5519d0b1b9,6859f67468ba8489,6291ac0a3726732f,1999-11-19,0,2,0,1500,11,6,43,10,7,36,0,0,36,9,1,0,6,1,954.0,401.8
13616,eebf672428b168b7,5ca158b1cc9cb242,8d26912cd2aeb366,1999-09-24,0,0,0,128,1,1,7,0,7,0,0,0,0,0,4,1,3,0,0.0,49.0
13617,eebf672428b168b7,8d26912cd2aeb366,5ca158b1cc9cb242,1999-09-24,0,1,1,128,0,0,4,2,4,0,0,0,0,0,1,1,3,2,0.0,126.0
13618,d9e86958bcb15c26,621a6c59f88a44fe,7b6ce3a9460565b5,1999-09-24,0,0,0,900,9,5,117,48,32,85,28,28,57,34,1,1,31,14,0.0,900.0
13619,d9e86958bcb15c26,7b6ce3a9460565b5,621a6c59f88a44fe,1999-09-24,0,1,0,900,0,0,25,5,24,1,0,0,1,0,2,2,22,5,0.0,900.0
13620,c6ead49500c047e5,a390eb8a9b2df298,f341f9551ba744e2,1999-09-24,1,0,0,233,0,0,28,13,24,4,0,0,4,4,0,0,24,9,31.0,109.0
13621,c6ead49500c047e5,f341f9551ba744e2,a390eb8a9b2df298,1999-09-24,0,0,0,233,5,0,7,0,7,0,0,0,0,0,5,5,2,0,0.0,162.0
13622,c57acf13de48330a,13c4313ed0f744f3,6ece1d2ab1bed31d,1999-09-24,1,0,0,30,1,1,3,3,3,0,0,0,0,0,0,0,3,3,0.0,22.0
13623,c57acf13de48330a,6ece1d2ab1bed31d,13c4313ed0f744f3,1999-09-24,0,0,0,30,0,0,0,0,0,0,0,0,0,0,0,0,0,0,0.0,29.0
13624,b1134affa18449dd,2f732dd9210d301f,fcaae0385b514f11,1999-09-24,0,0,0,1182,9,8,74,18,32,42,3,1,39,16,1,1,31,2,753.6,226.7
13625,b1134affa18449dd,fcaae0385b514f11,2f732dd9210d301f,1999-09-24,1,1,0,1182,0,0,61,10,56,5,3,3,2,2,24,18,32,8,4.3,415.4
13626,a1c1e3c1e9c6cf1e,1e38bba6738b7b10,44260175069b6276,1999-09-24,0,0,0,600,2,1,62,21,52,10,0,0,10,4,15,13,37,17,27.0,398.6
13627,a1c1e3c1e9c6cf1e,44260175069b6276,1e38bba6738b7b10,1999-09-24,0,1,0,600,1,0,81,32,69,12,0,0,12,10,19,16,50,22,74.4,170.0
13628,96c247ba0eb1ac65,c7e9d15cfce52f1d,efaf544314bb5c2e,1999-09-24,0,0,0,900,0,0,30,7,24,6,1,1,5,4,4,4,20,3,68.7,545.6
13629,96c247ba0eb1ac65,efaf544314bb5c2e,c7e9d15cfce52f1d,1999-09-24,0,2,0,900,10,2,25,8,17,8,1,1,7,4,10,5,7,4,228.4,317.3
13630,968cd768ac41e6ee,1ffc38f67785797b,4a01dc8376736ef5,1999-09-24,0,0,0,613,1,0,33,6,33,0,0,0,0,0,5,3,28,6,0.0,610.0
13631,968cd768ac41e6ee,4a01dc8376736ef5,1ffc38f67785797b,1999-09-24,1,0,0,613,1,1,61,18,61,0,0,0,0,0,3,2,58,18,0.0,413.0
13632,df8d4014d8206ab1,bba678d312590087,cedfdf8d423d500c,1999-07-16,0,0,0,394,1,0,19,3,17,2,0,0,2,1,9,7,8,2,0.7,390.0
13633,df8d4014d8206ab1,cedfdf8d423d500c,bba678d312590087,1999-07-16,1,0,0,394,0,0,42,6,42,0,0,0,0,0,10,7,32,6,0.0,297.3
13634,c6f8541973f69080,a54a35a670d8e852,efaf544314bb5c2e,1999-07-16,1,0,0,171,0,0,20,10,17,3,0,0,3,3,1,0,16,7,7.6,143.0
13635,c6f8541973f69080,efaf544314bb5c2e,a54a35a670d8e852,1999-07-16,0,0,0,171,0,0,48,19,48,0,0,0,0,0,6,3,42,19,0.0,135.4
13636,82cf32aea3d7edf3,ab35634d1a8c7a11,f341f9551ba744e2,1999-07-16,1,0,0,260,0,0,2,1,1,1,0,0,1,0,0,0,1,1,14.0,9.0
13637,82cf32aea3d7edf3,f341f9551ba744e2,ab35634d1a8c7a11,1999-07-16,0,2,1,260,0,0,35,20,2,33,1,1,32,20,0,0,2,0,237.0,9.0
13638,693e4a0bed9a1369,669a3cb6e394f515,ce783bf73b5131f9,1999-07-16,0,0,0,379,8,2,26,11,11,15,0,0,15,8,0,0,11,3,121.6,216.7
13639,693e4a0bed9a1369,ce783bf73b5131f9,669a3cb6e394f515,1999-07-16,1,1,0,379,0,0,46,15,41,5,0,0,5,5,6,6,35,10,8.3,237.4
13640,62ac5bff3c181f50,33e33d51f289d2a1,597db668b01c442c,1999-07-16,1,0,0,300,0,0,4,2,2,2,0,0,2,2,2,2,0,0,34.0,266.0
13641,62ac5bff3c181f50,597db668b01c442c,33e33d51f289d2a1,1999-07-16,0,2,0,300,1,1,1,0,1,0,0,0,0,0,1,1,0,0,0.0,45.0
13642,3e4199f9a69bac88,b76ed59283d3559c,c7e9d15cfce52f1d,1999-07-16,1,3,0,600,3,0,14,7,7,7,1,1,6,6,6,3,1,1,75.0,138.60000000000002
13643,3e4199f9a69bac88,c7e9d15cfce52f1d,b76ed59283d3559c,1999-07-16,0,0,0,600,0,0,31,10,8,23,1,1,22,10,1,1,7,0,386.4,105.0
13644,38e3986b7cfff608,4f74c8be51db8a37,8d26912cd2aeb366,1999-07-16,0,0,0,281,1,0,14,0,14,0,0,0,0,0,0,0,14,0,0.0,125.1
13645,38e3986b7cfff608,8d26912cd2aeb366,4f74c8be51db8a37,1999-07-16,1,0,0,281,0,0,59,27,22,37,3,2,34,22,6,6,16,5,155.9,104.0
13646,1db8bed8b4d30fb3,911fb265462f0d94,c2a7623f398d9bd7,1999-07-16,1,0,0,600,2,1,32,13,19,13,3,3,10,10,9,9,10,3,206.7,139.0
13647,1db8bed8b4d30fb3,c2a7623f398d9bd7,911fb265462f0d94,1999-07-16,0,0,0,600,5,0,0,0,0,0,0,0,0,0,0,0,0,0,0.0,296.3
13648,c892b23ad8f2208b,a1f6999fe57236e0,c61f66d8c3fd5f07,1999-05-07,1,0,0,173,0,0,32,12,31,1,0,0,1,1,14,13,17,11,0.0,173.0
13649,c892b23ad8f2208b,c61f66d8c3fd5f07,a1f6999fe57236e0,1999-05-07,0,0,0,173,2,0,5,3,5,0,0,0,0,0,2,1,3,3,0.0,173.0
13650,a3fe8217502c42a4,6291ac0a3726732f,911fb265462f0d94,1999-05-07,0,2,1,388,0,0,27,7,17,10,0,0,10,6,9,8,8,1,0.0,388.0
13651,a3fe8217502c42a4,911fb265462f0d94,6291ac0a3726732f,1999-05-07,0,0,0,388,1,0,22,4,14,8,1,1,7,3,1,1,13,1,0.0,388.0
13652,99b5010fd25911af,1dab0d1d81dd06db,b44f39a5c6596953,1999-05-07,0,0,0,270,1,0,46,14,46,0,0,0,0,0,5,2,41,14,0.0,270.0
13653,99b5010fd25911af,b44f39a5c6596953,1dab0d1d81dd06db,1999-05-07,1,0,0,270,0,0,43,7,42,1,0,0,1,0,2,2,40,7,0.0,270.0
13654,79f9086932f21016,41e77dc504a192c6,efaf544314bb5c2e,1999-05-07,0,0,0,28,0,0,2,0,2,0,0,0,0,0,0,0,2,0,0.0,28.0
13655,79f9086932f21016,efaf544314bb5c2e,41e77dc504a192c6,1999-05-07,1,0,0,28,1,1,8,6,0,8,0,0,8,6,0,0,0,0,0.0,28.0
13656,73c07530f667289f,03688dc3c3af3ac1,6859f67468ba8489,1999-05-07,0,1,0,780,0,0,29,10,12,17,4,3,13,10,5,5,7,0,0.0,780.0
13657,73c07530f667289f,6859f67468ba8489,03688dc3c3af3ac1,1999-05-07,0,0,0,780,6,6,61,19,2,59,1,1,58,19,2,0,0,0,0.0,780.0
13658,6bb2a427004deecc,672ef06fd9f41f7d,775bad6d700d2302,1999-05-07,1,0,0,83,2,1,13,6,1,12,0,0,12,6,1,1,0,0,0.0,83.0
13659,6bb2a427004deecc,775bad6d700d2302,672ef06fd9f41f7d,1999-05-07,0,0,0,83,0,0,3,0,2,1,0,0,1,0,0,0,2,0,0.0,83.0
13660,3a271d9d9210a818,1c2f2571b18791b6,263ebd4a669e1e98,1999-05-07,1,0,0,81,0,0,6,3,4,2,2,2,0,0,1,1,3,3,0.0,81.0
13661,3a271d9d9210a818,263ebd4a669e1e98,1c2f2571b18791b6,1999-05-07,0,2,0,81,0,0,3,0,3,0,0,0,0,0,3,0,0,0,0.0,81.0
13662,c03d0d781df4ad2a,2f732dd9210d301f,946f341df6472ee0,1999-03-05,1,0,0,596,5,2,42,22,8,34,4,3,30,21,2,1,6,1,0.0,596.0
13663,c03d0d781df4ad2a,946f341df6472ee0,2f732dd9210d301f,1999-03-05,0,3,0,596,0,0,4,1,4,0,0,0,0,0,1,1,3,1,0.0,596.0
13664,b26c2f616c9436fb,8d26912cd2aeb366,a390eb8a9b2df298,1999-03-05,0,3,1,720,7,3,11,1,11,0,0,0,0,0,8,7,3,1,0.0,720.0
13665,b26c2f616c9436fb,a390eb8a9b2df298,8d26912cd2aeb366,1999-03-05,0,0,0,720,0,0,24,12,13,11,0,0,11,8,3,0,10,4,0.0,720.0
13666,9a38c18f00bb8b8e,5ca158b1cc9cb242,6291ac0a3726732f,1999-03-05,0,0,0,116,0,0,7,0,7,0,0,0,0,0,2,2,5,0,0.0,116.0
13667,9a38c18f00bb8b8e,6291ac0a3726732f,5ca158b1cc9cb242,1999-03-05,0,1,1,116,1,1,7,2,5,2,0,0,2,1,1,1,4,1,0.0,116.0
13668,997753de17f81e3a,33e33d51f289d2a1,6859f67468ba8489,1999-03-05,0,2,0,480,0,0,16,2,16,0,0,0,0,0,7,7,9,2,0.0,480.0
13669,997753de17f81e3a,6859f67468ba8489,33e33d51f289d2a1,1999-03-05,0,0,0,480,4,4,49,17,20,29,0,0,29,12,0,0,20,5,0.0,480.0
13670,28f31c3fd7afe737,a54a35a670d8e852,fbbde91f7bc2d3c5,1999-03-05,0,0,0,43,0,0,3,2,3,0,0,0,0,0,0,0,3,2,0.0,43.0
13671,28f31c3fd7afe737,fbbde91f7bc2d3c5,a54a35a670d8e852,1999-03-05,1,0,0,43,0,0,14,6,14,0,0,0,0,0,2,2,12,6,0.0,43.0
13672,25215e8c06d7d63f,7b6ce3a9460565b5,8f2d9ee27f206f1f,1999-03-05,0,0,0,178,0,0,8,2,8,0,0,0,0,0,0,0,8,2,0.0,178.0
13673,25215e8c06d7d63f,8f2d9ee27f206f1f,7b6ce3a9460565b5,1999-03-05,1,1,0,178,1,1,32,18,10,22,3,3,19,15,3,2,7,3,0.0,178.0
13674,03afd7b6a217aaac,5898357a45a73674,c058823a2595ab09,1999-03-05,1,0,0,601,1,1,19,6,16,3,0,0,3,2,4,3,12,4,0.0,601.0
13675,03afd7b6a217aaac,c058823a2595ab09,5898357a45a73674,1999-03-05,0,2,0,601,2,1,42,14,12,30,2,2,28,13,2,1,10,1,0.0,601.0
13676,fb8e8d1a734b6fe8,8f2d9ee27f206f1f,a24e080000fa7a35,1999-01-08,0,4,1,477,1,1,37,10,37,0,0,0,0,0,17,14,20,10,0.0,477.0
13677,fb8e8d1a734b6fe8,a24e080000fa7a35,8f2d9ee27f206f1f,1999-01-08,0,0,0,477,1,1,26,3,14,12,1,1,11,3,0,0,14,0,0.0,477.0
13678,86090172facd6cf7,21b8a0f5c231096f,b44f39a5c6596953,1999-01-08,0,0,0,480,6,2,53,23,24,29,0,0,29,18,4,2,20,5,0.0,480.0
13679,86090172facd6cf7,b44f39a5c6596953,21b8a0f5c231096f,1999-01-08,0,0,0,480,0,0,29,9,29,0,0,0,0,0,7,7,22,9,0.0,480.0
13680,6c15d41df17349c9,2f732dd9210d301f,93892752c5fc23ca,1999-01-08,1,0,0,451,7,6,76,35,41,35,2,1,33,17,1,1,40,18,0.0,451.0
13681,6c15d41df17349c9,93892752c5fc23ca,2f732dd9210d301f,1999-01-08,0,0,0,451,0,0,25,5,24,1,0,0,1,1,8,4,16,4,0.0,451.0
13682,48fccedc8889a473,20bd6c3e03c46ee6,4c805f5f58a75df0,1999-01-08,0,0,0,480,6,0,63,7,63,0,0,0,0,0,37,27,26,7,0.0,480.0
13683,48fccedc8889a473,4c805f5f58a75df0,20bd6c3e03c46ee6,1999-01-08,1,1,0,480,0,0,135,28,126,9,0,0,9,2,16,14,110,26,0.0,480.0
13684,453118d7f05be814,c8cca8f3de5be4b4,cedfdf8d423d500c,1999-01-08,0,1,0,780,6,1,88,5,87,1,0,0,1,1,19,14,68,4,0.0,780.0
13685,453118d7f05be814,cedfdf8d423d500c,c8cca8f3de5be4b4,1999-01-08,0,0,0,780,3,3,71,9,66,5,1,1,4,4,26,17,40,5,0.0,780.0
13686,3fc4d9f17be8d003,03688dc3c3af3ac1,b76ed59283d3559c,1999-01-08,1,0,0,435,0,0,61,21,57,4,0,0,4,4,11,10,46,17,0.0,435.0
13687,3fc4d9f17be8d003,b76ed59283d3559c,03688dc3c3af3ac1,1999-01-08,0,0,0,435,9,3,47,16,16,31,5,3,26,12,4,4,12,4,0.0,435.0
13688,0cf7636471fc5e45,1c2f2571b18791b6,44f9c777fed7ca03,1999-01-08,1,0,0,412,2,2,30,13,4,26,1,1,25,13,1,1,3,0,0.0,412.0
13689,0cf7636471fc5e45,44f9c777fed7ca03,1c2f2571b18791b6,1999-01-08,0,1,0,412,2,0,2,0,2,0,0,0,0,0,2,0,0,0,0.0,412.0
13690,f85bbc760000f001,b361180739bed4b0,b44f39a5c6596953,1998-10-16,0,0,0,487,2,1,48,16,39,9,0,0,9,5,0,0,39,11,0.0,487.0
13691,f85bbc760000f001,b44f39a5c6596953,b361180739bed4b0,1998-10-16,2,0,0,487,0,0,35,12,29,6,0,0,6,3,13,12,16,9,0.0,487.0
13692,dbdad3eb157703bc,6291ac0a3726732f,b76ed59283d3559c,1998-10-16,0,0,0,480,0,0,67,6,66,1,0,0,1,0,15,7,51,6,0.0,480.0
13693,dbdad3eb157703bc,b76ed59283d3559c,6291ac0a3726732f,1998-10-16,0,5,0,480,5,3,40,7,37,3,1,1,2,2,10,6,27,5,0.0,480.0
13694,c8a04210d832a928,31652c9267606d54,fcaae0385b514f11,1998-10-16,0,1,0,460,4,3,11,3,8,3,0,0,3,3,1,1,7,0,0.0,460.0
13695,c8a04210d832a928,fcaae0385b514f11,31652c9267606d54,1998-10-16,2,4,1,460,0,0,33,5,22,11,5,4,6,4,16,14,6,1,0.0,460.0
13696,b6de61e312dbb1db,8d26912cd2aeb366,dc950d59dc590aca,1998-10-16,0,0,0,207,0,0,5,0,5,0,0,0,0,0,4,3,1,0,0.0,207.0
13697,b6de61e312dbb1db,dc950d59dc590aca,8d26912cd2aeb366,1998-10-16,0,1,1,207,1,1,16,6,12,4,0,0,4,2,5,3,7,4,0.0,207.0
13698,635fbf57001897c7,7ca4c3f8aa8bacae,e8efeb9cf33b1941,1998-10-16,0,0,0,627,0,0,0,0,0,0,0,0,0,0,0,0,0,0,0.0,627.0
13699,635fbf57001897c7,e8efeb9cf33b1941,7ca4c3f8aa8bacae,1998-10-16,1,0,0,627,0,0,0,0,0,0,0,0,0,0,0,0,0,0,0.0,627.0
13700,35b871e0bdc1415b,c6e6926a81adcd00,e8c170a64dc920ac,1998-10-16,0,0,0,540,3,2,36,8,24,12,2,1,10,6,4,2,20,2,0.0,540.0
13701,35b871e0bdc1415b,e8c170a64dc920ac,c6e6926a81adcd00,1998-10-16,1,0,0,540,4,4,44,26,24,20,0,0,20,19,8,5,16,7,0.0,540.0
13702,3261bd16c10e3014,0ee783aa00e468f0,a1f6999fe57236e0,1998-10-16,1,0,0,44,0,0,13,7,13,0,0,0,0,0,0,0,13,7,0.0,44.0
13703,3261bd16c10e3014,a1f6999fe57236e0,0ee783aa00e468f0,1998-10-16,0,0,0,44,0,0,2,0,2,0,0,0,0,0,2,1,0,0,0.0,44.0
13704,07423d10cc23bfeb,4c805f5f58a75df0,cedfdf8d423d500c,1998-10-16,0,2,0,780,2,2,43,2,41,2,0,0,2,0,23,22,18,2,0.0,780.0
13705,07423d10cc23bfeb,cedfdf8d423d500c,4c805f5f58a75df0,1998-10-16,0,0,0,780,9,1,34,2,34,0,0,0,0,0,22,17,12,2,0.0,780.0
13706,ea535b46e0f69ad3,a390eb8a9b2df298,df2cf66d8c0123db,1998-05-15,0,0,0,720,2,2,98,13,88,10,2,1,8,4,49,32,39,9,0.0,720.0
13707,ea535b46e0f69ad3,df2cf66d8c0123db,a390eb8a9b2df298,1998-05-15,0,0,0,720,1,1,38,8,37,1,0,0,1,1,1,1,36,7,0.0,720.0
13708,a4d8e991ec42b048,21b8a0f5c231096f,6291ac0a3726732f,1998-05-15,0,0,0,338,8,3,49,23,25,24,0,0,24,14,3,3,22,9,0.0,338.0
13709,a4d8e991ec42b048,6291ac0a3726732f,21b8a0f5c231096f,1998-05-15,1,1,0,338,0,0,42,13,40,2,0,0,2,2,10,9,30,11,0.0,338.0
13710,8d83354075a937f2,952f6fa06f25a0ec,c96518b7f6881004,1998-05-15,0,3,1,52,1,1,1,1,0,1,0,0,1,1,0,0,0,0,0.0,52.0
13711,8d83354075a937f2,c96518b7f6881004,952f6fa06f25a0ec,1998-05-15,0,0,0,52,0,0,1,0,0,1,0,0,1,0,0,0,0,0,0.0,52.0
13712,8b258bbb37f74a66,4dc496aa0cfc0d95,a54a35a670d8e852,1998-05-15,0,0,0,480,0,0,0,0,0,0,0,0,0,0,0,0,0,0,0.0,480.0
13713,8b258bbb37f74a66,a54a35a670d8e852,4dc496aa0cfc0d95,1998-05-15,0,0,0,480,0,0,0,0,0,0,0,0,0,0,0,0,0,0,0.0,480.0
13714,74dcccd3d2f487a1,2ee09ec2a0695eb9,74fefd43f073cd2f,1998-05-15,0,1,1,661,1,1,72,15,39,33,6,5,27,12,11,7,28,3,0.0,661.0
13715,74dcccd3d2f487a1,74fefd43f073cd2f,2ee09ec2a0695eb9,1998-05-15,0,1,0,661,5,0,11,2,11,0,0,0,0,0,4,2,7,2,0.0,661.0
13716,21aa163b80e504f9,1ccf4e7caff270df,e62b36885ecdac27,1998-05-15,1,1,0,480,1,1,54,21,41,13,1,1,12,9,10,9,31,12,0.0,480.0
13717,21aa163b80e504f9,e62b36885ecdac27,1ccf4e7caff270df,1998-05-15,1,0,0,480,0,0,49,16,48,1,0,0,1,1,22,20,26,15,0.0,480.0
13718,1e14e79a477f2357,706404da0775dcbc,b361180739bed4b0,1998-05-15,0,0,0,43,3,1,0,0,0,0,0,0,0,0,0,0,0,0,0.0,43.0
13719,1e14e79a477f2357,b361180739bed4b0,706404da0775dcbc,1998-05-15,1,0,0,43,0,0,16,11,3,13,0,0,13,9,0,0,3,2,0.0,43.0
13720,1d3c1dedfba6eddc,8d26912cd2aeb366,fcaae0385b514f11,1998-05-15,0,0,0,388,10,5,25,10,13,12,1,1,11,9,5,3,8,1,0.0,388.0
13721,1d3c1dedfba6eddc,fcaae0385b514f11,8d26912cd2aeb366,1998-05-15,0,3,1,388,0,0,28,3,20,8,5,5,3,3,15,12,5,0,0.0,388.0
13722,17526cb9fb6072ef,1ccf4e7caff270df,952f6fa06f25a0ec,1998-05-15,0,0,0,480,3,3,42,26,24,18,2,2,16,11,0,0,24,15,0.0,480.0
13723,17526cb9fb6072ef,952f6fa06f25a0ec,1ccf4e7caff270df,1998-05-15,2,1,0,480,3,2,32,10,32,0,0,0,0,0,11,10,21,10,0.0,480.0
13724,f32f823658478705,108afe61a26bcbf4,fcaae0385b514f11,1998-03-13,0,0,0,22,0,0,2,0,2,0,0,0,0,0,0,0,2,0,0.0,22.0
13725,f32f823658478705,fcaae0385b514f11,108afe61a26bcbf4,1998-03-13,1,0,0,22,1,1,4,1,3,1,0,0,1,1,3,1,0,0,0.0,22.0
13726,db936df21e61209e,13b2f59210dda9cc,93892752c5fc23ca,1998-03-13,0,0,0,623,2,2,25,13,9,16,4,4,12,9,1,1,8,4,0.0,623.0
13727,db936df21e61209e,93892752c5fc23ca,13b2f59210dda9cc,1998-03-13,0,2,1,623,2,0,17,2,16,1,0,0,1,1,3,3,13,1,0.0,623.0
13728,b80872821bc4f6ba,1c2f2571b18791b6,601cf40c09090853,1998-03-13,1,0,0,75,0,0,0,0,0,0,0,0,0,0,0,0,0,0,0.0,75.0
13729,b80872821bc4f6ba,601cf40c09090853,1c2f2571b18791b6,1998-03-13,0,0,0,75,0,0,0,0,0,0,0,0,0,0,0,0,0,0,0.0,75.0
13730,b55481006297ba05,08ae5cd9aef7ddd3,b76ed59283d3559c,1998-03-13,0,2,0,480,5,2,46,13,34,12,0,0,12,7,0,0,34,6,0.0,480.0
13731,b55481006297ba05,b76ed59283d3559c,08ae5cd9aef7ddd3,1998-03-13,0,0,0,480,2,0,75,31,53,22,2,1,20,10,15,13,38,21,0.0,480.0
13732,a3a328ca117184df,4c805f5f58a75df0,f70144caea5c4c80,1998-03-13,1,1,0,585,1,1,80,25,58,22,14,14,8,6,5,3,53,19,0.0,585.0
13733,a3a328ca117184df,f70144caea5c4c80,4c805f5f58a75df0,1998-03-13,0,0,0,585,2,0,24,2,24,0,0,0,0,0,9,4,15,2,0.0,585.0
13734,4bce0ce561a65288,56f4b81ec4db61af,b19fc66613dc75b9,1998-03-13,0,0,0,80,0,0,0,0,0,0,0,0,0,0,0,0,0,0,0.0,80.0
13735,4bce0ce561a65288,b19fc66613dc75b9,56f4b81ec4db61af,1998-03-13,0,0,1,80,0,0,0,0,0,0,0,0,0,0,0,0,0,0,0.0,80.0
13736,43885ee6cc5ed241,20bd6c3e03c46ee6,cedfdf8d423d500c,1998-03-13,0,0,0,480,3,2,34,7,9,25,0,0,25,7,9,6,0,0,0.0,480.0
13737,43885ee6cc5ed241,cedfdf8d423d500c,20bd6c3e03c46ee6,1998-03-13,0,1,0,480,0,0,27,5,25,2,0,0,2,2,13,13,12,3,0.0,480.0
13738,16f25f0808db6f77,b19fc66613dc75b9,cedfdf8d423d500c,1998-03-13,0,1,0,542,1,1,10,1,10,0,0,0,0,0,2,1,8,1,0.0,542.0
13739,16f25f0808db6f77,cedfdf8d423d500c,b19fc66613dc75b9,1998-03-13,0,1,1,542,0,0,14,4,7,7,0,0,7,3,4,2,3,1,0.0,542.0
13740,ec1bda9a4c2aab42,9b5b5a75523728f3,f717b6002486f73f,1997-12-21,0,2,1,224,1,1,2,1,1,1,0,0,1,1,0,0,1,0,0.0,224.0
13741,ec1bda9a4c2aab42,f717b6002486f73f,9b5b5a75523728f3,1997-12-21,0,1,0,224,1,1,2,1,2,0,0,0,0,0,0,0,2,1,0.0,224.0
13742,e0c636beed345e1d,13b2f59210dda9cc,fcaae0385b514f11,1997-12-21,0,0,0,16,1,1,3,1,3,0,0,0,0,0,1,1,2,1,0.0,16.0
13743,e0c636beed345e1d,fcaae0385b514f11,13b2f59210dda9cc,1997-12-21,0,1,1,16,0,0,1,1,1,0,0,0,0,0,0,0,1,1,0.0,16.0
13744,764e492b55c0ec40,b361180739bed4b0,e06fd1260ac865a7,1997-12-21,0,0,0,480,4,3,31,13,12,19,0,0,19,7,0,0,12,6,0.0,480.0
13745,764e492b55c0ec40,e06fd1260ac865a7,b361180739bed4b0,1997-12-21,0,1,0,480,1,0,9,1,9,0,0,0,0,0,8,8,1,1,0.0,480.0
13746,748657d9ba9d7c71,0aa92558424ced9e,33e33d51f289d2a1,1997-12-21,0,1,0,780,3,3,31,19,0,31,0,0,31,19,0,0,0,0,0.0,780.0
13747,748657d9ba9d7c71,33e33d51f289d2a1,0aa92558424ced9e,1997-12-21,0,0,0,780,0,0,17,5,16,1,0,0,1,1,6,4,10,4,0.0,780.0
13748,5c3542260741c6bc,0ee783aa00e468f0,19ffeb5e3fffd6d5,1997-12-21,0,3,1,243,2,2,0,0,0,0,0,0,0,0,0,0,0,0,0.0,243.0
13749,5c3542260741c6bc,19ffeb5e3fffd6d5,0ee783aa00e468f0,1997-12-21,0,0,0,243,0,0,1,0,1,0,0,0,0,0,1,1,0,0,0.0,243.0
13750,2750ac5854e8b28b,9b5b5a75523728f3,f717b6002486f73f,1997-12-21,0,0,0,111,1,0,1,0,0,1,0,0,1,0,0,0,0,0,0.0,111.0
13751,2750ac5854e8b28b,f717b6002486f73f,9b5b5a75523728f3,1997-12-21,0,1,0,111,1,1,10,4,10,0,0,0,0,0,0,0,10,4,0.0,111.0
13752,0e0629a1503125a6,13c4313ed0f744f3,1dab0d1d81dd06db,1997-12-21,0,0,0,605,6,3,24,9,7,17,1,1,16,8,2,2,5,1,0.0,605.0
13753,0e0629a1503125a6,1dab0d1d81dd06db,13c4313ed0f744f3,1997-12-21,0,1,1,605,0,0,17,5,16,1,0,0,1,0,1,1,15,5,0.0,605.0
13754,da77ead135cb4f17,312f47c3d2f83ffa,31c01fbc2586a5eb,1997-10-17,0,0,0,223,0,0,2,0,2,0,0,0,0,0,1,1,1,0,0.0,223.0
13755,da77ead135cb4f17,31c01fbc2586a5eb,312f47c3d2f83ffa,1997-10-17,1,0,0,223,1,1,22,11,0,22,0,0,22,11,0,0,0,0,0.0,223.0
13756,c99e302777049f2d,4dc496aa0cfc0d95,baa5358456803df8,1997-10-17,0,4,0,720,1,1,22,2,22,0,0,0,0,0,12,10,10,2,0.0,720.0
13757,c99e302777049f2d,baa5358456803df8,4dc496aa0cfc0d95,1997-10-17,0,0,0,720,5,1,18,8,8,10,0,0,10,5,3,3,5,3,0.0,720.0
13758,b5e49b35bc25c5a9,0aa92558424ced9e,0ee783aa00e468f0,1997-10-17,1,1,0,496,1,1,43,31,31,12,0,0,12,10,3,3,28,21,0.0,496.0
13759,b5e49b35bc25c5a9,0ee783aa00e468f0,0aa92558424ced9e,1997-10-17,0,0,0,496,1,0,21,6,21,0,0,0,0,0,0,0,21,6,0.0,496.0
13760,b3cafb4e6e1b2ad0,33e33d51f289d2a1,b361180739bed4b0,1997-10-17,0,1,1,488,0,0,13,7,6,7,0,0,7,6,5,5,1,1,0.0,488.0
13761,b3cafb4e6e1b2ad0,b361180739bed4b0,33e33d51f289d2a1,1997-10-17,1,0,0,488,0,0,22,5,11,11,0,0,11,2,0,0,11,3,0.0,488.0
13762,6603f1d60bfeefa9,91181b29be041f1c,a7b48e18ca27795d,1997-10-17,0,0,0,17,0,0,3,0,3,0,0,0,0,0,1,0,2,0,0.0,17.0
13763,6603f1d60bfeefa9,a7b48e18ca27795d,91181b29be041f1c,1997-10-17,1,0,0,17,0,0,2,1,2,0,0,0,0,0,0,0,2,1,0.0,17.0
13764,3bd789bcfb12368d,9fd1f08dd4aec14a,a220be6d41d6f97d,1997-10-17,0,0,0,480,3,3,28,10,12,16,0,0,16,7,5,3,7,3,0.0,480.0
13765,3bd789bcfb12368d,a220be6d41d6f97d,9fd1f08dd4aec14a,1997-10-17,0,0,0,480,4,2,32,6,29,3,0,0,3,3,9,5,20,3,0.0,480.0
13766,1c1f8f281b2065e0,31c01fbc2586a5eb,a7b48e18ca27795d,1997-10-17,0,0,0,53,0,0,0,0,0,0,0,0,0,0,0,0,0,0,0.0,53.0
13767,1c1f8f281b2065e0,a7b48e18ca27795d,31c01fbc2586a5eb,1997-10-17,0,1,1,53,1,1,7,5,1,6,0,0,6,5,1,0,0,0,0.0,53.0
13768,f44aa569b4eec404,a7b48e18ca27795d,baf942f4bcb09894,1997-07-27,1,0,0,142,1,1,20,14,0,20,0,0,20,14,0,0,0,0,0.0,142.0
13769,f44aa569b4eec404,baf942f4bcb09894,a7b48e18ca27795d,1997-07-27,0,0,0,142,0,0,2,0,1,1,1,1,0,0,1,0,0,0,0.0,142.0
13770,f373e50e2fab3d5f,1f5f75658551f2d3,baa5358456803df8,1997-07-27,0,0,0,150,0,0,1,0,1,0,0,0,0,0,1,1,0,0,0.0,150.0
13771,f373e50e2fab3d5f,baa5358456803df8,1f5f75658551f2d3,1997-07-27,0,0,1,150,1,1,12,4,3,9,1,1,8,4,3,2,0,0,0.0,150.0
13772,e0a11799d3446b87,13b2f59210dda9cc,3fed746acfd026dd,1997-07-27,1,0,0,87,1,1,6,3,3,3,0,0,3,3,2,0,1,0,0.0,87.0
13773,e0a11799d3446b87,3fed746acfd026dd,13b2f59210dda9cc,1997-07-27,0,0,0,87,0,0,4,1,4,0,0,0,0,0,0,0,4,1,0.0,87.0
13774,c92596c3143db25b,13b2f59210dda9cc,253de74457bd6374,1997-07-27,0,1,1,44,1,1,4,2,0,4,0,0,4,2,0,0,0,0,0.0,44.0
13775,c92596c3143db25b,253de74457bd6374,13b2f59210dda9cc,1997-07-27,0,0,0,44,0,0,1,0,1,0,0,0,0,0,1,0,0,0,0.0,44.0
13776,6158150558be0edf,4679a38cced7c64a,df85d6ec3493d120,1997-07-27,0,0,0,480,0,0,5,1,5,0,0,0,0,0,0,0,5,1,0.0,480.0
13777,6158150558be0edf,df85d6ec3493d120,4679a38cced7c64a,1997-07-27,0,0,0,480,3,3,9,7,1,8,0,0,8,7,1,0,0,0,0.0,480.0
13778,3f6c0a76407e1863,1c3f5e85b59ec710,f348d05403fad037,1997-07-27,0,0,0,130,0,0,10,6,10,0,0,0,0,0,0,0,10,6,0.0,130.0
13779,3f6c0a76407e1863,f348d05403fad037,1c3f5e85b59ec710,1997-07-27,0,1,1,130,1,1,21,9,14,7,0,0,7,4,0,0,14,5,0.0,130.0
13780,1f561a3e35a9b48a,a7b48e18ca27795d,f348d05403fad037,1997-07-27,0,0,1,98,1,1,6,1,2,4,0,0,4,1,2,2,0,0,0.0,98.0
13781,1f561a3e35a9b48a,f348d05403fad037,a7b48e18ca27795d,1997-07-27,0,0,0,98,0,0,1,0,1,0,0,0,0,0,0,0,1,0,0.0,98.0
13782,1a5171802bf3bce6,21b8a0f5c231096f,33e33d51f289d2a1,1997-07-27,0,2,0,780,7,2,43,19,6,37,0,0,37,17,0,0,6,2,0.0,780.0
13783,1a5171802bf3bce6,33e33d51f289d2a1,21b8a0f5c231096f,1997-07-27,0,0,0,780,0,0,65,34,44,21,0,0,21,19,21,21,23,15,0.0,780.0
13784,1586c14f26880553,253de74457bd6374,8788beb528894f33,1997-07-27,0,1,1,91,1,1,8,4,0,8,1,1,7,4,0,0,0,0,0.0,91.0
13785,1586c14f26880553,8788beb528894f33,253de74457bd6374,1997-07-27,0,0,0,91,0,0,2,0,1,1,0,0,1,0,0,0,1,0,0.0,91.0
13786,f3c33d0b7a087eaf,184b955181bdef52,2f732dd9210d301f,1997-05-30,0,0,0,31,0,0,0,0,0,0,0,0,0,0,0,0,0,0,0.0,31.0
13787,f3c33d0b7a087eaf,2f732dd9210d301f,184b955181bdef52,1997-05-30,1,0,0,31,1,1,24,20,1,23,0,0,23,20,1,1,0,0,0.0,31.0
13788,e3255c742fff811c,3e514f437c51ce0a,738acab0c6934dd8,1997-05-30,0,1,1,90,1,1,0,0,0,0,0,0,0,0,0,0,0,0,0.0,90.0
13789,e3255c742fff811c,738acab0c6934dd8,3e514f437c51ce0a,1997-05-30,0,0,0,90,0,0,1,0,1,0,0,0,0,0,1,1,0,0,0.0,90.0
13790,90557b479ce1c2a7,0cf935519d439ba6,669a3cb6e394f515,1997-05-30,0,1,1,96,0,0,0,0,0,0,0,0,0,0,0,0,0,0,0.0,96.0
13791,90557b479ce1c2a7,669a3cb6e394f515,0cf935519d439ba6,1997-05-30,0,0,0,96,1,0,6,3,0,6,0,0,6,3,0,0,0,0,0.0,96.0
13792,86f566f142593667,2f732dd9210d301f,946f341df6472ee0,1997-05-30,0,0,0,120,1,1,19,5,15,4,0,0,4,4,0,0,15,1,0.0,120.0
13793,86f566f142593667,946f341df6472ee0,2f732dd9210d301f,1997-05-30,0,1,1,120,1,0,5,0,5,0,0,0,0,0,0,0,5,0,0.0,120.0
13794,75d16f9eae9c6ea6,0aa92558424ced9e,bad28b7b34f334de,1997-05-30,0,1,1,56,1,1,1,1,0,1,0,0,1,1,0,0,0,0,0.0,56.0
13795,75d16f9eae9c6ea6,bad28b7b34f334de,0aa92558424ced9e,1997-05-30,0,0,0,56,0,0,0,0,0,0,0,0,0,0,0,0,0,0,0.0,56.0
13796,45e49fe8d3d1bfb5,7269329bd87eb479,946f341df6472ee0,1997-05-30,0,1,0,480,2,0,16,3,16,0,0,0,0,0,3,0,13,3,0.0,480.0
13797,45e49fe8d3d1bfb5,946f341df6472ee0,7269329bd87eb479,1997-05-30,0,0,0,480,0,0,54,21,42,12,1,1,11,7,14,13,28,14,0.0,480.0
13798,4165dd0c39926e2f,0aa92558424ced9e,3e514f437c51ce0a,1997-05-30,1,0,0,193,1,1,19,15,0,19,1,1,18,15,0,0,0,0,0.0,193.0
13799,4165dd0c39926e2f,3e514f437c51ce0a,0aa92558424ced9e,1997-05-30,0,0,0,193,0,0,0,0,0,0,0,0,0,0,0,0,0,0,0.0,193.0
13800,0e16795e385e76a7,0ee783aa00e468f0,b361180739bed4b0,1997-05-30,1,0,0,52,1,1,24,13,12,12,0,0,12,7,2,2,10,6,0.0,52.0
13801,0e16795e385e76a7,b361180739bed4b0,0ee783aa00e468f0,1997-05-30,0,0,0,52,1,0,5,0,5,0,0,0,0,0,2,2,3,0,0.0,52.0
13802,0473ef44197be419,21f2974fd08085e3,53e533db1b8e9712,1997-05-30,0,1,0,83,0,0,5,0,5,0,0,0,0,0,1,1,4,0,0.0,83.0
13803,0473ef44197be419,53e533db1b8e9712,21f2974fd08085e3,1997-05-30,1,0,0,83,0,0,13,11,2,11,0,0,11,11,0,0,2,0,0.0,83.0
13804,fa347a9ac9d0558c,0ee783aa00e468f0,977081bc01197656,1997-02-07,1,0,0,43,0,0,12,9,3,9,0,0,9,7,0,0,3,2,0.0,43.0
13805,fa347a9ac9d0558c,977081bc01197656,0ee783aa00e468f0,1997-02-07,0,0,0,43,0,0,2,0,2,0,0,0,0,0,0,0,2,0,0.0,43.0
13806,e45feb9866eb2da7,6420efac0578988b,da6dfd09cca1d705,1997-02-07,0,0,0,480,1,1,43,20,33,10,0,0,10,8,0,0,33,12,0.0,480.0
13807,e45feb9866eb2da7,da6dfd09cca1d705,6420efac0578988b,1997-02-07,0,0,0,480,10,1,17,1,17,0,0,0,0,0,0,0,17,1,0.0,480.0
13808,b28809d58f8c18fd,0ee783aa00e468f0,1dab0d1d81dd06db,1997-02-07,1,0,0,77,0,0,29,17,19,10,0,0,10,10,0,0,19,7,0.0,77.0
13809,b28809d58f8c18fd,1dab0d1d81dd06db,0ee783aa00e468f0,1997-02-07,0,0,0,77,0,0,7,0,7,0,0,0,0,0,1,1,6,0,0.0,77.0
13810,77bf1e37929b0d59,3da19339ee7051d5,abbc4fc02e0d84b3,1997-02-07,0,0,1,14,0,0,0,0,0,0,0,0,0,0,0,0,0,0,0.0,14.0
13811,77bf1e37929b0d59,abbc4fc02e0d84b3,3da19339ee7051d5,1997-02-07,0,0,0,14,0,0,0,0,0,0,0,0,0,0,0,0,0,0,0.0,14.0
13812,72e7d6d5328bc3d6,1a49e0670dfaca31,977081bc01197656,1997-02-07,0,0,0,482,0,0,5,3,5,0,0,0,0,0,0,0,5,3,0.0,482.0
13813,72e7d6d5328bc3d6,977081bc01197656,1a49e0670dfaca31,1997-02-07,1,1,0,482,2,2,42,23,20,22,2,2,20,15,5,5,15,8,0.0,482.0
13814,565ecefd8a37ad7e,1d147d4163a6989b,4985113c0928aa62,1997-02-07,1,0,0,48,0,0,0,0,0,0,0,0,0,0,0,0,0,0,0.0,48.0
13815,565ecefd8a37ad7e,4985113c0928aa62,1d147d4163a6989b,1997-02-07,0,0,0,48,0,0,0,0,0,0,0,0,0,0,0,0,0,0,0.0,48.0
13816,3e813ba25895913d,21b8a0f5c231096f,c670aa48827d6be6,1997-02-07,0,2,1,177,0,0,12,4,8,4,0,0,4,2,0,0,8,2,0.0,177.0
13817,3e813ba25895913d,c670aa48827d6be6,21b8a0f5c231096f,1997-02-07,0,0,0,177,3,0,4,2,4,0,0,0,0,0,0,0,4,2,0.0,177.0
13818,2963e9a4b8c10bc9,1d147d4163a6989b,93892752c5fc23ca,1997-02-07,0,0,0,39,1,0,0,0,0,0,0,0,0,0,0,0,0,0,0.0,39.0
13819,2963e9a4b8c10bc9,93892752c5fc23ca,1d147d4163a6989b,1997-02-07,0,1,1,39,1,1,4,2,4,0,0,0,0,0,1,0,3,2,0.0,39.0
13820,18af785da73b5996,577ec7e108b94be3,93892752c5fc23ca,1997-02-07,0,0,0,84,0,0,0,0,0,0,0,0,0,0,0,0,0,0,0.0,84.0
13821,18af785da73b5996,93892752c5fc23ca,577ec7e108b94be3,1997-02-07,0,1,1,84,1,1,3,0,3,0,0,0,0,0,3,0,0,0,0.0,84.0
